,blockNumber,gas,gasPrice,executionGas,callDataUsage,callDataLength,nonce,to,from
0,15627832,517689,57000000000,515877,1812,458,7235,0x7a250d5630B4cF539739dF2C5dAcb4c659F2488D,0x7a83e700F385233C644c30a4eCb029183AC53C47
1,15627832,517689,57000000000,515865,1824,458,3140,0x7a250d5630B4cF539739dF2C5dAcb4c659F2488D,0x449475a8555B535aBa72f17878C4fF58823f8Ab8
2,15627832,150000,30000000000,149356,644,138,11173680,0x88601056d36B2c5E0928f78886eB9329df9e889a,0xFBb1b73C4f0BDa4f67dcA266ce6Ef42f520fBB98
3,15627832,71000,23214786296,71000,0,2,5293,0x56D0c33E5e8cB6390ceBd7369D2Fe7E7870a04E0,0x56D0c33E5e8cB6390ceBd7369D2Fe7E7870a04E0
4,15627832,500000,20000000000,498176,1824,458,1,0x7a250d5630B4cF539739dF2C5dAcb4c659F2488D,0x4A6F988d3311dB558457bec7E1384eB015D6190a
5,15627832,469802,14090000000,458886,10916,2250,371,0x76f4eeD9fE41262669D0250b2A97db79712aD855,0xabC67a49D7d75bD04fA1DAE22cD4b8c4F796540a
6,15627832,189922,13416032217,189202,720,266,353,0x86130Dac04869a8201c7077270C10f3AFaba1c82,0xD7BCEE2EaA9579F39c2290d48e0fA3c706C90153
7,15627832,69905,13046029587,68961,944,138,93,0x19A4e33581c3b0ded84E6ce3Ba8515a4D45b5001,0x728441FE041422D6Ce3b2094C25FD3B00D190bcF
8,15627832,350000,12932490123,350000,0,2,6925018,0x91BF276C0721c123C578ac840567692e2fD89B43,0x46340b20830761efd32832A74d7169B29FEB9758
9,15627832,21000,12684754705,21000,0,2,377,0xCBD6832Ebc203e49E2B771897067fce3c58575ac,0x7498EAfb4630193007B8885DE77822F3c1dbB825
10,15627832,652488,12384562792,648572,3916,970,91227,0xa57Bd00134B2850B2a1c55860c9e9ea100fDd6CF,0x4603180BBB8221157880AfaA84638E0fc467738D
11,15627832,191077,12368652142,190177,900,266,153,0xd588b586D61C826A0e87919b3D1a239206d58bf2,0xFF714e5735424170352E19f0Fcd4Ccb87E86BF2C
12,15627832,21000,12024879396,21000,0,2,0,0xC098B2a3Aa256D2140208C3de6543aAEf5cd3A94,0x723BF60B1e85CBE509B445B618D5c2EC3b8CCfD3
13,15627832,350000,11517773766,349392,608,138,6925019,0xdAC17F958D2ee523a2206206994597C13D831ec7,0x46340b20830761efd32832A74d7169B29FEB9758
14,15627832,350000,11517773766,349392,608,138,6925020,0xdAC17F958D2ee523a2206206994597C13D831ec7,0x46340b20830761efd32832A74d7169B29FEB9758
15,15627832,661136,11450029588,657316,3820,970,111456,0xa57Bd00134B2850B2a1c55860c9e9ea100fDd6CF,0x065e3DbaFCb2C26A978720f9eB4Bce6aD9D644a1
16,15627832,21014,11446029589,21014,0,2,224451,0x91aaE0aAfd9D2d730111b395c6871f248d7Bd728,0x91aaE0aAfd9D2d730111b395c6871f248d7Bd728
17,15627832,21000,11049029587,21000,0,2,195475,0x1118d298be3188973092ab92CAeeE0161A3AC22A,0xB287eaC48aB21c5FB1d3723830d60b4c797555B0
18,15627832,120000,11049029587,119392,608,138,2,0xdAC17F958D2ee523a2206206994597C13D831ec7,0xa1998F50dE9549355970432ebEA54dD601C585BA
19,15627832,25200,11049029587,25200,0,2,17910,0x15848c6f03195e84e6A142Ae4B4d56531150FF3d,0x7563758243A262E96880F178aeE7817DcF47Ab0f
20,15627832,300014,11046029587,298522,1492,394,92672,0x98C3d3183C4b8A650614ad179A1a98be0a8d6B8E,0x5E2B6c6B2240d582995537D3FafdB556E4A3822F
21,15627832,335411,11046029587,334347,1064,180,5388,0x9507c04B10486547584C37bCBd931B2a4FeE9A41,0x934ed35e39f5D9B1D42041B3f6B74C0ce452F4Ac
22,15627832,300014,11046029587,298522,1492,394,46929,0x98C3d3183C4b8A650614ad179A1a98be0a8d6B8E,0x2A91d154CDCdf08A553017afDcdea398C8b706a6
23,15627832,153378,10887739540,152202,1176,266,8323,0xD249942f6d417CbfdcB792B1229353B66c790726,0xb18ccf69940177F3Ec62920dDb2A08eF7CB16E8f
24,15627832,73749,10843744618,72805,944,138,2,0x6B175474E89094C44Da98b954EedeAC495271d0F,0x26eFf98AD6bAE10fED58E3569508A3Ce31719e51
25,15627832,63000,10843744618,63000,0,2,4709892,0x7a490EaFbC3E0b0250D1dC2b6264A917343bCA38,0x2FAF487A4414Fe77e2327F0bf4AE2a264a776AD2
26,15627832,73875,10843744618,72931,944,138,1,0x9AB7bb7FdC60f4357ECFef43986818A2A3569c62,0x4dA5012ac15C28169348AA9e71E13e12E62fad1B
27,15627832,63000,10843744618,63000,0,2,4709893,0xbbbe43473Da815357f7EC7234e4f1340861A5D93,0x2FAF487A4414Fe77e2327F0bf4AE2a264a776AD2
28,15627832,63000,10843744618,63000,0,2,2710042,0xD3f914Fb2979a500E583eBA02E2DC5Ea4A08e027,0xC098B2a3Aa256D2140208C3de6543aAEf5cd3A94
29,15627832,350000,10546029587,349772,228,74,511206,0x06012c8cf97BEaD5deAe237070F9587f8E7A266d,0xAb5622d7Da96c571c6aBe08e4B85E462eB666e4F
30,15627832,21000,10530000000,21000,0,2,0,0x6dfc34609a05bC22319fA4Cce1d1E2929548c0D7,0x93CB457A15CC394734Ca910de23e8FFdD63efe01
31,15627832,21000,10530000000,21000,0,2,0,0x6dfc34609a05bC22319fA4Cce1d1E2929548c0D7,0x77176Dbe1da56E4cFca6f9cCD6a4ED37247fAfe1
32,15627832,62287,10480000000,61631,656,138,24,0xE41d2489571d322189246DaFA5ebDe1F4699F498,0x996cCbe59B03df5E053F3C206095Cdf136a39852
33,15627832,90000,10397733011,90000,0,2,341,0x77134cbC06cB00b66F4c7e623D5fdBF6777635EC,0x5c64313775376B0Dd3f6006a7dcd1Ed5A2E18B2e
34,15627832,200000,10099238660,198632,1368,266,35383,0x5a54fe5234E811466D5366846283323c954310B2,0x1A8ed0D3Ad42c9019CC141aAce7e5Fb6E576B917
35,15627832,49175,10046029587,48687,488,138,788,0xD27dcbcC8778a8AB33AAc529Df36a634567Be325,0xF5889E6a7618A6e70d294DcD64fE5f0D1d27F650
36,15627832,214927,10046029587,213127,1800,458,3319,0x7a250d5630B4cF539739dF2C5dAcb4c659F2488D,0x9B228B4F71B3Bc7e4b478251f218060D7B70Dc25
37,15627832,42000,10000000000,42000,0,2,0,0x00f0486a7d3D3CF0Aa08B04F36B84CCB7fd57556,0x64eBDE07dA8450D2c2dA7DBc0B174746D27dBC3A
38,15627832,30000,10000000000,30000,0,2,3194,0x3e6722f32CBE5b3C7BD3dcA7017c7FfE1b9E5A2A,0x2240FFCB2330177D49578954B11445d7C7Db1e29
39,15627832,90000,9588329851,90000,0,2,784400,0x80e21DA066C9752408e5b494dD7aFa94Ff537E1d,0xcaD621da75a66c7A8f4FF86D30A2bF981Bfc8FdD
40,15627832,305947,9546029587,298959,6988,970,24,0x9b3B6974531d8AA15A87908FFd821A64863Ede5B,0x41821D3bC5270434F2742D8dDc38675AFF44393D
41,15627832,150756,9546029587,150692,64,10,4,0x65c2e54a4c75ff6da7b6B32369c1677250075fb2,0x06E8f98F034290DF1b467A35adB552b05516f440
42,15627832,77221,9546029587,77157,64,10,18,0x5e2c61dE16Ec4D8D7Ea8D85A03616EB0F10b358a,0x2e6b402436F358836439750be5631e39EFbB4273
43,15627832,143796,9546029587,143592,204,74,212,0x7F9306FC1978938d5C1C57Bf6044dc67E07eeB8a,0x7BEf3e0af01a9633916B711af062D9aA88888888
44,15627832,160000,9546029587,159796,204,74,1004,0xb967D2335A3879b7CAE42E085f88274EBff90Fc4,0xb88437f8a872f878afF31f80Ad9292B0d910aEF2
45,15627832,164713,9546029587,164509,204,74,521,0x7F9306FC1978938d5C1C57Bf6044dc67E07eeB8a,0xBa98130C362431039e34638508c9EB57623D433E
46,15627832,21000,9446061562,21000,0,2,549,0xAb59F99f2151Be933E12Fdd0Ab37E2043C30057c,0x113e88A4F61BD60cd13DBECFFBdAe7d6eBbC9D9f
47,15627832,297334,9303079588,293646,3688,970,126451,0xa57Bd00134B2850B2a1c55860c9e9ea100fDd6CF,0x042523DB4F3Effc33d2742022B2490258494f8B3
48,15627832,387694,9250176484,385438,2256,650,96394,0xA69babEF1cA67A37Ffaf7a485DfFF3382056e78C,0xBbAD96336943A36E3e292D973B3382dd0bA4D1EF
49,15627832,318391,9096029587,314383,4008,1226,777,0x68b3465833fb72A70ecDF485E0e4C7bD8665Fc45,0xEF3bAF2AD803A5d9B1A4B4a719b7b2E1C1E2E2B9
50,15627832,586972,9046029587,571376,15596,4626,14131,0x1111111254fb6c44bAC0beD2854e76F90643097d,0xD54e4f8A55247487dd7C8c59f14EE5c0c2889477
51,15627832,500000,9046029587,499392,608,138,1262736,0xdAC17F958D2ee523a2206206994597C13D831ec7,0x89e51fA8CA5D66cd220bAed62ED01e8951aa7c40
52,15627832,222098,9046029587,218518,3580,1162,4610,0x68b3465833fb72A70ecDF485E0e4C7bD8665Fc45,0xB814FC646FbDA374F2bD115dec05F0DDEC676093
53,15627832,42000,9046029587,42000,0,2,329507,0x3B51dD1200c58bf59389f5C07f2701F2691bD506,0x9430801EBAf509Ad49202aaBC5F5Bc6fd8A3dAf8
54,15627832,218508,9046029587,211920,6588,1802,2315,0x00000000006c3852cbEf3e08E8dF289169EdE581,0x87CEF391361A4168148333332fBd5D2C621D3252
55,15627832,211503,9046029587,208287,3216,1034,366,0x68b3465833fb72A70ecDF485E0e4C7bD8665Fc45,0xc4331008949DEe0eb51B3fb8262a8d842FA6a372
56,15627832,923229,9046029587,882989,40240,14026,906,0xaE9C73fd0Fd237c1c6f66FE009d24ce969e98704,0x307F563C6c5446fadB230d33fBB74C8ACea792DF
57,15627832,268643,9046029587,262703,5940,1676,16,0x881D40237659C251811CEC9c364ef91dC08D300C,0xF340Eb34ABD1dAD2B4377c0223cA955Fa23A2445
58,15627832,21000,9046029587,21000,0,2,42,0x0311A5bb367dbB908BE7e603FdBcC817eD9e336C,0xE326A2a27b526Dfe2C64Cff84B1EAf5c35D3cCE7
59,15627832,375557,9046029587,369373,6184,1546,40,0x1A90B3Dead0113740266b7F7Ea1136e8ED1b48C5,0x35bd0E3703bC2DF72E16Aaa79F514EDF28Ab3c8B
60,15627832,90000,9046029587,90000,0,2,93922,0xb82DB807145eE11f8180295749402F5493574568,0xf89d7b9c864f589bbF53a82105107622B35EaA40
61,15627832,60760,9046029587,59816,944,138,17,0xA0b86991c6218b36c1d19D4a2e9Eb0cE3606eB48,0x1D3d2C5E85485CeAe892b5c16ed09349F29D26e7
62,15627832,272904,9046029587,267768,5136,1484,18,0x881D40237659C251811CEC9c364ef91dC08D300C,0x1D3d2C5E85485CeAe892b5c16ed09349F29D26e7
63,15627832,77814,9046029587,77134,680,138,164,0x7420B4b9a0110cdC71fB720908340C03F9Bc03EC,0x8E793508e94B468D766625942400715BA4716930
64,15627832,167169,9046029587,160593,6576,1802,10,0x00000000006c3852cbEf3e08E8dF289169EdE581,0x59238d918D7bcA2A7374e495C8732F25B27c041B
65,15627832,168636,8846029587,162504,6132,1802,69318,0x4D9079Bb4165aeb4084c526a32695dCfd2F77381,0x428AB2BA90Eba0a4Be7aF34C9Ac451ab061AC010
66,15627832,199647,8826029587,198239,1408,394,2,0x3b3ae790Df4F312e745D270119c6052904FB6790,0x69d1688a045Eb1AF19340e7Ac9dd6254dC054B07
67,15627832,120000,8589029587,119404,596,138,57296,0xdAC17F958D2ee523a2206206994597C13D831ec7,0xCfC0F98f30742B6d880f90155d4EbB885e55aB33
68,15627832,50719,8556029587,50111,608,138,6501,0xdAC17F958D2ee523a2206206994597C13D831ec7,0x79F346c53e24d70b92a110AE5C821a85aB9a3BEc
69,15627832,220102,8546029587,218174,1928,522,4,0xeF3739eE528B8D74D0C2a906Aa469C67233c6B44,0x2811d32Aec2030Cc66b6Eb46aE2Fe48Dd7Da7Aa3
70,15627832,21000,8546029587,21000,0,2,0,0xBfFEa57972fc6BD0498992CE29FFb8c14B904327,0x945D4A1a93fF946191d142af45ceA48344ca3bfc
71,15627832,21000,8546029587,21000,0,2,80,0xd643aD32B6A7A8b14ecb6c4A5C0eFbFa7379e8D6,0x1639314b1AdcC1F150903C1b6E14BC0E2eE5F409
72,15627832,107894,8546029587,106942,952,202,51,0xba30E5F9Bb24caa003E9f2f0497Ad287FDF95623,0x58d057a9F7b5825f3aCeEFB3af79e6E1baCdF4e9
73,15627832,401954,8546029587,398362,3592,1162,799,0x68b3465833fb72A70ecDF485E0e4C7bD8665Fc45,0xf81ca0c17423Ef1E918DaEE6035EEabb99401a89
74,15627832,46040,8546029587,45552,488,138,105,0x07314007735FAF41fA8ed4F590e5165BD21604B1,0xFEC6C76fC788e493D8991011c92e7c3b9c5Ec969
75,15627832,160843,8546029587,160603,240,74,524,0xf11ED77fD65840b64602526DDC38311E9923c81B,0x4B6B892B6878E61F421066A01FC03d0648228F82
76,15627832,21000,8546029587,21000,0,2,223,0xB35bCc2a72e69D4a5AB3b08FFe3bdDAED2ce5151,0x560259a1a735299086661820D6A9da50d82C8E1A
77,15627832,21000,8546029587,21000,0,2,3,0x9CAb85210e4F82f2128c0975429c256e31FdEfC5,0x43455a8BD05d802EC3B3547C28561C66b702A011
78,15627832,842850,8546029587,787046,55804,19474,197,0x00000000006c3852cbEf3e08E8dF289169EdE581,0x33Fa950A47caa3523215B9B2e504359930266BC2
79,15627832,143000,8546029587,136424,6576,1802,7,0x00000000006c3852cbEf3e08E8dF289169EdE581,0x9AfBFdACd8ce64A2F824C1078Af8E636F42D2099
80,15627832,309602,8546029587,303958,5644,1546,153,0x68b3465833fb72A70ecDF485E0e4C7bD8665Fc45,0xA908D87081F57ff1771664B495fe03bD7f7e19dF
81,15627832,65172,8546029587,64228,944,138,181,0xba5BDe662c17e2aDFF1075610382B9B691296350,0x6BfE59e8fEaDDfBdBb97F7Da8c6B4550a8bD4ffd
82,15627832,289804,8546029587,287420,2384,522,526,0x283Af0B28c62C092C9727F1Ee09c02CA627EB7F5,0x0bc53955402534F8298C33a4FA747020dEbcbb2E
83,15627832,46267,8546029587,45691,576,74,344,0x283Af0B28c62C092C9727F1Ee09c02CA627EB7F5,0xd3AfEA7C924cBbFe8C3B514cefb6dbd505788Fa3
84,15627832,99244,8546029587,98636,608,138,40,0xA0b86991c6218b36c1d19D4a2e9Eb0cE3606eB48,0x61208DcCA9Ac845473f5c6461DEA88b3dA11689E
85,15627832,46256,8546029587,45768,488,138,3,0x1b1bFf222999BcD6fD07b64d7880e6a95d54ACaA,0x667B01EE62889356ef4878cB4066D51E1cD45f99
86,15627832,80724,8546029587,80068,656,138,45,0xdDF7Fd345D54ff4B40079579d4C4670415DbfD0A,0x6F7CB638e8DdA00a081E521207102A271287f5A9
87,15627832,123784,8546029587,122816,968,330,635,0x4e32004D8b81847A670b4a1778ACe4dCF2bBA01E,0x0bd3292Ab67D05187f0087C2e0Ae010518D4E830
88,15627832,21000,8546029587,21000,0,2,831,0x3434407e6230E0addbA621285049f97f821a751C,0xeC1676fae70827cB96ee31bb9ad2583dD0934C39
89,15627832,213777,8546029587,211017,2760,842,92,0x68b3465833fb72A70ecDF485E0e4C7bD8665Fc45,0xC3511c5795dB560F313A1cc24193103648CcbB35
90,15627832,95838,8546029587,95598,240,74,2970,0x5Aa653A076c1dbB47cec8C1B4d152444CAD91941,0xf3e11d89b07e738F31dE12e8D8CFa0EAc7867A37
91,15627832,92375,8546029587,92171,204,74,2,0xB092Ec81F41c619EEa434357477ea8A4b1455755,0xC3b367eae57E0754865ca8A803078834c1936754
92,15627832,101197,8546029587,99629,1568,330,899,0x4976fb03C32e5B8cfe2b6cCB31c09Ba78EBaBa41,0x9B20b150E873F079187c1510ba554f267F809471
93,15627832,267041,8546029587,248041,19000,4618,697,0x00000000006c3852cbEf3e08E8dF289169EdE581,0x485D183Bb27af4B1E8e3c2b69a92f41f918F92bD
94,15627832,49175,8546029587,48687,488,138,262,0x7f738Ad7072187909384B2ffBaEEdC3C1DA1b686,0x062082F5b88D7dC0be8260dAb7Dad82A2Ae621De
95,15627832,740000,8546029587,729076,10924,2506,58943,0xea7C55976844396f3bD4C89F66988b8b5Be5E96a,0xCe859E48f6cE9834a119Ba04FdC53c1D4F1082A7
96,15627832,21000,8546029587,21000,0,2,139,0x6364b4525fcaE53ed5BFE84cD76A917C9631c3d5,0x79C0c0E159e357a9530323742CD72A4Dba704bE8
97,15627832,21000,8546029587,21000,0,2,0,0xB87f53934Be5E004E42eF5AA80fF26E9f4D72e92,0x56aAC63dE35D3aAE7f0c1Ee985A5340F1A71F84d
98,15627832,197571,8546029587,194383,3188,906,24,0x68b3465833fb72A70ecDF485E0e4C7bD8665Fc45,0xd7368896302b00e270e72E39EFC5F16D1340aF51
99,15627832,181545,8546029587,178809,2736,842,1132,0x68b3465833fb72A70ecDF485E0e4C7bD8665Fc45,0x6d01af8711133DEE2B2edfC54DC6Ce38223f8396
100,15627832,21000,8546029587,21000,0,2,7,0x5440F88120ee9C110ecE078DF4Bd7a2B65c99e80,0x091c98aC6dEb67e39Aec6A232c52e8B3E79E06Db
101,15627832,147054,8546029587,140402,6652,1810,315,0x00000000006c3852cbEf3e08E8dF289169EdE581,0xccAD221D9c55EFe5F46E69867e94698320B54dF4
102,15627832,479469,8546029587,472641,6828,1610,158,0x76f4eeD9fE41262669D0250b2A97db79712aD855,0x3C325DfeafaC6F08DB973E7dfD6E25490aE00Af1
103,15627832,46174,8546029587,45686,488,138,16,0xC7C962e44316E0C052448A0fdd1da15EA24fa9a9,0x675964a3420d5B749f4F07cCB22138FDc06B9b11
104,15627832,54807,8546029587,54323,484,202,619,0x17D084106C2f1C716ce39fa015AB022757d30C9A,0xfcCba679D3c8AAF521fBc69aeDBA9666174a7584
105,15627832,52888,8546029587,52244,644,138,4,0x12b6893cE26Ea6341919FE289212ef77e51688c8,0x44181818D48C27B8B35baCcD8089139E6dB3Ef04
106,15627832,46437,8546029587,45865,572,138,3481,0x0c2E57EFddbA8c768147D1fdF9176a0A6EBd5d83,0xC458e1a4eC03C5039fBF38221C54Be4e63731E2A
107,15627832,222232,8546029587,203744,18488,4554,641,0x00000000006c3852cbEf3e08E8dF289169EdE581,0x103246339988c3A3eC32086A179d6D6b8dE34c4F
108,15627832,434526,8546029587,429006,5520,1610,145,0x68b3465833fb72A70ecDF485E0e4C7bD8665Fc45,0x5fF9206d88ebd668e0869efd9cFFd9cb60387169
109,15627832,212832,8546029587,212640,192,74,29,0x6a9f9d6F5D672a9784c5E560a9648de6cbe2c548,0x1C2bEc615Ec89674e718b0966c686D5343EDc127
110,15627832,21000,8546029587,21000,0,2,1333,0x3434407e6230E0addbA621285049f97f821a751C,0x8589F2Ef6353A2d4B771Ee3c9f8743A7D47Ddc47
111,15627832,185835,8546029587,183671,2164,586,97,0xFbdDaDD80fe7bda00B901FbAf73803F2238Ae655,0xC22DE29ef6E65788cb3764fa4Ec114682Aff28B6
112,15627832,159051,8546029587,156231,2820,842,240,0x68b3465833fb72A70ecDF485E0e4C7bD8665Fc45,0x7D4320c3A77bf087D1d67Ad16628Ed0713671130
113,15627832,62499,8546029587,61547,952,202,395,0xC86664e7d2608f881f796ee8E24FA9d4d7598406,0x7D3E5dD617EAF4A3d42EA550C41097086605c4aF
114,15627832,545174,8546029587,542034,3140,906,156,0x68b3465833fb72A70ecDF485E0e4C7bD8665Fc45,0xBcE449cC68d95FDEb0a1dDC3777A40dB07C5bfb0
115,15627832,50000,8531178101,49936,64,10,825,0x00000000006c3852cbEf3e08E8dF289169EdE581,0xb813f353a181Fd6E899D7dbC1D67c43fE9f2C6C5
116,15627832,191077,8416032217,190177,900,266,227,0xd588b586D61C826A0e87919b3D1a239206d58bf2,0x528982B1B6aBa3A4543aF07Be196251cBCCb85CE
117,15627832,279828,8380662888,277584,2244,650,116835,0xA69babEF1cA67A37Ffaf7a485DfFF3382056e78C,0x6046945C5B5eF5933b8E73a98A6AD7bF3e031df7
118,15627832,273356,8380662888,271172,2184,650,107059,0xA69babEF1cA67A37Ffaf7a485DfFF3382056e78C,0xA5A13F62ce1113838e0d9B4559b8CAf5F76463C0
119,15627832,273130,8380662888,270946,2184,650,43187,0x5050e08626c499411B5D0E0b5AF0E83d3fD82EDF,0xBf2D5d8eBF05947245B3D7f38b2776A6a49710DD
120,15627832,56667,8264577794,55723,944,138,1862,0xB97Ad583dacB8Bd46F75b3593c6eF2ec598Ef37e,0x1e86952Ed4428C62636eBA3D0C7946316A0c359b
121,15627832,298242,8258230587,294554,3688,970,131293,0xa57Bd00134B2850B2a1c55860c9e9ea100fDd6CF,0x60b86AF869f23aEb552fB7F3CaBD11B829f6Ab2F
122,15627832,271186,8258230587,269002,2184,650,44521,0x5050e08626c499411B5D0E0b5AF0E83d3fD82EDF,0xe9F82f15910E161999777036e20CB4108F4Df800
123,15627832,271412,8258230587,269228,2184,650,111036,0xA69babEF1cA67A37Ffaf7a485DfFF3382056e78C,0x36a454aEF52938c8637CD4689B2980C1Cfd43389
124,15627832,279444,8258230587,277188,2256,650,119825,0xA69babEF1cA67A37Ffaf7a485DfFF3382056e78C,0xeCa2e2D894D19778939bD4DfC34D2a3C45E96456
125,15627832,253792,8258230587,251524,2268,650,93260,0xA69babEF1cA67A37Ffaf7a485DfFF3382056e78C,0xFF82BF5238637B7E5E345888BaB9cd99F5Ebe331
126,15627832,283196,8258230587,283196,0,2,12254,0x368dEC1eB6e533119F8740c15613144bf5a668cA,0x368dEC1eB6e533119F8740c15613144bf5a668cA
127,15627832,283826,8238322393,281154,2672,714,35,0x6fBF1b6A681307f86c2d212f0f6Ad72621309eF1,0x7ca4dBC75154245A85b3F8C80beBb49F29e4844e
128,15627832,51334,8238322393,50738,596,138,0,0x083D41d6DD21EE938f0c055CA4fb12268DF0EfaC,0x72DD6b14308aaE6362F6e42d4ce2ea5F1b34282c
129,15627832,265008,8147029587,262740,2268,650,122586,0xA69babEF1cA67A37Ffaf7a485DfFF3382056e78C,0x1c8F6A5F009E051CaB9C3851ca2DA2c936b2775A
130,15627832,276946,8147029587,276946,0,2,106618,0x9AAb3F81604c683a1a0D14019FBfe15bef7aA1ee,0x9AAb3F81604c683a1a0D14019FBfe15bef7aA1ee
131,15627832,253182,8147029587,250914,2268,650,90717,0xA69babEF1cA67A37Ffaf7a485DfFF3382056e78C,0x43e4715ae093a4C86B5eCdDb52216c4f879e9672
132,15627832,389432,8147029587,386028,3404,714,67855,0x00000000C2Cf7648c169b25ef1C217864bFa38cC,0x6e551048CB8f6f94632206a25628807D76432126
133,15627832,21000,8128420782,21000,0,2,24,0xBA6928897514440BA9D14900DD3A7b7591b6a000,0x92965060E73B18ae94473CeC1b0CE8EA30E3FD6B
134,15627832,196246,8096029587,195878,368,138,193,0x8652168693827ff341f2ad5AD9a091f2A975710A,0x59c8c4911b8b31B525893953513E7f1206026962
135,15627832,47204,8046029587,46272,932,138,24,0xb12494C8824fc069757F47d177E666c571Cd49aE,0xBeD84af8cC672cE154dC1f5A7255771Dbb15Ec46
136,15627832,43060,8046029587,42808,252,74,41,0x1748B24faf9780B74E5A9f3Feb41553E712E94aa,0x6819eA7792CC89394fEEE84FC70d54a67cD0B765
137,15627832,191095,8046029587,190183,912,266,211,0xd588b586D61C826A0e87919b3D1a239206d58bf2,0xde499CC69295e266DcA857ab4DF0Bc6A22a99142
138,15627832,294350,8046029587,291418,2932,586,583,0x283Af0B28c62C092C9727F1Ee09c02CA627EB7F5,0xa0723253F645b28e7AABB660f69fa169e736deA8
139,15627832,100881,8046029587,100677,204,74,232,0x9b9D659D4f2cF68b6616Cc0a65683f1951Eb725C,0xCd4C256ff4fd858E27b8eD827B2B97Cf6D577230
140,15627832,101263,8046029587,100691,572,138,36,0x1Fa8559e873f698292766790AeCf8080A66433F6,0x450423ddFf2125B52EC524c8ec35B46552054aBc
141,15627832,181476,8046029587,179912,1564,394,864,0x1Fa8559e873f698292766790AeCf8080A66433F6,0x71D11243995F3003B4950E6FAEd483531F82eCA3
142,15627832,260292,8046029587,258492,1800,458,1202,0x7a250d5630B4cF539739dF2C5dAcb4c659F2488D,0xc5ADA957A63f6d5FF0C7C598FE55631779748239
143,15627832,272068,8046029587,268236,3832,970,119377,0xa57Bd00134B2850B2a1c55860c9e9ea100fDd6CF,0x0cac3d1a887206e0f6169222C4504301A8b4b993
144,15627832,266702,8046029587,262894,3808,970,100932,0xa57Bd00134B2850B2a1c55860c9e9ea100fDd6CF,0x431B5A84aCC1297Eda88259f300262F1bc3A74f3
145,15627832,283224,8046029587,280968,2256,650,97405,0xA69babEF1cA67A37Ffaf7a485DfFF3382056e78C,0x76e40D0a69Fd81826B5eb7D18145626d46EAFdef
146,15627832,270156,8046029587,266348,3808,970,119486,0xa57Bd00134B2850B2a1c55860c9e9ea100fDd6CF,0x93F635372008B7c5d770AAa6Ff313454c8dc498c
147,15627832,296646,8046029587,294378,2268,650,92848,0xA69babEF1cA67A37Ffaf7a485DfFF3382056e78C,0xfb9779477e5b4834BF2bC02dD29b97b344d0F700
148,15627832,257318,8046029587,253498,3820,970,45159,0xa57Bd00134B2850B2a1c55860c9e9ea100fDd6CF,0x69181A03fD84D1e2679Eb520DFDE72C97e1Ce524
149,15627832,256378,8046029587,254098,2280,650,117894,0xA69babEF1cA67A37Ffaf7a485DfFF3382056e78C,0x26bce6eCb5b10138e4bf14aC0ffcc8727FEF3B2e
150,15627832,257870,8046029587,254050,3820,970,12876,0xa57Bd00134B2850B2a1c55860c9e9ea100fDd6CF,0xa483254773CFe94d502557099945Caf90725473f
151,15627832,280350,8046029587,276662,3688,970,12759,0xa57Bd00134B2850B2a1c55860c9e9ea100fDd6CF,0x8d6E15cB3442Ff24F2b8538C203B829F3D879705
152,15627832,255762,8046029587,252954,2808,842,119,0x68b3465833fb72A70ecDF485E0e4C7bD8665Fc45,0x7b719f9518F4DDCd341D28838a06A78395A7d5fC
153,15627832,189331,8046029587,186547,2784,842,0,0x68b3465833fb72A70ecDF485E0e4C7bD8665Fc45,0x9aEa7A0812caE2f3A2D93105b8AB184005567A08
154,15627832,599759,8000000000,593059,6700,1546,164,0x76f4eeD9fE41262669D0250b2A97db79712aD855,0x190fb3B4118e5633820184fE9217049A88f07FCF
155,15627832,21000,7914903026,21000,0,2,1,0xd3ADaaD59A1fe1b8C1AC99Fc9512c2ed1A9d6B61,0x735190FF217c0A08f93d9004a68089bcD78FbdA7
156,15627832,600000,7702024453,599392,608,138,138548,0xdAC17F958D2ee523a2206206994597C13D831ec7,0x974CaA59e49682CdA0AD2bbe82983419A2ECC400
157,15627832,105000,8416032217,105000,0,2,138549,0x312ef3cFff87C328965be834D3c9C098C604771a,0x974CaA59e49682CdA0AD2bbe82983419A2ECC400
158,15627832,600000,8105077760,599392,608,138,138550,0xdAC17F958D2ee523a2206206994597C13D831ec7,0x974CaA59e49682CdA0AD2bbe82983419A2ECC400
159,15627832,242776,7702024453,240904,1872,458,56,0xEfF92A263d31888d860bD50809A8D171709b7b1c,0x1834885235A6FDac300a0D92bbea5B76A2822fdd
160,15627832,8000000,7700000000,7997484,2516,714,158,0xC3CD80b8e99c18AE85E16FBcdfd6A2131EAa4240,0x64951dBD26A4da0DcCdF40e6Ff31F035C43CC302
161,15627832,50000,7574000000,49332,668,138,0,0xdAC17F958D2ee523a2206206994597C13D831ec7,0xF71e5335f336bf2c2cD795217281C43f738992f9
162,15627832,458947,7553825706,458495,452,138,104,0x2d77B594B9BBaED03221F7c63Af8C4307432daF1,0x8a706170885CBEBC17a70EBdb0b8f7a53320C9D3
163,15627832,46267,7553825706,45691,576,74,176,0x283Af0B28c62C092C9727F1Ee09c02CA627EB7F5,0x465169037Da9f80F3bA4bf6d3e6DA74e5c1BE182
164,15627832,21000,7435830446,21000,0,2,6347,0x5c2202CF00E2c6376c5b3faa5d94A6fD87987488,0x94c4c463960082abeD5430554e3698A19e3C9f6F
165,15627832,75836,7360000000,75240,596,138,18,0xdAC17F958D2ee523a2206206994597C13D831ec7,0xc502D714240bf6A73f709DC022089DdbF2c8a261
166,15627832,21000,7280000000,21000,0,2,10,0x292f04a44506c2fd49Bac032E1ca148C35A478c8,0x8B241A8b479047890e890B77947597091C621594
167,15627832,351390,7233498542,164658,186732,23546,183237,0x5E4e65926BA27467555EB562121fac00D24E9dD2,0x6887246668a3b87F54DeB3b94Ba47a6f63F32985
168,15627832,56803,7225296389,56315,488,138,224,0xc9a0B20D522AeeAC5d8D6ba13146a073A97B326A,0x68a9360E07a5fe96a2209A64Fa486bB7B2dF217B
169,15627832,21000,7225296389,21000,0,2,2,0xb87B012e10B34b6331a8D70ca21D7a8Ee6eC5D2b,0x2ee73FB4391B40579A7091E52D1D412801bf49B1
170,15627832,329014,7225296389,324682,4332,1034,0,0x197492CCB4B1acaAAcd43432657A17832E36AB49,0x01BB57dDe333314a7614973C67C60C598F076e14
171,15627832,46619,7209989933,46131,488,138,135,0xeB4A28587503d84dc29DE8e4Fc8bF0A57A7Ddb0d,0x2c5e0478bcd516cfA726d46815f90daF0607B507
172,15627832,46157,8046029587,45669,488,138,136,0x4050C9b0F9e008E7E8335D1F12bf95E11013Fc01,0x2c5e0478bcd516cfA726d46815f90daF0607B507
173,15627832,71410,7209989933,70458,952,202,99,0xF59B70D31Dd2a7ce2FdFB0a9326988dF6cc58ec9,0x7fAeF9b8a8798c8EdaD02a3bbC9e627e5CD68AF8
174,15627832,71410,7233498542,70458,952,202,100,0xF59B70D31Dd2a7ce2FdFB0a9326988dF6cc58ec9,0x7fAeF9b8a8798c8EdaD02a3bbC9e627e5CD68AF8
175,15627832,71410,7233498542,70458,952,202,101,0xF59B70D31Dd2a7ce2FdFB0a9326988dF6cc58ec9,0x7fAeF9b8a8798c8EdaD02a3bbC9e627e5CD68AF8
176,15627832,71410,7233498542,70458,952,202,102,0xF59B70D31Dd2a7ce2FdFB0a9326988dF6cc58ec9,0x7fAeF9b8a8798c8EdaD02a3bbC9e627e5CD68AF8
177,15627832,70000,7081125506,69068,932,138,0,0xdAC17F958D2ee523a2206206994597C13D831ec7,0x26E5B0e777D10dcc8f367eedD58b2091441f3C10
178,15627832,21000,7058891994,21000,0,2,2291,0x03476A65eFD691bD32CDa69EA320a5BadDeAD777,0xAE41A4A1b3B4B28EB6CC7199Aaa1f1600FaDBAdf
179,15627833,21000,41196944431,21000,0,2,5165,0x63B7F7C47F5410d3ce86A715dF97F46283187167,0x63B7F7C47F5410d3ce86A715dF97F46283187167
180,15627833,579642,22442300698,577606,2036,522,221,0x7a250d5630B4cF539739dF2C5dAcb4c659F2488D,0x0a0215ad69f3a208CbB94Ad060A333de7Ad26bdD
181,15627833,80751,17306767770,80083,668,138,2188219,0x2e9d63788249371f1DFC918a52f8d799F4a38C94,0x75e89d5979E4f6Fba9F97c104c2F0AFB3F1dcB88
182,15627833,21000,16889626549,21000,0,2,12392,0xea9D00b3e0Aa90D6393Ecb62e7F59cAd086B3A8c,0xea9D00b3e0Aa90D6393Ecb62e7F59cAd086B3A8c
183,15627833,283086,14690980001,280842,2244,650,49755,0xA69babEF1cA67A37Ffaf7a485DfFF3382056e78C,0xfc23b61db3a1dCE083e82Da5A2CcFd91A2211f7C
184,15627833,267056,14690980000,264056,3000,842,93489,0x4A137FD5e7a256eF08A7De531A17D0BE0cc7B6b6,0x00dEe1F836998bcc736022f314dF906588d44808
185,15627833,21000,11445300698,21000,0,2,251465,0x124F20340dDCd9326FE7CD8B49cC180685239Fad,0x151B381058f91cF871E7eA1eE83c45326F61e96D
186,15627833,208545,11442300698,207021,1524,230,2381,0x9507c04B10486547584C37bCBd931B2a4FeE9A41,0x599da210eAA67270b127ef28A3f6e78C3725858A
187,15627833,73345,11190185684,72725,620,138,4709894,0xdAC17F958D2ee523a2206206994597C13D831ec7,0x2FAF487A4414Fe77e2327F0bf4AE2a264a776AD2
188,15627833,26000000,11000000000,25935264,64736,15882,16089,0x4F4495243837681061C4743b74B3eEdf548D56A5,0x19e34D09c2664d4F0829B1431eA73daC1B2bea93
189,15627833,79381,10480000000,78785,596,138,14,0xA0b86991c6218b36c1d19D4a2e9Eb0cE3606eB48,0x5Cd70A76D285ca5465a87832Fa6e74f935736B54
190,15627833,833544,10442300698,810588,22956,7634,3990,0x1111111254fb6c44bAC0beD2854e76F90643097d,0xD97eEb8B7f164CBbe9CB45C83C98D4E0BF502A4F
191,15627833,273840,10442300698,271616,2224,778,59,0x08038283d6710bF62C8Ac76E53E6dA8E8dc4f787,0x1Dc0BA9941847A96F096d25018Df844176066FCA
192,15627833,234753,10382072033,231921,2832,842,41,0x68b3465833fb72A70ecDF485E0e4C7bD8665Fc45,0xdd62Dbf16DcE107AD6F2685ada3e9eD64296C100
193,15627833,21000,10080000000,21000,0,2,36,0x00428adc6751d0b2e4463b6A3822a030a6B82225,0x84751AC7924dA180Ba3cA00C968ed5993A0638d1
194,15627833,21000,10017466597,21000,0,2,7,0x6C5e354bf58421c59593C78dD59f23acbD4D5B05,0x4064b2E3881BBE7B50016547b6D23a29876Ac4d7
195,15627833,170689,9942300698,170485,204,74,5,0x7F9306FC1978938d5C1C57Bf6044dc67E07eeB8a,0x7e54c7fEd6Ce38608ddAa68BD0303C4fFC5c6828
196,15627833,21000,9942300698,21000,0,2,17212,0xA23fC447AF5609258F9DFc3B0Beb1fD344902A83,0xf9a416fDEAD4A9b7C32eb9D452F8E3428651Cf99
197,15627833,153922,9942300698,153858,64,10,857,0x112536829069dDF8868De6F8283eA7C3cD3E6743,0xD9186E34aE6197236E6cB9290b1D2F60aD7a9102
198,15627833,8000000,9726093312,7999936,64,10,15095,0x88266E58a66cB5b1880814F6BFe5E12b68832B9D,0xb2AA4a5DF3641D42e72D7F07a40292794dfD07a0
199,15627833,77431,9442300698,76763,668,138,18,0x4d224452801ACEd8B2F0aebE155379bb5D594381,0x893B6Ea847a460803c29b78E144FA4269D85985f
200,15627833,21000,9442300698,21000,0,2,119,0xf89d7b9c864f589bbF53a82105107622B35EaA40,0x0cAB181efc80AEaCE970D43D5aB6AB1aF3949DE7
201,15627833,30732,9442300698,30668,64,10,534,0xC02aaA39b223FE8D0A0e5C4F27eAD9083C756Cc2,0x851b0a003bF1CA98Ee84028848da1ed69A50cca7
202,15627833,51988,9442300698,51044,944,138,777,0x72B169AD8aF6c4FB53056b6a2A85602Ad6863864,0xA5E2A4105397ABc662827f5daA6D0F449B71bA37
203,15627833,771000,9442300698,766304,4696,1162,79,0xe66B31678d6C16E9ebf358268a790B763C133750,0xb5c76C95E0f7f9f30C554a1560E8282f620c3b3C
204,15627833,2000000,9442300698,1994912,5088,1226,171030,0xA9D1e08C7793af67e9d92fe308d5697FB81d3E43,0x7830c87C02e56AFf27FA8Ab1241711331FA86F43
205,15627833,2000000,9442300698,1992040,7960,1738,171031,0xA9D1e08C7793af67e9d92fe308d5697FB81d3E43,0x7830c87C02e56AFf27FA8Ab1241711331FA86F43
206,15627833,21000,9442300698,21000,0,2,469147,0xB9acFcEfa71bD6E51A5f2156Bc0479e2Ef714f6d,0xb739D0895772DBB71A89A3754A160269068f0D45
207,15627833,21000,9442300698,21000,0,2,1783196,0x7aBf7a4A6a59ac79104a2848BC3C80231bCe5226,0x503828976D22510aad0201ac7EC88293211D23Da
208,15627833,398073,9099701052,392817,5256,1610,251,0x68b3465833fb72A70ecDF485E0e4C7bD8665Fc45,0xF930fE78b91351f3F0640266b9752Ad8839E7368
209,15627833,600000,9035509092,598728,1272,458,59273,0xE544cF993C7d477C7ef8E91D28aCA250D135aa03,0x69f36eA1ebf4Ec9E53e3aaBF11CAF62b034ff3eE
210,15627833,21000,9000000000,21000,0,2,0,0x4E5B2e1dc63F6b91cb6Cd759936495434C7e972F,0x76D5462bc5E991dea886b0f058ee320549d3b2a6
211,15627833,21000,8985300698,21000,0,2,57297,0xe8C5b857713F88b474Ecd09ABd95905C1FcF44Fa,0xCfC0F98f30742B6d880f90155d4EbB885e55aB33
212,15627833,46685,8942300698,46197,488,138,287,0x0c537f8F6780628aFdf866E41A81d2ED97CFC8a2,0xA9684014290976aED5B098E3f60cceda447204bf
213,15627833,132457,8942300698,125921,6536,1692,50,0x00000000006c3852cbEf3e08E8dF289169EdE581,0xA8b8c932d6164d3A3aB5eE623e14C7964C4a64bC
214,15627833,46138,8942300698,45650,488,138,12,0x0B2f7F5c4d88C8b6ed3b40a7467731326C7A0820,0xAd365321E15714a13d8DBc84260943f714b6a989
215,15627833,46638,8942300698,46150,488,138,12,0xCF3bc939f9B2487092936F21cC0757b2b523B7aA,0x6616e78124B9343F8B05e9976599E427E35263CC
216,15627833,139466,8942300698,138654,812,330,236,0x96d7Bf9ECc9A136b233AB065b9263c91514E019d,0xd8fd0ae6076B3D643543B7C7D386d5425bb48284
217,15627833,46111,8942300698,45623,488,138,404,0xFB6e20268256ed02Ad06fD983E80a48E87759F29,0xED8d9D737ea41A24F9D564Dee911A278e594d3ab
218,15627833,267017,8942300698,248041,18976,4618,698,0x00000000006c3852cbEf3e08E8dF289169EdE581,0x485D183Bb27af4B1E8e3c2b69a92f41f918F92bD
219,15627833,73795,8942300698,72851,944,138,45,0x527331F3F550f6f85ACFEcAB9Cc0889180C6f1d5,0x22728FB916C38d23a70cE66Af2fc7c4C3a961a75
220,15627833,160347,8942300698,153759,6588,1802,24,0x00000000006c3852cbEf3e08E8dF289169EdE581,0x60d423293D20E6C448F60e3994F9053500E94CcF
221,15627833,120637,8942300698,120573,64,10,10,0xf7db4205032153a81BCB6ed0561c00E65Ac55a06,0x0dfE3D29F1599De07a81E5Fa9B6B8304711d087a
222,15627833,234355,8942300698,233939,416,138,228,0x244cf1DEF777a5030B93516fC74FC081221c1Ad6,0x1D892Ab8436cd93687575A82A4622c3C4b6B62AB
223,15627833,63654,8942300698,63654,0,2,484,0xECF281C21382e1DEf02a2c56c543C9c27fc0faeF,0xf2b4AA6AF64F8ff0a7A1b529d77E85319FB43221
224,15627833,328423,8942300698,325223,3200,906,222,0x68b3465833fb72A70ecDF485E0e4C7bD8665Fc45,0xa7C1d32B4bB7155Ad5e9e53F472b9CE61BB37ddc
225,15627833,92147,8942300698,91195,952,202,22,0x5b7A317A300699531cA4673473b84b6a7cbBC294,0x2a8482a8e89C1D4aCdDA32FD232EA425eeb87e60
226,15627833,137477,8942300698,130865,6612,1802,90,0x00000000006c3852cbEf3e08E8dF289169EdE581,0x947B898fb8fF1E3fdaFEf4094059253EC0Cad0cf
227,15627833,273384,8543300698,273384,0,2,12646,0x3fbAEa01B228368E67ca40d8cb195018Fd095318,0x3fbAEa01B228368E67ca40d8cb195018Fd095318
228,15627833,59056,8442300698,58092,964,394,2352,0x645E9324f4be25be581BB62163cfa86c40b01D07,0xc5009AFEd2D6DA219538aD165998F63B553185B1
229,15627833,302480,8442300698,300212,2268,650,47362,0xA69babEF1cA67A37Ffaf7a485DfFF3382056e78C,0xD68fe83d3834bF35c6e1AA8A9d81c56249a61881
230,15627833,267646,8442300698,265378,2268,650,40452,0xA69babEF1cA67A37Ffaf7a485DfFF3382056e78C,0x64bbde373e909501de1309231336761AdEaA07d5
231,15627833,273158,8442300698,270974,2184,650,12825,0x5050e08626c499411B5D0E0b5AF0E83d3fD82EDF,0x1335d0a7cbA7e5742399b0C94305136E8f4bc2a8
232,15627833,283164,8442300698,280908,2256,650,14275,0xA69babEF1cA67A37Ffaf7a485DfFF3382056e78C,0x77eB9084CE8168901bcb11F14f02A7aAb36fCd0c
233,15627833,175110,8442300698,173546,1564,394,109,0x1Fa8559e873f698292766790AeCf8080A66433F6,0x5B3FDeDC929BEB803ad5a4d5CCe12Feba42Cc8CF
234,15627833,256438,8442300698,254158,2280,650,41546,0xA69babEF1cA67A37Ffaf7a485DfFF3382056e78C,0xD295879063BE7A6c49F7327AfaA831a4f3f64882
235,15627833,253196,8442300698,250928,2268,650,41714,0xA69babEF1cA67A37Ffaf7a485DfFF3382056e78C,0x421125ca608A35458B2C99DA39CD55B70bA202a4
236,15627833,657366,8442300698,653546,3820,970,41780,0xa57Bd00134B2850B2a1c55860c9e9ea100fDd6CF,0xAc221503406190103b8CB7D9393AE66D9C9Af6a3
237,15627833,431521,8379645473,424549,6972,2066,632,0x1111111254fb6c44bAC0beD2854e76F90643097d,0xa4a5C3591ABBfEd86ea1ED80495d7E27ef05200A
238,15627833,69163,7950096817,68555,608,138,11,0xdAC17F958D2ee523a2206206994597C13D831ec7,0xF5dd38C4c2004573b3e5573010AB4b7AA49b37B3
239,15627833,21000,7642300698,21000,0,2,5079,0x6c870DAb9D3D1C038aeA007D9375fC7bd696759e,0x6c870DAb9D3D1C038aeA007D9375fC7bd696759e
240,15627834,517689,57000000000,516745,944,138,3141,0xB97Ad583dacB8Bd46F75b3593c6eF2ec598Ef37e,0x449475a8555B535aBa72f17878C4fF58823f8Ab8
241,15627834,517689,57000000000,516745,944,138,7236,0xB97Ad583dacB8Bd46F75b3593c6eF2ec598Ef37e,0x7a83e700F385233C644c30a4eCb029183AC53C47
242,15627834,100000,53000000000,99356,644,138,2106,0xcD74Cf66c43e45Abd5703f3642F73d0675D6AFF7,0x92D47B6E3dce6471F42021Db650A611Af4257771
243,15627834,21000,45000000000,21000,0,2,0,0xD86e3A116Bc98A354253dea47ffd36E86b1A1BC2,0x3F78499024f6621514a183699eBd9CEDB0B0fDE1
244,15627834,600000,30000000000,599344,656,138,396,0x7D1AfA7B718fb893dB30A3aBc0Cfc608AaCfeBB0,0x68b5E9E083BFC28c33cfbf3F19D33e629015E907
245,15627834,150000,30000000000,149392,608,138,11173681,0xdAC17F958D2ee523a2206206994597C13D831ec7,0xFBb1b73C4f0BDa4f67dcA266ce6Ef42f520fBB98
246,15627834,654187,27362006468,646703,7484,1524,83030,0x0000000000007F150Bd6f54c40A34d7C3d5e9f56,0x0336E78E4D09b8A6A84D34d0fD103452dE57A7A3
247,15627834,21000,19036819037,21000,0,2,10943,0x7Dacfce9EAcdCA48CaD5Ba0b61560586c375890B,0x7Dacfce9EAcdCA48CaD5Ba0b61560586c375890B
248,15627834,5049304,17000000000,5042216,7088,1098,273,0x0a39DA505DfB5E0BBc6bd84428281A8ba1bC7753,0x495E889d1A6cEB447a57dcc1C68410299392380c
249,15627834,21000,16741028868,21000,0,2,10944,0x7Dacfce9EAcdCA48CaD5Ba0b61560586c375890B,0x7Dacfce9EAcdCA48CaD5Ba0b61560586c375890B
250,15627834,641538,16400499697,634126,7412,1524,53737,0x0000000000007F150Bd6f54c40A34d7C3d5e9f56,0x048Fde2d3d47F54d3E7bE0Be7A40e1cb5AfF5d72
251,15627834,322794,16012788133,320490,2304,650,106619,0xA69babEF1cA67A37Ffaf7a485DfFF3382056e78C,0x9AAb3F81604c683a1a0D14019FBfe15bef7aA1ee
252,15627834,54756,14155723583,54160,596,138,1238,0x083D41d6DD21EE938f0c055CA4fb12268DF0EfaC,0x0e747EB2ff0F26fB77c3a1eA67EE07FAc2DbB783
253,15627834,90000,14000000000,89392,608,138,0,0xdAC17F958D2ee523a2206206994597C13D831ec7,0x361b25cac69e63f8a5019B670792b6EcA693f43e
254,15627834,96703,12945915429,95143,1560,458,2,0x0BABA1Ad5bE3a5C0a66E7ac838a129Bf948f1eA4,0x89532E5d25B4fd8A60a67234FbdD0C791bD9B9DB
255,15627834,100000,12917894644,99404,596,138,132643,0xdAC17F958D2ee523a2206206994597C13D831ec7,0x63A395B574D5E23C3dbC6986Be5994Ef6743aFA8
256,15627834,409605,12865735357,403673,5932,1546,1713,0xd3bd2e8254C7B8d10af3185f41f89b8E43b73B04,0xeD6a31f8Ba489041b38B10eE1E468d059aDf5B32
257,15627834,255000,12786835289,253336,1664,402,609,0x1111111254fb6c44bAC0beD2854e76F90643097d,0xacA2BD469F52ee4892317B784309f49463F43A71
258,15627834,394759,12786835289,393667,1092,176,26580,0xa622397cFD777766F4b31Ee2FDFe733E85c0c6c8,0xEf5a3745F822f8F83693564c54904d7FF156CFb2
259,15627834,276808,12786835289,272856,3952,1162,4296,0xD7c09E006A2891880331b0F6224071C1e890A98A,0x92F47cbabDC4639DCDC2e7dcFCb0c017c8cf730E
260,15627834,480000,12786835289,476724,3276,842,1019,0x1B72d900eE50CA200097003100001F30aE00495b,0xAFD3d6Adda8630D22Bd87816d23B57E2eabAC17c
261,15627834,448824,12786835289,444504,4320,890,105720,0x0000000000007F150Bd6f54c40A34d7C3d5e9f56,0x60530f5Ca4CB9907e0FBE67cA3AFCbFE56D19A5c
262,15627834,3000000,12786835289,2996848,3152,414,6930,0xbD6a2bfcCFc6a4f7EcE6c005d50D01428Fb9c086,0x0124D0fA0DfB1430dFcff16eC6A96945E7a0BC10
263,15627834,236337,12608560404,233577,2760,842,432,0x68b3465833fb72A70ecDF485E0e4C7bD8665Fc45,0x45B5b71d3A359ac378A9f1eD3AF158CF16672A14
264,15627834,21000,12370527493,21000,0,2,1,0xCBD6832Ebc203e49E2B771897067fce3c58575ac,0x0BF38628e46a9b473429f289fAEDC012E2590f8E
265,15627834,350000,12122353727,350000,0,2,6925021,0x4eBf7489301FC3298B372164046AD3f7B0A0cC69,0x46340b20830761efd32832A74d7169B29FEB9758
266,15627834,1000000,11945915429,999356,644,138,9692,0x320623b8E4fF03373931769A31Fc52A4E78B5d70,0xCb018790c03bDFd33A82354DEE4e320f1398d66F
267,15627834,99262,11945915429,98642,620,138,188,0xA0b86991c6218b36c1d19D4a2e9Eb0cE3606eB48,0x44f12eF573F5A70464B7904E037aff4eC0061c6F
268,15627834,100000,11444654479,99380,620,138,181425,0x473037de59cf9484632f4A27B509CFE8d4a31404,0x6238872A0Bd9F0E19073695532a7Ed77ce93C69E
269,15627834,191041,11000000000,190165,876,266,1383,0xd588b586D61C826A0e87919b3D1a239206d58bf2,0xC22d03e13B888Dabb33A1575e4F6542f0e996622
270,15627834,21000,10948915429,21000,0,2,251466,0x007a298e8053c862Bd4b069DF148946b5314475A,0x151B381058f91cF871E7eA1eE83c45326F61e96D
271,15627834,300014,10945915429,298818,1196,330,224452,0x98C3d3183C4b8A650614ad179A1a98be0a8d6B8E,0x91aaE0aAfd9D2d730111b395c6871f248d7Bd728
272,15627834,350000,10814984900,349392,608,138,6925022,0xA0b86991c6218b36c1d19D4a2e9Eb0cE3606eB48,0x46340b20830761efd32832A74d7169B29FEB9758
273,15627834,350000,10814984900,349392,608,138,6925023,0xdAC17F958D2ee523a2206206994597C13D831ec7,0x46340b20830761efd32832A74d7169B29FEB9758
274,15627834,350000,10814984900,349404,596,138,6925024,0xA0b86991c6218b36c1d19D4a2e9Eb0cE3606eB48,0x46340b20830761efd32832A74d7169B29FEB9758
275,15627834,350000,10814984900,350000,0,2,6925025,0x3cE45354361113480E64909E38Ad09a50AFef3ED,0x46340b20830761efd32832A74d7169B29FEB9758
276,15627834,350000,10814984900,350000,0,2,6925026,0xf426346B8d7E8a3f64352443A3F6329c358f2D8F,0x46340b20830761efd32832A74d7169B29FEB9758
277,15627834,350000,10814984900,350000,0,2,6925027,0x894f1Ea7A3880cd03B0876c9Be0034501D7BD130,0x46340b20830761efd32832A74d7169B29FEB9758
278,15627834,63000,10693800415,63000,0,2,2710043,0xC8670055665e5aa9E1c9Be0cE6AA7EE5A5225440,0xC098B2a3Aa256D2140208C3de6543aAEf5cd3A94
279,15627834,21000,10520040271,21000,0,2,52,0x1b41f5A28Cf8eDB597983e77A237b8930252327D,0x7f33A0ae75A9a9a4ED6ED119736E95c4350D0400
280,15627834,75836,10080000000,75240,596,138,7,0xdAC17F958D2ee523a2206206994597C13D831ec7,0x8885D60aC9C0dE5c0141147865a0F6291Cc5b9B7
281,15627834,100000,10000000000,100000,0,2,270666,0x92fb397c0Cf18F62218d31894fBB521A119D8740,0x23f4569002a5A07f0Ecf688142eEB6bcD883eeF8
282,15627834,21000,10000000000,21000,0,2,16,0x5F0dF408D1C0e68D7CE46F6e75A2D699a2590a07,0xDF542b9c2184bF2f9C79712549f2dB6c9947b6d5
283,15627834,143796,10000000000,143592,204,74,72,0x7F9306FC1978938d5C1C57Bf6044dc67E07eeB8a,0x89C1Ca055F652f19b17F3D7bdea0F4C52D7d6020
284,15627834,21000,10000000000,21000,0,2,15,0xBc13D80CB3FD572FDBc64210DE762dcb8Bd93469,0xa0B1FF0aa69695C9d6258B38E65A672aae185271
285,15627834,28000,9945915429,27996,4,4,147,0x000000000000000000000000000000000000dEaD,0x8C7cCE1F0ed5cF36D24cB8aBa73749a0e0eCb995
286,15627834,97780,9945915429,96528,1252,394,1569,0x710515Bf543fDb6834144F9269BBf0D1d32B1702,0xB97A925d8027E8633c2aADd377260F9d0126F7f1
287,15627834,637875,9945915429,635863,2012,522,3,0x7a250d5630B4cF539739dF2C5dAcb4c659F2488D,0xd4c9786231E5f9C7D1B13fC1e742913D75759263
288,15627834,273840,9945915429,271616,2224,778,60,0xCd48eCd9110979D6e343Bc5AE4Cc8035339A35c9,0x1Dc0BA9941847A96F096d25018Df844176066FCA
289,15627834,21000,9725915429,21000,0,2,7,0x63e7a12c0FFA37788f9e951203F193983D7bD98A,0xB26142cc41b590753c7B9f7e132f86C0300c05f0
290,15627834,155748,9695915429,155544,204,74,430,0x7F9306FC1978938d5C1C57Bf6044dc67E07eeB8a,0x6eE74060e6F102cb1a2B70102214E47e75C51C3D
291,15627834,55442,9445915429,54870,572,138,694,0x86EABEbC09B451bBd7E0B8daaf617e9272FeeE3E,0x8861399eE37626fCC020c49E5184D9b839ed854A
292,15627834,143796,9445915429,143592,204,74,723,0x7F9306FC1978938d5C1C57Bf6044dc67E07eeB8a,0x6748c23CB9D9F40aC75ec2C43106A8BC3197f82E
293,15627834,6000000,9445915429,5749272,250728,105098,3929,0x737901bea3eeb88459df9ef1BE8fF3Ae1B42A2ba,0xFcF75295f242C4E87203Abb5d7C9BbEda90a8895
294,15627834,143796,9445915429,143592,204,74,92,0x7F9306FC1978938d5C1C57Bf6044dc67E07eeB8a,0x539aEe394EDbe2aE6E537651dB0989a7aDaaA5fB
295,15627834,170689,9445915429,170485,204,74,724,0x7F9306FC1978938d5C1C57Bf6044dc67E07eeB8a,0x6748c23CB9D9F40aC75ec2C43106A8BC3197f82E
296,15627834,143796,9445915429,143592,204,74,52,0x7F9306FC1978938d5C1C57Bf6044dc67E07eeB8a,0x789f9c7dFBed17f23e6573128ab289f9d8c696b6
297,15627834,833972,9445915429,829928,4044,1610,1511,0x286Beef3Cc540d4EC281599117Ba594C95D2CF02,0x518201899E316bf98c957C73e1326b77672Fe52b
298,15627834,90000,9445915429,89796,204,74,24,0x350e201c6285D61a11633127361D25A05B2eEAB8,0xe2EAD5cA1836c19eD38BDad6B56aAeB2183a2915
299,15627834,77221,9445915429,77157,64,10,19,0x5e2c61dE16Ec4D8D7Ea8D85A03616EB0F10b358a,0x2e6b402436F358836439750be5631e39EFbB4273
300,15627834,146784,9445915429,146580,204,74,27,0x7F9306FC1978938d5C1C57Bf6044dc67E07eeB8a,0x0cB965F38099687eec65D51D9B12D1234284Dce4
301,15627834,143796,9445915429,143592,204,74,249,0x7F9306FC1978938d5C1C57Bf6044dc67E07eeB8a,0x1E372D919Fa97242aa89eb0C6aad4778eD45e57f
302,15627834,600000,9319908514,598744,1256,330,43,0x89B5919bCD78363B15A9C4CC25E90eE49c9caCbE,0x6210A57885BEaA46Df891Cc3BcAed577d96D228f
303,15627834,8000000,9155723583,7999936,64,10,15096,0xF2A0BD19d179F8283be3E4907fa8a6D53A096745,0xb2AA4a5DF3641D42e72D7F07a40292794dfD07a0
304,15627834,665284,9098261301,657728,7556,1524,36239,0x0000000000007F150Bd6f54c40A34d7C3d5e9f56,0x0593A1447F14c5b8C6B635d40B1cF8a5e1c0f3d1
305,15627834,153441,9045915429,152125,1316,330,14132,0xA0c68C638235ee32657e8f720a23ceC1bFc77C77,0xD54e4f8A55247487dd7C8c59f14EE5c0c2889477
306,15627834,60105,9021199325,60105,0,2,48492,0x4dC9e781Fef18fa4Dc5217A5Ee1156f668B5aF55,0x4dC9e781Fef18fa4Dc5217A5Ee1156f668B5aF55
307,15627834,30000,9000000000,30000,0,2,3195,0x3e6722f32CBE5b3C7BD3dcA7017c7FfE1b9E5A2A,0x2240FFCB2330177D49578954B11445d7C7Db1e29
308,15627834,21000,8995915429,21000,0,2,12,0x9b4a766C5c7728CE7Df70d5DB609b61F22d192D8,0x9758d1F156bb1936DB725572b325BD640523c8a5
309,15627834,21000,8945915429,21000,0,2,52370,0x588c637511c14625718A5A586Ce5CdE5D239A8Be,0x7c195D981AbFdC3DDecd2ca0Fed0958430488e34
310,15627834,336468,8945915429,334704,1764,458,828,0x7a250d5630B4cF539739dF2C5dAcb4c659F2488D,0xba28267b3aA1a1E1503f31ff58fd081451Fc505b
311,15627834,42000,8945915429,42000,0,2,329508,0xB10858beCc9F96b9619a4f83C7dD7F953074E0cA,0x9430801EBAf509Ad49202aaBC5F5Bc6fd8A3dAf8
312,15627834,537948,8945915429,534796,3152,906,69,0x68b3465833fb72A70ecDF485E0e4C7bD8665Fc45,0xD5b5E8a77b87224B1f6712Ba02c34fE163F78c62
313,15627834,500000,8945915429,499356,644,138,3636,0x4a220E6096B25EADb88358cb44068A3248254675,0x10593a64B7b7BB0Ea29B8c01F1619ca8fF294b2F
314,15627834,638424,8945915429,634832,3592,1162,1020,0x68b3465833fb72A70ecDF485E0e4C7bD8665Fc45,0x757fD55374512D23332F634b396a9997B9880134
315,15627834,340789,8945915429,336793,3996,1226,24,0x68b3465833fb72A70ecDF485E0e4C7bD8665Fc45,0x9913ac6011C6301487c1eaEAd7B2B59f5aA43680
316,15627834,264018,8945915429,263590,428,138,70,0x94235659cF8b805B2c658f9ea2D6d6DDbb17C8d7,0xfCDc25ba0D9D9C16A40506802a50C6c0870d5BC6
317,15627834,3644847,8945915429,3398975,245872,33460,0,,0x3AAE1C87e79f5B62F2A35f168B7e8CE773225f11
318,15627834,223558,8945915429,218282,5276,1548,81,0x881D40237659C251811CEC9c364ef91dC08D300C,0x9e49b18c3748dfBca783407415ef7D21E99fa125
319,15627834,21000,8945915429,21000,0,2,346915,0x24197b03bA6c18399BE52F996BAc29D3E0CA2Ab4,0x77696bb39917C91A0c3908D577d5e322095425cA
320,15627834,21000,8945915429,21000,0,2,1211342,0xFebFcC94750a523034562F67229EaACd5445a4a9,0x95A9bd206aE52C4BA8EecFc93d18EACDd41C88CC
321,15627834,21000,8945915429,21000,0,2,1783197,0x6bd3b825948c164a9141Da8e5ad7f7194E1F0407,0x503828976D22510aad0201ac7EC88293211D23Da
322,15627834,46097,8945915429,45501,596,138,8,0xdAC17F958D2ee523a2206206994597C13D831ec7,0x4fE7ca4c0B7bc79f51C3Aa1253A4acbDDB250785
323,15627834,63479,8945915429,62995,484,202,121,0x59728544B08AB483533076417FbBB2fD0B17CE3a,0x42Aa209d752AD365Dc81a9693E2ee1e2E68E3A6a
324,15627834,100000,8945915429,99024,976,202,88930,0xdAC17F958D2ee523a2206206994597C13D831ec7,0x3018018c44338B9728d02be12d632C6691E020d1
325,15627834,21000,8945915429,21000,0,2,8804460,0xf998341E6321806E569f1C00A416aeECb02eB5b6,0x3cD751E6b0078Be393132286c442345e5DC49699
326,15627834,21000,8945915429,21000,0,2,1783198,0x918960ED7D81689D52B355239269070bc0040D54,0x503828976D22510aad0201ac7EC88293211D23Da
327,15627834,21000,8945915429,21000,0,2,1783199,0xFC7A3AC399B94492A923f27Bd2A60c6F44dc990B,0x503828976D22510aad0201ac7EC88293211D23Da
328,15627834,21000,8945915429,21000,0,2,469148,0xC0EfC6032cF09fef7A7C12be21D1914936Ec395F,0xb739D0895772DBB71A89A3754A160269068f0D45
329,15627834,46109,8945915429,45501,608,138,11017,0xdAC17F958D2ee523a2206206994597C13D831ec7,0xCe352e98934499be70F641353f16A47D9E1E3aBd
330,15627834,90000,8945915429,89392,608,138,93923,0xdAC17F958D2ee523a2206206994597C13D831ec7,0xf89d7b9c864f589bbF53a82105107622B35EaA40
331,15627834,259987,8945915429,254839,5148,1484,92,0x881D40237659C251811CEC9c364ef91dC08D300C,0x096D07fa54BaBFC1c2e4f019D6cb684cE78D00f2
332,15627834,181476,8945915429,179912,1564,394,510,0x1Fa8559e873f698292766790AeCf8080A66433F6,0x268DEc53B71A2e688638419e9A0Fc6204Cd716Ef
333,15627834,85000,8945915429,84512,488,138,661,0xD27dcbcC8778a8AB33AAc529Df36a634567Be325,0xe04014E7812bf6a1F946271b723Cf0928375001B
334,15627834,85000,8945915429,84512,488,138,68,0xD27dcbcC8778a8AB33AAc529Df36a634567Be325,0x4ebd3092255660213AA2Dc4617827a417164B18b
335,15627834,127866,8945915429,127262,604,202,25,0x084b1c3C81545d370f3634392De611CaaBFf8148,0x80a6C0823524F2719233a9129B6AcaCC00CBa6e9
336,15627834,207128,8945915429,206496,632,138,4232319,0x3845badAde8e6dFF049820680d1F14bD3903a5d0,0xDFd5293D8e347dFe59E90eFd55b2956a1343963d
337,15627834,207128,8945915429,207128,0,2,3199164,0x8DAb1e8ecD6Bdccdf912352E53666ef58AE30ABc,0x9696f59E4d72E237BE84fFD425DCaD154Bf96976
338,15627834,207128,8945915429,207128,0,2,1679520,0x7AfCe763Bf28f821beb664D76098FD7c1782c04E,0x4976A4A02f38326660D17bf34b431dC6e2eb2327
339,15627834,207128,8945915429,206508,620,138,4708685,0xe3c408BD53c31C085a1746AF401A4042954ff740,0x28C6c06298d514Db089934071355E5743bf21d60
340,15627834,207128,8945915429,207128,0,2,3492265,0x3A688518e7f61bAcE9b757C41C05231d36Be84e1,0x56Eddb7aa87536c09CCc2793473599fD21A8b17F
341,15627834,207128,8945915429,207128,0,2,4468924,0x381B317Df5c8b8D2A454e72167FCA29aF43436aE,0x21a31Ee1afC51d94C2eFcCAa2092aD1028285549
342,15627834,207128,8945915429,207128,0,2,4232320,0x021946d496e19F6a8d7BBA9BC95BE255EbF684D3,0xDFd5293D8e347dFe59E90eFd55b2956a1343963d
343,15627834,21000,8945915429,21000,0,2,2759931,0x4409297fa9796869d2F524B00726B7f50f19DB5A,0x267be1C1D684F78cb4F6a176C4911b741E4Ffdc0
344,15627834,207128,8945915429,207128,0,2,4708686,0x74fc9F871010Db0D112023c8060167154cE35b6A,0x28C6c06298d514Db089934071355E5743bf21d60
345,15627834,21000,8945915429,21000,0,2,2759932,0xad72542A5CF353dfAC6F8111AC83b6293Ae041DD,0x267be1C1D684F78cb4F6a176C4911b741E4Ffdc0
346,15627834,207128,8945915429,206496,632,138,4468925,0x4a220E6096B25EADb88358cb44068A3248254675,0x21a31Ee1afC51d94C2eFcCAa2092aD1028285549
347,15627834,174779,8945915429,172955,1824,458,175,0x03f7724180AA6b939894B5Ca4314783B0b36b329,0xEcdFFeEF02cde246bb59C4B760D0D0D50d15910f
348,15627834,46256,8945915429,45768,488,138,104,0x27013D274AA60c6e6883AA2130e8b01249EB11d4,0x2BD29af09c6743C7B1CD3358C2ecE9582e20eF09
349,15627834,207128,8945915429,206484,644,138,4468926,0x3506424F91fD33084466F402d5D97f05F8e3b4AF,0x21a31Ee1afC51d94C2eFcCAa2092aD1028285549
350,15627834,205159,8945915429,202399,2760,650,36246,0x7390917c51fa26AFB227cD41B1D7123E8489d1dC,0x6CB44BAb280EAa2D6fb8E798D0081DBF1Ccea50f
351,15627834,207128,8945915429,206472,656,138,4468927,0x4Fabb145d64652a948d72533023f6E7A623C7C53,0x21a31Ee1afC51d94C2eFcCAa2092aD1028285549
352,15627834,207128,8945915429,206508,620,138,4468928,0xdAC17F958D2ee523a2206206994597C13D831ec7,0x21a31Ee1afC51d94C2eFcCAa2092aD1028285549
353,15627834,207128,8945915429,207128,0,2,4468929,0xAC3595a528b0E8C5EC44D0c2C4eE8E22FbebA693,0x21a31Ee1afC51d94C2eFcCAa2092aD1028285549
354,15627834,475440,8945915429,466600,8840,2700,5273,0x881D40237659C251811CEC9c364ef91dC08D300C,0xd0098691479cAdcAcA2F19a8597E6185276227fD
355,15627834,124439,8945915429,124115,324,74,76,0x5eB8A7f4Cee6C69b3207E0CfDD96942466c4791B,0xe2B9A164d70A3D1Cd8AE8b4b41599acB173185f5
356,15627834,21000,8915585536,21000,0,2,40796,0xBEAe018f3A87C8bFF9F99543565C3F1Bc0413C80,0x9715254754284a0b3e4C7BF8f57E790415041c1C
357,15627834,60105,8693888112,60105,0,2,6994,0xFB2875efe1AA73F02d48046Fb2faD0308bc01E5d,0xFB2875efe1AA73F02d48046Fb2faD0308bc01E5d
358,15627834,800000,8618983106,798336,1664,402,46627,0x1111111254fb6c44bAC0beD2854e76F90643097d,0x839d4641F97153b0ff26aB837860c479E2Bd0242
359,15627834,788741,8555915429,777345,11396,3786,17,0xDEF171Fe48CF0115B1d80b88dc8eAB59176FEe57,0xAD1e1F80689c7E53d0FEbF1b435f24545DC071cf
360,15627834,68989,8488915429,68321,668,138,80401,0x4E15361FD6b4BB609Fa63C81A2be19d873717870,0xA294cCa691e4C83B1fc0c8d63D9a3eeF0A196DE1
361,15627834,65154,8488915429,64498,656,138,80402,0x408e41876cCCDC0F92210600ef50372656052a38,0xA294cCa691e4C83B1fc0c8d63D9a3eeF0A196DE1
362,15627834,120000,8488915429,119392,608,138,8449,0xdAC17F958D2ee523a2206206994597C13D831ec7,0xebc18d25d8122da21F73A6BcB78971671f21F6Ff
363,15627834,21000,8488915429,21000,0,2,113032,0xdffD0E2b4CC072Bc5Df2460b429b1543bd1044A6,0x6081258689a75d253d87cE902A8de3887239Fe80
364,15627834,62668,8488915429,62012,656,138,7276,0xF629cBd94d3791C9250152BD8dfBDF380E2a3B9c,0x2660DCBC6a30ac3401C3C4e9F90b78C7A685a68D
365,15627834,400000,8445915429,399796,204,74,5,0x6AE0D3b09f87319807cf1AF13C8eE41832075CB5,0x51BbbD7dcC7d30C5C4162333d9320D467597C8E4
366,15627834,46179,8445915429,45691,488,138,7,0x905030b96eE8F02ba27e3AdC521Fb4D00634De0A,0x7d39d36D3d5E9397C2A76637264C323AC86Eb841
367,15627834,46255,8445915429,45691,564,74,222,0x283Af0B28c62C092C9727F1Ee09c02CA627EB7F5,0x57679F905F9618d50a638cc1fe272003A831cec1
368,15627834,46242,8445915429,45670,572,138,112,0x145ac4EDfFAE802D8260D64e5720E4b210039C71,0xa4b4467BeB88cfaA40F43C684Cd33aCbc5B0beD0
369,15627834,21000,8445915429,21000,0,2,87,0xD54d21D43816A405f9FF7e3EDa4213024444860D,0x1d1425051BCbf8a18255f9ae69bBE2bEeF76821d
370,15627834,46332,8445915429,45844,488,138,2459,0xc3F5E8A98B3d97f19938E4673Fd97C7cfd155577,0xA17138c0675173B8Ea506Fb1b96FA754BC316cc2
371,15627834,142999,8445915429,136407,6592,1810,107,0x00000000006c3852cbEf3e08E8dF289169EdE581,0xCc1dD65746D5910362bE6201D598BE868C83dF32
372,15627834,55924,8445915429,54980,944,138,162,0xa30E3CE725Cefcbb0dDF744ba7FDd30CbA6750f0,0xd99631840cFd0D61c88e884464a691b61f4804AF
373,15627834,238751,8445915429,237979,772,202,148,0xcDA72070E455bb31C7690a170224Ce43623d0B6f,0x0f5c0Dd31f7b122E4203e49Af864C3680373beE3
374,15627834,194337,8445915429,182337,12000,3794,263,0x00000000006c3852cbEf3e08E8dF289169EdE581,0x062082F5b88D7dC0be8260dAb7Dad82A2Ae621De
375,15627834,91981,8445915429,88885,3096,650,180,0x5Fb00386558CCc219e51B69D8e963Ef20b0C267a,0x448b7Ae83c09621804a88aEAaf71b108c0287B8d
376,15627834,405217,8445915429,401637,3580,1162,4208,0x68b3465833fb72A70ecDF485E0e4C7bD8665Fc45,0x4Ed952edDB2DF5EcB924Cab763cC926f10F3F070
377,15627834,21000,8445915429,21000,0,2,453,0xE286B87CC61916191C768d5dD75572af512c3AB4,0x615e3bB7B96A54D80Eb8f6B61Fc1851e399f578d
378,15627834,358003,8445915429,354815,3188,1098,271,0x8731d54E9D02c286767d56ac03e8037C07e01e98,0xe52776d36ef023e1f38B22D35Aee64b4FaCfA6ec
379,15627834,49175,8445915429,48687,488,138,1224,0xf442459c8bB4b891B789E816775232b812Eb2ccD,0x3A90705c017255731C3EcAc6F5BC3Cd9Ac3fAe8b
380,15627834,323964,8445915429,321024,2940,650,12,0x03f7724180AA6b939894B5Ca4314783B0b36b329,0x27Cda06B00a0ecCF4225371792DdE8f1a5eA97EB
381,15627834,21000,8445915429,21000,0,2,4,0x4272Dd8C721133596E1Fe904af7bce6f10E8a84C,0x6f20bFa063Ac0Fb305e0b0156535306CDF0c003e
382,15627834,49175,8445915429,48687,488,138,55,0xD27dcbcC8778a8AB33AAc529Df36a634567Be325,0xA62F52A52A351D63b079517ACA35e6beBf55C474
383,15627834,21000,8445915429,21000,0,2,14,0xb12Cdc0531E510A607537854401276c8560fAa7e,0xa1a900f5c14881B69010c5803812F61C128928c4
384,15627834,21000,8445915429,21000,0,2,10,0x9a2BBc3a1b644Df5AD1E47D810A6Ce7397497115,0xCc12d44EBf0F8b517FDA4E1dAaFb96b3b5aFa986
385,15627834,72878,8445915429,71006,1872,458,98,0xFbdDaDD80fe7bda00B901FbAf73803F2238Ae655,0xC22DE29ef6E65788cb3764fa4Ec114682Aff28B6
386,15627834,21000,8445915429,21000,0,2,4,0xA7eB38F0Bab2EDcd2FD35DD1F20C1a413B210ee8,0x39Fb8Bdc318fC5f9BBB33A05D3913866C1c08981
387,15627834,21000,8445915429,21000,0,2,3,0x4f0B4c8f8e11CD9967f3d81773ECB14047612aa0,0x00E53360375Cc201fDD4b7d93D3c232787A474af
388,15627834,49259,8445915429,48687,572,138,163,0x1B671CdB1F41Ec3d30f6402Bdf3c0e5C4eF277f0,0x5f3c2F785C6e180Acc1ff0389C92eAAb24c981b0
389,15627834,46091,8445915429,45603,488,138,343,0xaDC28cac9c1d53cC7457b11CC9423903dc09DDDc,0xbe6cbAC8Ae6B2516CdC23Ef1F01e078c20F452C6
390,15627834,182322,8445915429,179514,2808,842,17,0x68b3465833fb72A70ecDF485E0e4C7bD8665Fc45,0xdf8963eA56aA915E1497c3d22c8760B12BC6F3f4
391,15627834,289237,8445915429,285921,3316,970,19,0x68b3465833fb72A70ecDF485E0e4C7bD8665Fc45,0xDEB1195c419C54bC6a4dD55bb0D4fe9B18FA21F9
392,15627834,46267,8445915429,45691,576,74,200,0x283Af0B28c62C092C9727F1Ee09c02CA627EB7F5,0x79B3b99476f44B2bC0288c4396B260f6DFC79597
393,15627834,151639,8445915429,145039,6600,1802,129,0x00000000006c3852cbEf3e08E8dF289169EdE581,0xa2492E3Bc1710252485AaE71013ec25580110E98
394,15627834,46663,8445915429,46175,488,138,2460,0xC8100dD81e0D8D0901b7b5831e575b03E1489057,0xA17138c0675173B8Ea506Fb1b96FA754BC316cc2
395,15627834,46267,8445915429,45691,576,74,7,0x283Af0B28c62C092C9727F1Ee09c02CA627EB7F5,0xDa70fB6592450C4520f23a2E1AE8CE3CCA335294
396,15627834,204885,8445915429,204645,240,74,80,0xf11ED77fD65840b64602526DDC38311E9923c81B,0x27c1F5eBCA3F721Cc44C19b650cbd8D48Ff6c205
397,15627834,305865,8445915429,302549,3316,970,0,0x68b3465833fb72A70ecDF485E0e4C7bD8665Fc45,0x8055B3B38E938F44252E83ec56E2c055A86a64d4
398,15627834,36015,8445915429,35751,264,74,71,0xC02aaA39b223FE8D0A0e5C4F27eAD9083C756Cc2,0x4Ba4bED31fE23143C365941b52b8a6aC33A05188
399,15627834,169883,8445915429,163055,6828,1802,287,0x00000000006c3852cbEf3e08E8dF289169EdE581,0xB569A24f09faB23A166074ad21E04FB346e59eD5
400,15627834,21000,8445915429,21000,0,2,456,0x9CAb85210e4F82f2128c0975429c256e31FdEfC5,0x70a429f92465e512884B4e8DfDaA3e0Bb077aCa2
401,15627834,49175,8445915429,48687,488,138,225,0xeF3739eE528B8D74D0C2a906Aa469C67233c6B44,0xc33D0dBbdB6ABEDC0A2b6f6B7B5a4015C4e22B26
402,15627834,221140,8445915429,219188,1952,522,20,0x1B671CdB1F41Ec3d30f6402Bdf3c0e5C4eF277f0,0xE9C06525B38E1B4738Ff3ed2306cC23227F987e2
403,15627834,21000,8445915429,21000,0,2,401,0xa8238d516f15Ddb468eae4D05a20B93A138e7b51,0x1f3BaA7fb44D58025B28Af654182C66e058CE806
404,15627834,143796,8445915429,143592,204,74,23,0x7F9306FC1978938d5C1C57Bf6044dc67E07eeB8a,0x9a153C18A5489E97c51f76aF07f07FcB08471A2a
405,15627834,190465,8445915429,187657,2808,842,605,0x68b3465833fb72A70ecDF485E0e4C7bD8665Fc45,0xEF54CC23f3709B0d68BBa422038152d572bFf830
406,15627834,83139,8445915429,82187,952,202,52,0xba30E5F9Bb24caa003E9f2f0497Ad287FDF95623,0x58d057a9F7b5825f3aCeEFB3af79e6E1baCdF4e9
407,15627834,46065,8445915429,45577,488,138,1263,0x9777F2c85713f05356Da1B43BcE02b30bdA1bF69,0x6B29380bb9955D5b2dF1624c5C6a72a5E69a6b80
408,15627834,99244,8445915429,98636,608,138,1,0xA0b86991c6218b36c1d19D4a2e9Eb0cE3606eB48,0x556eC8F8c3db2AFB1a2C41DF7977eE602763d12D
409,15627834,143335,8445915429,136711,6624,1802,5796,0x00000000006c3852cbEf3e08E8dF289169EdE581,0x2f3A54BF279d3CDc31DD363E380c69346EFd2d9d
410,15627834,218243,8445915429,216555,1688,330,1,0xE284c1277762E639Ea818611E96109548470A466,0xfa41E58b32972630F769B98bC1FA749315a167f3
411,15627834,1155629,8445915429,1152245,3384,1418,389,0xFC2d7c0FD2D353923D47cCD2409f8Ee19e86fd29,0x7ECB7A50d54d7985604DBa59aCB2705B0871572C
412,15627834,191740,8445915429,188100,3640,1162,230,0x68b3465833fb72A70ecDF485E0e4C7bD8665Fc45,0xf58f66Cb1ab1cEf422e193f7Cc70ee96e3a658BD
413,15627834,46619,8445915429,46131,488,138,2461,0x01a9f037d4Cd7DA318ab097a47aCD4DEA3ABc083,0xA17138c0675173B8Ea506Fb1b96FA754BC316cc2
414,15627834,163869,8445915429,157217,6652,1810,206,0x00000000006c3852cbEf3e08E8dF289169EdE581,0x58c0c31F09286bB66526DDaf646Fa2746AE6ed77
415,15627834,21000,8445915429,21000,0,2,3,0xAd0a048d4268C45Fd6f6e9664bC00343d0c5c3cE,0x296D3B1439453D6C7F23C30a0b7c81c30cd1C4C4
416,15627834,96817,8445915429,96541,276,74,327,0xfc4913214444aF5c715cc9F7b52655e788A569ed,0x32bFfc19c880DfFb51667c402D8068B02A036B34
417,15627834,46506,8445915429,45562,944,138,139,0x73968b9a57c6E53d41345FD57a6E6ae27d6CDB2F,0x0B86b1bccBb0222c8d877EfAD8fB06c4116AFA08
418,15627834,73188,8445915429,72580,608,138,1,0xA0b86991c6218b36c1d19D4a2e9Eb0cE3606eB48,0xdb870741c877dc739a974ADAD2d5a7EEB4c413D2
419,15627834,21000,8445915429,21000,0,2,4,0x850Eb0195a28e202fDEc9aDe2cc6511c69d6142D,0x370cc10aef78F07418E76Aa383B92A6cd7BB853f
420,15627834,135599,8445915429,128835,6764,1698,310,0x00000000006c3852cbEf3e08E8dF289169EdE581,0x1bE7340d3067850824F54860aee9cb22ED78629e
421,15627834,401883,8445915429,398267,3616,1162,200,0x68b3465833fb72A70ecDF485E0e4C7bD8665Fc45,0xDCc2a7727A0cc230D065068BbEAf0311864220C2
422,15627834,51988,8445915429,51044,944,138,57,0x72B169AD8aF6c4FB53056b6a2A85602Ad6863864,0x1834885235A6FDac300a0D92bbea5B76A2822fdd
423,15627834,52099,8445915429,51611,488,138,1,0x3E707eaDBfdb6faa57f55a6295F40f8f925179Ec,0xf474B093bad5D9FaCdA6F5Ac146cF18220d6eB47
424,15627834,46163,8445915429,45603,560,138,445,0x9d860AFBc78BFB8f5F551160eD7Cfa4cBB204045,0x79a069e0e7e9B646C8C9a5B329f926202eBa077f
425,15627834,50706,8445915429,50110,596,138,8,0xdAC17F958D2ee523a2206206994597C13D831ec7,0xA014F4532C8C5AA5d24EDa91AB1aBE4686F78C76
426,15627834,55926,8445915429,54982,944,138,22,0x456cD8af1E936AD47a31579A5fB462393c6A6851,0x8001E22B2b3948E8B2cEDCa34e0c1eAF24a7B648
427,15627834,291576,8445915429,289156,2420,522,107,0x283Af0B28c62C092C9727F1Ee09c02CA627EB7F5,0x4D631b7130f4d6c46C5469d17D4B4aa9dE905378
428,15627834,299359,8445915429,296159,3200,906,223,0x68b3465833fb72A70ecDF485E0e4C7bD8665Fc45,0xa7C1d32B4bB7155Ad5e9e53F472b9CE61BB37ddc
429,15627834,46641,8445915429,46153,488,138,151,0x345974220a845DdeCEed011e8e6106b59724b661,0x7cc26b600eC01F23209ba6fc80322Af5BD2B7155
430,15627834,46368,8445915429,45880,488,138,2462,0x788defd1AE1e2299D54CF9aC3658285Ab1dA0900,0xA17138c0675173B8Ea506Fb1b96FA754BC316cc2
431,15627834,46267,8445915429,45691,576,74,40,0x283Af0B28c62C092C9727F1Ee09c02CA627EB7F5,0x466a9935322BC74bF2A332D4aA736D46B5fa45fE
432,15627834,46348,8445915429,45680,668,138,530,0x67954768E721FAD0f0f21E33e874497C73ED6a82,0xB156C425F325d750968702D4Bd4226573EDC3aED
433,15627834,21000,8445915429,21000,0,2,571,0x0F8176c597aA2136b54bCA3F10e098c668fA2CcB,0x80664c7312615eD5d7c022299788f2EC6Cf5A4d0
434,15627834,60691,8445915429,53271,7420,2506,154,0x00000000006c3852cbEf3e08E8dF289169EdE581,0x6fcc8d17b177C95DbbE74F2B00917C200A6A85c2
435,15627834,46707,8445915429,46219,488,138,5,0x47Bd71b482B27eBDb57af6e372cab46c7280bf44,0x133dE21365966e1C2919f67Cd98122592cFc2DE1
436,15627834,88338,8445915429,84706,3632,1098,8,0x076F605BF8d2bD03c991cECcc2B4a1d5bC50BaaB,0xB88714B9175fe49E7401F4b1eEE82E99573DD09A
437,15627834,29219,8445915429,28587,632,138,17,0x045da4bFe02B320f4403674B3b7d121737727A36,0x697579242F5579e0BEF93763e7B48917dA186523
438,15627834,2000000,8392746618,1997940,2060,522,401,0x7a250d5630B4cF539739dF2C5dAcb4c659F2488D,0xC1604496e206B7ff546c602Fdd5Ab69cF15f3DA7
439,15627834,2000000,8392746618,1997940,2060,522,474,0x7a250d5630B4cF539739dF2C5dAcb4c659F2488D,0xCa6b060a4E795473a2205ebD1ff2599A8bEF1DF8
440,15627834,150000,8351932591,149760,240,74,638770,0xA0b86991c6218b36c1d19D4a2e9Eb0cE3606eB48,0x55FE002aefF02F77364de339a1292923A15844B8
441,15627834,150000,8351932591,149392,608,138,638771,0xA0b86991c6218b36c1d19D4a2e9Eb0cE3606eB48,0x55FE002aefF02F77364de339a1292923A15844B8
442,15627834,292969,8270394783,289393,3576,686,196478,0x0000000000007F150Bd6f54c40A34d7C3d5e9f56,0x0197ABe48f0a9826D10F44DaD7050f26586Eb9bA
443,15627834,56667,8164463636,55723,944,138,1047,0xB97Ad583dacB8Bd46F75b3593c6eF2ec598Ef37e,0x9E4759Fa9746c2aEe65A6D8acdBADA77AeFB92E7
444,15627834,125000,8133384385,124392,608,138,44689,0xdAC17F958D2ee523a2206206994597C13D831ec7,0x79672062c5a45E3808D6B784129Cf3eCF59d4224
445,15627834,218644,8105077760,215984,2660,714,3494,0x6fBF1b6A681307f86c2d212f0f6Ad72621309eF1,0xB26D9424F0F435C8b10ed478Af36Da8Ca7D5B095
446,15627834,216211,8105077760,214327,1884,458,3229,0xEfF92A263d31888d860bD50809A8D171709b7b1c,0x7D26D3bD8e5EEe24697ECDF4f7b41C2CA2F92F30
447,15627834,184180,8105077760,172628,11552,3594,577,0x74312363e45DCaBA76c59ec49a7Aa8A65a67EeD3,0x346B81Ba12Cb74e9f4E635b10E3B28154268B022
448,15627834,51334,8105077760,50738,596,138,1,0x083D41d6DD21EE938f0c055CA4fb12268DF0EfaC,0x72DD6b14308aaE6362F6e42d4ce2ea5F1b34282c
449,15627834,51352,8105077760,50744,608,138,0,0x083D41d6DD21EE938f0c055CA4fb12268DF0EfaC,0xA099d1e8bd76eDFB10fe8F62DBe5A3B150b60f0C
450,15627834,353058,8011260135,351942,1116,146,286,0xdb7A53E6AE058E1Dcf4502341E2ADFA522E2B29F,0xa23cABeCa2145Ce4e6fdD81a45be8fB53A4F9535
451,15627834,385711,8011259135,384595,1116,146,397,0xdb7A53E6AE058E1Dcf4502341E2ADFA522E2B29F,0x679C45ee70B4FC42f6d6367EC70eeE69B744d0e2
452,15627834,30000,8000000000,30000,0,2,3196,0x3e6722f32CBE5b3C7BD3dcA7017c7FfE1b9E5A2A,0x2240FFCB2330177D49578954B11445d7C7Db1e29
453,15627834,1630468,7945915429,1628840,1628,522,24,0x9eB2Ce1be2DD6947e4f5Aabe33106f48861DFD74,0xBb9071e928C92020C65c4EdB955C71Ad04555601
454,15627834,113310,7945915429,113106,204,74,879,0x5D004ddB5D92938dAF8448b9eac1CaA593cd26Ca,0x0dA477DC4C97eF0eb894E8bA1ac52Ab0a5D4Ed87
455,15627834,196344,7945915429,194656,1688,330,30,0x70F6a907D792Ca5e0cd14A6d502990D87Ed8EC91,0x4d08Ed1d821e89c3DD47f5C16F352C6860B4EAd4
456,15627834,73188,7945915429,72580,608,138,2,0xA0b86991c6218b36c1d19D4a2e9Eb0cE3606eB48,0x6A5a268C5B6Fdb54120D9738F175267b47686913
457,15627834,196344,7945915429,194656,1688,330,36,0x8095de89DFea094cc3B9c1BEe08092bbfcB78De9,0x532fbC7a9B4D8DbBC01cFa7c7DC97be19D5edb81
458,15627834,288750,7945915429,285082,3668,906,0,0x197492CCB4B1acaAAcd43432657A17832E36AB49,0x9B1258E768aA21Cb248A303613121Af7f4B8CAb8
459,15627834,240028,7945915429,239824,204,74,1,0x6b6fa17ce72EDd3bf092D4DA66a45Aab87750867,0x6D2A8671b26c2128861F6f82eE654eb91A63C719
460,15627834,216000,7945915429,215404,596,138,161,0x4527a3B4A8A150403090a99b87efFC96F2195047,0xCD2bA98fA75B629302b3e919A49ef744EB639D59
461,15627834,150756,7945915429,150692,64,10,22,0x65c2e54a4c75ff6da7b6B32369c1677250075fb2,0xa8C2684d38f04d21Ad980c7047BF5A189097846D
462,15627834,162020,7945915429,161792,228,74,130,0x4Ddc2D193948926D02f9B1fE9e1daa0718270ED5,0xe8787b5a359c30318D9b805651D18275f33Fa1Bd
463,15627834,42919,7945915429,42715,204,74,194,0x55f1C36Bb7aE0d7D6caE97902E30A2306686Ec73,0x5bAB06Aab8aEcD0E60c8287391233F2285ad7071
464,15627834,777213,7945915429,776641,572,138,29,0xc2D35270a022829c8EEA3B6A33aCd096AFDF65AC,0xb33ACF7cFB1Ee9FA342dEE509cc9348e359aBB99
465,15627834,250000,7945915429,250000,0,2,45337019,0x94A54a4955ca22b432Db06Ab0139c02B3a588cF7,0xEA674fdDe714fd979de3EdF0F56AA9716B898ec8
466,15627834,250000,7945915429,250000,0,2,45337020,0x86E4Acb69B5e06eD7A3F75edA232452b61Addf59,0xEA674fdDe714fd979de3EdF0F56AA9716B898ec8
467,15627834,250000,7945915429,250000,0,2,45337021,0xE0F093c4D651DD1A5B8764E30E7553a8120Cf2dB,0xEA674fdDe714fd979de3EdF0F56AA9716B898ec8
468,15627834,250000,7945915429,250000,0,2,45337022,0x7f45F109c04654fFA2B768b7798766a5B5f4c895,0xEA674fdDe714fd979de3EdF0F56AA9716B898ec8
469,15627834,250000,7945915429,250000,0,2,45337023,0x4C2f06F5fD5f4f420C1EFB46521153bEDae55972,0xEA674fdDe714fd979de3EdF0F56AA9716B898ec8
470,15627834,250000,7945915429,250000,0,2,45337024,0x83ea198770d6FFf3B26deb60e6A75066Dd28916D,0xEA674fdDe714fd979de3EdF0F56AA9716B898ec8
471,15627834,250000,7945915429,250000,0,2,45337025,0x035044E86fe53c2bfE0752C92E9A91dC8737e4Ff,0xEA674fdDe714fd979de3EdF0F56AA9716B898ec8
472,15627834,250000,7945915429,250000,0,2,45337026,0xB36e0950Ff3a1ff7b20FBa99C7802d3064F697ab,0xEA674fdDe714fd979de3EdF0F56AA9716B898ec8
473,15627834,250000,7945915429,250000,0,2,45337027,0x1C8f8E87C6b034B7670EaA0df86d96472D6c90d1,0xEA674fdDe714fd979de3EdF0F56AA9716B898ec8
474,15627834,250000,7945915429,250000,0,2,45337028,0xEe9c3B4E562E67cEafa6bDDA1a6e1541948704Aa,0xEA674fdDe714fd979de3EdF0F56AA9716B898ec8
475,15627834,250000,7945915429,250000,0,2,45337029,0x24b605aaa85303AE57a790c2843161A9C34085FD,0xEA674fdDe714fd979de3EdF0F56AA9716B898ec8
476,15627834,21000,7945915429,21000,0,2,100,0xf7246349B50B35E33d97dAACF5119358Ab7a3b71,0x3bF66C1E5651Ca5C11eC985B436CaeBaef000bbB
477,15627834,135730,7945915429,135526,204,74,154,0x4556561740B7B5F858967A6a4E54e506609704Bd,0x90EF9D4125570c1C6190B19aDf52A8c7146009EB
478,15627834,294006,7945915429,290694,3312,1034,484,0x68b3465833fb72A70ecDF485E0e4C7bD8665Fc45,0x7862958ee0797a7ABD33A65030fC608a656febB7
479,15627834,46135,7945915429,45647,488,138,181,0x1Fa8559e873f698292766790AeCf8080A66433F6,0xC99e255f88E39889A5FeC0B8D58A2Dba426BEcd8
480,15627834,181476,7945915429,179912,1564,394,1708,0x1Fa8559e873f698292766790AeCf8080A66433F6,0xf637D3eb55AD7f859543d1B5bd4BbCF93B6fa5A5
481,15627834,21000,7945915429,21000,0,2,159,0xd638E38Bc48300Ef03A65dd0c71d0201F4A8eAfc,0xb46474ED447403367b6fB561B353C1C5995f059F
482,15627834,148179,7945915429,147975,204,74,77,0xd22C10aaCCd20292B06F956d9055B3F693E97dF7,0x6C29F11f94e10F958B51267478d68a57cA4b454B
483,15627834,293475,7574178753,283719,9756,2954,20544,0x9008D19f58AAbD9eD0D60971565AA8510560ab41,0xc9ec550BEA1C64D779124b23A26292cc223327b6
484,15627834,397081,7490056603,395965,1116,146,384,0xdb7A53E6AE058E1Dcf4502341E2ADFA522E2B29F,0x214f12E4eDD3F8d0983833F4645fcEE3EDcf6336
485,15627834,376533,7490055603,375417,1116,146,526,0xdb7A53E6AE058E1Dcf4502341E2ADFA522E2B29F,0xb0F114C155921f56e548AC3f0EeA5E28ac4Ab2fe
486,15627834,331953,7490054603,330837,1116,146,411,0xdb7A53E6AE058E1Dcf4502341E2ADFA522E2B29F,0x43930DC6DA994737Af679d5C196998E487Ff349d
487,15627834,143796,7480206897,143592,204,74,2,0x7F9306FC1978938d5C1C57Bf6044dc67E07eeB8a,0x5D2a22896Ab8D4F3A623D7C51a38C339e037F162
488,15627834,150756,7453711548,150692,64,10,2,0x65c2e54a4c75ff6da7b6B32369c1677250075fb2,0x88CdbcCbC05A2bd37d4F8C76AAd8820Fc2d7ceb0
489,15627834,69633,7453711548,68689,944,138,59,0xaaAEBE6Fe48E54f431b0C390CfaF0b017d09D42d,0x51Dd6D50C0C46564a792028FDDf10E61573c0630
490,15627834,56659,7453711548,55715,944,138,307,0xAD13C2a8d418d01F3236F4d8b9d724575a4e9d24,0x14a6a449B1177c74b01983f9a2E60A1e5e07c418
491,15627834,150756,7453711548,150692,64,10,14,0x65c2e54a4c75ff6da7b6B32369c1677250075fb2,0xfB0B232912F8636749ec045635DeE863247208E5
492,15627834,120000,7233498542,119392,608,138,38,0xdAC17F958D2ee523a2206206994597C13D831ec7,0x22b7c79966f14834a590426b5B25e9a59EB7aC6F
493,15627834,21000,7233498542,21000,0,2,15,0x974CaA59e49682CdA0AD2bbe82983419A2ECC400,0x4544D31BC8b25429438a0cFE80D22cEAAE51f140
494,15627834,807241,7228563262,801381,5860,1546,18,0x5DBC7B840baa9daBcBe9D2492E45D7244B54A2A0,0xAcEe688Ffbf7bb2E5af85E4A220AA540418F2dA5
495,15627834,51231,7000000000,50287,944,138,22,0xF345754D715fb208F7b3965FA5fA0B4Cff2dFE8f,0x03f08c89362DC4d3416ab59e6947fC313f6202bd
496,15627834,59307,7000000000,58819,488,138,45,0x6de7aC835EC6841Af9b94fd1273dB83B8d69e3f7,0x7E63Ff6A16419E36879BB1e6152D1A61E66F531d
497,15627834,51302,8205915429,50814,488,138,46,0xCF3bc939f9B2487092936F21cC0757b2b523B7aA,0x7E63Ff6A16419E36879BB1e6152D1A61E66F531d
498,15627834,21000,7000000000,21000,0,2,15,0x9C4c2553a37b40024E1Ee8046c01Cd7b0Fd309ab,0xeB83D803d4d92cb418fd12C3Ee451D8b11BA79FD
499,15627834,21000,7000000000,21000,0,2,165,0x2e12b76418DC10A45A372E1537eD85C0B138a342,0xa2AF49cDd106cf657A50B0BB0626e0a554db0692
500,15627834,21000,7000000000,21000,0,2,373,0xC1105641d5ddaCD4ef4b91d8431389fe9c7C619C,0xfC7c37a4b74958f9f2361592C1F7B8f166EEb270
501,15627834,77241,7000000000,76573,668,138,246,0xf4d2888d29D722226FafA5d9B24F9164c092421E,0x165896732df25087eba4e736604559CEaFdfC82F
502,15627835,307602,102357817378,306322,1280,264,12403,0xBEEFBaBEeA323F07c59926295205d3b7a17E8638,0x9cf269bc104648718922689DF44d7AEeb6F33Db7
503,15627835,21000,19524512574,21000,0,2,26,0x3B794929566e3Ba0f25e4263e1987828b5c87161,0x1b41f5A28Cf8eDB597983e77A237b8930252327D
504,15627835,21000,19927887667,21000,0,2,27,0x000F422887eA7d370FF31173FD3B46c8F66A5B1c,0x1b41f5A28Cf8eDB597983e77A237b8930252327D
505,15627835,21000,20026982740,21000,0,2,28,0x3B794929566e3Ba0f25e4263e1987828b5c87161,0x1b41f5A28Cf8eDB597983e77A237b8930252327D
506,15627835,413252,17074873148,405288,7964,1524,196479,0x0000000000007F150Bd6f54c40A34d7C3d5e9f56,0x0197ABe48f0a9826D10F44DaD7050f26586Eb9bA
507,15627835,21000,11820000000,21000,0,2,30,0x2a1EB42c3E4907Cf98cF0117460C037f291eDbF6,0x2EeA822E08A90e0B5F916fC3b184267d369Cf2C8
508,15627835,400000,11808429050,393688,6312,1802,626,0x00000000006c3852cbEf3e08E8dF289169EdE581,0x07Ea687C51103D3Ea021c019e2B2ffFA40FCa432
509,15627835,51706,11674828640,51086,620,138,50,0x467719aD09025FcC6cF6F8311755809d45a5E5f3,0xD0c10500c50CE5BD054Cae8a829f2610B225d7Ac
510,15627835,80492,11606144081,79860,632,138,355143,0x514910771AF9Ca656af840dff83E8264EcF986CA,0x7abE0cE388281d2aCF297Cb089caef3819b13448
511,15627835,170280,10808429050,166652,3628,970,67393,0xa81011Ae274eF6deBd3BDaB634102c7b6c2C452D,0x963737C550E70FFe4D59464542a28604eDb2eF9a
512,15627835,329014,10308429050,324682,4332,1034,3,0x197492CCB4B1acaAAcd43432657A17832E36AB49,0x307E811b5399a357918757C5BB834f7d236a9bE5
513,15627835,270604,9808429051,268384,2220,650,11892,0x5050e08626c499411B5D0E0b5AF0E83d3fD82EDF,0x36d63E35446bAf55893a710cFE6dBDd300ECe496
514,15627835,203473,9808429050,200737,2736,842,97,0x68b3465833fb72A70ecDF485E0e4C7bD8665Fc45,0x39F954C8674009e4bD03c4AFb36ccAf1732D3F7b
515,15627835,21000,9808429050,21000,0,2,6029,0xaf95cE153c5f30EF5b1800F625D5b9E49e447e5a,0x65768f7e9448595181271a0Af9A2351D383ace1a
516,15627835,196350,9808429050,189698,6652,1810,96,0x00000000006c3852cbEf3e08E8dF289169EdE581,0x737DCe458eFC5ae64C9f793e00824DE1E5F9c38c
517,15627835,364976,9808429050,363848,1128,266,8,0x7d2768dE32b0b80b7a3454c06BdAc94A69DDc7A9,0x9C312C8551E82D48ba1947CFeb37Fd7bba668414
518,15627835,42000,9808429050,42000,0,2,329509,0xCE490505422Ffad1aB459641f1c14a79b4D24766,0x9430801EBAf509Ad49202aaBC5F5Bc6fd8A3dAf8
519,15627835,847476,9808429050,794200,53276,7182,24,,0x3317a5241c9deAA134660369C54C54A3709d1A2a
520,15627835,100000,9762399463,99368,632,138,1050377,0x4a220E6096B25EADb88358cb44068A3248254675,0xf16E9B0D03470827A95CDfd0Cb8a8A3b46969B91
521,15627835,21000,9465052305,21000,0,2,3,0x3f4995bCB381dD7d97BEDb09573B22c68Acb39eC,0x854C7A737dE81542412C1c2abEaA3606b16259C6
522,15627835,252650,9459929051,252650,0,2,111037,0x36a454aEF52938c8637CD4689B2980C1Cfd43389,0x36a454aEF52938c8637CD4689B2980C1Cfd43389
523,15627835,278324,9459929051,276032,2292,650,119378,0xA69babEF1cA67A37Ffaf7a485DfFF3382056e78C,0x0cac3d1a887206e0f6169222C4504301A8b4b993
524,15627835,21000,9351429050,21000,0,2,113033,0xBdc68fe8Eb22008F52c8F32BE77e222Cc5c546FB,0x6081258689a75d253d87cE902A8de3887239Fe80
525,15627835,49701,9318429050,48757,944,138,175,0x5a6A4D54456819380173272A5E8E9B9904BdF41B,0x6792c4bDc1b45EfA131ecCa985A28EF5c4622E48
526,15627835,270830,9308429051,268610,2220,650,12845,0xA69babEF1cA67A37Ffaf7a485DfFF3382056e78C,0x1a54220656FA426a20331141324260398A549314
527,15627835,46103,9308429050,45615,488,138,153,0x34Bc797F40Df0445c8429d485232874B15561728,0x26c8a2C7175F53fc85438D343B5d5C2cC5F46751
528,15627835,286254,9308429050,282914,3340,970,1,0x68b3465833fb72A70ecDF485E0e4C7bD8665Fc45,0xf51fEaa6D573B93dF0B0A10Dad68330366C89021
529,15627835,47029,9308429050,46965,64,10,46,0x00000000006c3852cbEf3e08E8dF289169EdE581,0x0565df3f5aad5a45D340B98D1e95F255e238cDc3
530,15627835,46052,9308429050,45564,488,138,706,0xb967D2335A3879b7CAE42E085f88274EBff90Fc4,0x9b6cd0Ff5789748aA352a9257C13Be99126f3fB2
531,15627835,65048,9308429050,64104,944,138,2,0x2a3bFF78B79A009976EeA096a51A948a3dC00e34,0x7Cd5E31875A0F3D96D01A8bcDD074844593C2434
532,15627835,230984,9308429050,230628,356,138,178,0x2b591e99afE9f32eAA6214f7B7629768c40Eeb39,0x76525783B4AFB360A22499D3D994DF564F63CD69
533,15627835,146954,9308429050,140402,6552,1802,316,0x00000000006c3852cbEf3e08E8dF289169EdE581,0xccAD221D9c55EFe5F46E69867e94698320B54dF4
534,15627835,46088,9308429050,45600,488,138,330,0x5D004ddB5D92938dAF8448b9eac1CaA593cd26Ca,0x26DC5D39Bd7A8bc2d792dcAAAC55FE6DCef25593
535,15627835,46016,9308429050,45528,488,138,2463,0x495f947276749Ce646f68AC8c248420045cb7b5e,0xA17138c0675173B8Ea506Fb1b96FA754BC316cc2
536,15627835,46103,9308429050,45615,488,138,715,0x34Bc797F40Df0445c8429d485232874B15561728,0xc1F11eF44d825EB9965AB1B38992eD2898B62Dd0
537,15627835,298257,9308429050,291369,6888,3146,192,0x726E1d384124e0A0c65602c350d581f2318228b8,0x24BcC4F72B185C4a344AC8Dd7B9ae0f57D677C53
538,15627835,21000,9308429050,21000,0,2,136,0x965a3fF80fF0eb2DF11572bDa7b90856156ADDF7,0xcA5AD8bB2214F552cE18e69Ffe50A2aD9b6749bc
539,15627835,46267,9308429050,45691,576,74,256,0x283Af0B28c62C092C9727F1Ee09c02CA627EB7F5,0x34A19a7fd3383e89C943B3E44073c4d21837695C
540,15627835,46278,9308429050,45706,572,138,81,0x0477A628Bd5722F56646B094126d4489B121B5ea,0xFB96D60ce3ee83ed4BC71c6E0da10C537601b77C
541,15627835,21000,9308429050,21000,0,2,0,0xf4fa63Ad7E654e467E144A1C8F7D2d1384F32569,0x9bA001DdC8d73449c52451DC927ea82C00b40034
542,15627835,45038,9308429050,44974,64,10,135,0xC02aaA39b223FE8D0A0e5C4F27eAD9083C756Cc2,0xfD47E00B023e9928f3Ff0b1ed97776e135c4cAd4
543,15627835,69951,9308429050,68223,1728,458,177,0x495f947276749Ce646f68AC8c248420045cb7b5e,0x511077d1505D3e5AE2A5Aa4D7188f316A1228cAd
544,15627835,46686,9308429050,46198,488,138,1754,0xf4FaB8D5dd1A7d347de09471B8d24FEDB9c3315d,0xD5fF53f48F14e9409B581e41a4cDDFe0E97Dc724
545,15627835,255450,9308429050,252146,3304,970,182,0x68b3465833fb72A70ecDF485E0e4C7bD8665Fc45,0x6BfE59e8fEaDDfBdBb97F7Da8c6B4550a8bD4ffd
546,15627835,64607,9308429050,63767,840,266,19,0xfc33E8b6E160A81DdB442B07355D01DF711EFEee,0xdBd8642Fc457dA6275d854571358dAE55CE96D3F
547,15627835,51706,9308429050,51038,668,138,911,0x549020a9Cb845220D66d3E9c6D9F9eF61C981102,0x50729246D44Ad421Ac22ADFc339E0F2B79239dE1
548,15627835,382640,9308429050,379300,3340,970,14,0x68b3465833fb72A70ecDF485E0e4C7bD8665Fc45,0x16393fCEd4Ca637a3699cfF8e4E0eFcb7aF16bC9
549,15627835,46750,9308429050,46262,488,138,38,0xBa9e9E3C437eE98b88973b95e405Fb5092939917,0x6ecB6Da313891Ac6aED8Cf63a188d9b308f084DA
550,15627835,83808,9308429050,83236,572,138,134,0x5CC5B05a8A13E3fBDB0BB9FcCd98D38e50F90c38,0x43DD2d966D661e65a06861Aa42B9137D452E421E
551,15627835,232805,9308429050,213841,18964,4618,699,0x00000000006c3852cbEf3e08E8dF289169EdE581,0x485D183Bb27af4B1E8e3c2b69a92f41f918F92bD
552,15627835,245914,9308429050,242286,3628,1162,1076,0x68b3465833fb72A70ecDF485E0e4C7bD8665Fc45,0xC4C80f9917a537a41b27825E4B55c6bd4A5b4b95
553,15627835,4815941,8808429050,4479621,336320,113226,143,0x83C8F28c26bF6aaca652Df1DbBE0e1b56F8baBa2,0xDe84c0d2f56523c46D3D0083543D9FEe6a75F7E3
554,15627835,219338,8808429050,216614,2724,842,82,0x68b3465833fb72A70ecDF485E0e4C7bD8665Fc45,0x8F8d47F74C5E3144ab242e82Fa621D9A383C2df7
555,15627835,237349,8808429050,234517,2832,842,69,0x68b3465833fb72A70ecDF485E0e4C7bD8665Fc45,0x66f54Ca911390De3F6C92158a7c516B4B169fBd0
556,15627835,354654,8808429050,346682,7972,1162,25,0x84927e55Ed03EA00732F17FdAA89f482AD12c005,0xBeD84af8cC672cE154dC1f5A7255771Dbb15Ec46
557,15627835,101263,8808429050,100691,572,138,37,0x1Fa8559e873f698292766790AeCf8080A66433F6,0x450423ddFf2125B52EC524c8ec35B46552054aBc
558,15627835,29246,8808429050,28302,944,138,114,0x00000000000C2E074eC69A0dFb2997BA6C7d2e1e,0xe2939E609643d097b695a00ff8e1cddC74B139e3
559,15627835,21000,8570000000,21000,0,2,259896,0x739DA3B0522790530D61862445De86ed655E25E2,0x292f04a44506c2fd49Bac032E1ca148C35A478c8
560,15627835,8000000,8560061260,7999936,64,10,15097,0xf50b537Bfb9D115DEf055519EE4059ffC664EF77,0xb2AA4a5DF3641D42e72D7F07a40292794dfD07a0
561,15627835,184270,8442300698,178274,5996,1674,78,0x00000000006c3852cbEf3e08E8dF289169EdE581,0x58Be12fb15B03D55E4bc91Fbd1F6f9472C45395b
562,15627835,21000,8442300698,21000,0,2,10,0xdb8EFCDe93CDa85E84C5c8F943166F88951085d5,0x12bD20c1B3CA78Fe7f5dB06a0fE459d247f3491C
563,15627835,170689,8442300698,170485,204,74,4,0x7F9306FC1978938d5C1C57Bf6044dc67E07eeB8a,0x1ae15D4a7260018F3365a071DF6b5C0F59B676af
564,15627835,53483,8379645473,52539,944,138,40,0x4e3FBD56CD56c3e72c1403e103b45Db9da5B9D2B,0x64974Bcdb6e3ccA6035804D80550Bc7DFbDc6CfE
565,15627835,143796,8342720518,143592,204,74,3,0x7F9306FC1978938d5C1C57Bf6044dc67E07eeB8a,0x5D2a22896Ab8D4F3A623D7C51a38C339e037F162
566,15627835,182565,8342720518,181165,1400,402,7,0x1111111254fb6c44bAC0beD2854e76F90643097d,0x40fC24Da69AA37268c87F6c076F0b0a3917B6304
567,15627835,29929,8342720518,29865,64,10,199,0x00000000006c3852cbEf3e08E8dF289169EdE581,0x355270e826ab9297f3F7ce2aa2E60ee67f7a2094
568,15627835,21000,8316225169,21000,0,2,5,0x04D0cc60f70fF0E06fbeAFA547602D833f613EB4,0x7B4802Ae4778B7967B646d8339447C039326ebE8
569,15627835,21000,8203392042,21000,0,2,1,0x6e96bBB46bf813C88260Dcf3269E7F17B0C63a08,0xe4598d7d4b40B3BaBDb3b40B2A43b0c2D04E3E24
570,15627835,21000,8203392042,21000,0,2,0,0x6e96bBB46bf813C88260Dcf3269E7F17B0C63a08,0xF43798cFBc0491CD526cF144A20c914689f8686d
571,15627835,235212,8046029587,224572,10640,3402,59,0x00000000006c3852cbEf3e08E8dF289169EdE581,0x3f23033bD7feAc22F5A5C0a22556d371EecAa5BF
572,15627835,10000000,8000000000,9993744,6256,1738,39,0x260C32eB38D1403bd51B83B5b7047812C70B7845,0x14A20b4B762b8d297859cf0477D86324d66aF69f
573,15627835,655513,7995898005,215345,440168,55338,183238,0x5E4e65926BA27467555EB562121fac00D24E9dD2,0x6887246668a3b87F54DeB3b94Ba47a6f63F32985
574,15627836,71000,235628620433,71000,0,2,2386,0xe25a92c98356E7F18702d83107E83EB6fF9abDe5,0xe25a92c98356E7F18702d83107E83EB6fF9abDe5
575,15627836,309598,7626271220,307426,2172,650,106620,0xA69babEF1cA67A37Ffaf7a485DfFF3382056e78C,0x9AAb3F81604c683a1a0D14019FBfe15bef7aA1ee
576,15627836,349662,125000000000,344230,5432,1482,128,0x68b3465833fb72A70ecDF485E0e4C7bD8665Fc45,0xF73CC8098A381018823662aA7929d6Da2687804D
577,15627836,191655,81768304717,190319,1336,190,5393,0x9507c04B10486547584C37bCBd931B2a4FeE9A41,0x45c5232b76Ed9C6a70ec842A1E79D2D00eb58827
578,15627836,302938,7626271220,300802,2136,650,44522,0x5050e08626c499411B5D0E0b5AF0E83d3fD82EDF,0xe9F82f15910E161999777036e20CB4108F4Df800
579,15627836,2566460,7626271220,2545960,20500,5962,2054,0xBA71B56fD0B590ED2a6992eD57a34C1391940513,0xb792FAF099991f96c5dfEf037Ae9f248186D9b30
580,15627836,21000,17626271220,21000,0,2,2,0xB17Fe9F5A2b3E016c653E101845121421e2b225a,0x7D45271F0fe2C6E11E37dCF6eaF54faE027227C1
581,15627836,319796,14751255412,317480,2316,650,116836,0xA69babEF1cA67A37Ffaf7a485DfFF3382056e78C,0x6046945C5B5eF5933b8E73a98A6AD7bF3e031df7
582,15627836,100000,14070000000,99056,944,138,372,0x9813037ee2218799597d83D4a5B6F3b6778218d9,0xabC67a49D7d75bD04fA1DAE22cD4b8c4F796540a
583,15627836,303868,13000000000,301628,2240,522,2964,0x25553828F22bDD19a20e4F12F052903Cb474a335,0x3531F87396D392350663A847AAd80Ad40490A12d
584,15627836,222222,12000000000,220670,1552,394,3184,0x1Fa8559e873f698292766790AeCf8080A66433F6,0x3615E04D0F21E2c7D6001e561cE8d4a5D0594Ee7
585,15627836,164654,11679113053,163790,864,134,13639,0x5C57Ac8dC5D8589DAB9d422993ED3DE8CC244151,0x4D521577f820525964C392352bB220482F1Aa63b
586,15627836,52006,11674828640,51302,704,138,4049,0x761D38e5ddf6ccf6Cf7c55759d5210750B5D60F3,0xD9408f29026E32852AFf8C5C9C8Ea834b44b4e1C
587,15627836,52110,11674828640,51466,644,138,1,0x7420B4b9a0110cdC71fB720908340C03F9Bc03EC,0x7bC93BFD4e32CeB3f11Fe8063514482b545994d8
588,15627836,193705,11626271220,192121,1584,230,2315,0x9507c04B10486547584C37bCBd931B2a4FeE9A41,0x252983Ea0aF117575c843514be54af8fE91Ee8e9
589,15627836,93850,11374156206,93242,608,138,4709895,0xdAC17F958D2ee523a2206206994597C13D831ec7,0x2FAF487A4414Fe77e2327F0bf4AE2a264a776AD2
590,15627836,93850,11374156206,93242,608,138,4709896,0xdAC17F958D2ee523a2206206994597C13D831ec7,0x2FAF487A4414Fe77e2327F0bf4AE2a264a776AD2
591,15627836,63000,11362699383,63000,0,2,4709897,0x88af037858F5dCE1872B97c1547BBc5201521EdF,0x2FAF487A4414Fe77e2327F0bf4AE2a264a776AD2
592,15627836,76207,11362699383,75231,976,202,4709898,0xdAC17F958D2ee523a2206206994597C13D831ec7,0x2FAF487A4414Fe77e2327F0bf4AE2a264a776AD2
593,15627836,181458,10626271220,179906,1552,394,582,0x1Fa8559e873f698292766790AeCf8080A66433F6,0x87D9b41d139189403E008d9c0678F9EEB5754CF8
594,15627836,850000,10626271220,848072,1928,522,136,0x7a250d5630B4cF539739dF2C5dAcb4c659F2488D,0x5010973206B3cA1c2fA12C846D6465FB5efD98BE
595,15627836,850000,10626271220,848072,1928,522,118,0x7a250d5630B4cF539739dF2C5dAcb4c659F2488D,0x2C5789571A40a5554114bB6548DD9bc69D494b15
596,15627836,535245,10488000000,526349,8896,2698,49,0x3b3ae790Df4F312e745D270119c6052904FB6790,0x63B35B4e7801a44e9F9356033607B37130278E69
597,15627836,226870,7626271220,224722,2148,650,96395,0xA69babEF1cA67A37Ffaf7a485DfFF3382056e78C,0xBbAD96336943A36E3e292D973B3382dd0bA4D1EF
598,15627836,48804,10126897958,48184,620,138,70,0xA0b86991c6218b36c1d19D4a2e9Eb0cE3606eB48,0x0d29e141a7Fb644CAA03d58279e01952d75f9677
599,15627836,155748,10126271220,155544,204,74,16,0x7F9306FC1978938d5C1C57Bf6044dc67E07eeB8a,0x633de685159E309648AeC4149EF8853b453e712C
600,15627836,26703,10126271220,25759,944,138,97,0x19A4e33581c3b0ded84E6ce3Ba8515a4D45b5001,0x761d9D7d97044ab387b8B3CaEbdf8AEEb8F13E00
601,15627836,146655,10126271220,146591,64,10,7,0xEFECAbFCc8a2E28Cc6278E95E6f20DE81D3C9A56,0xD64592AaC64F558BCeC5B582F2379f7937cA2DC3
602,15627836,800000,10126271220,799056,944,138,123,0x19A4e33581c3b0ded84E6ce3Ba8515a4D45b5001,0xB18721357a023418A75310576D6787B22469C3E5
603,15627836,52862,10126271220,52798,64,10,3569,0x4545484255248A57396e081FA1d5836395446170,0xCE222910bA7524cADc75DDC7c57Ec5b97E8bFfc9
604,15627836,324437,10029414952,323289,1148,180,2278,0x9507c04B10486547584C37bCBd931B2a4FeE9A41,0xa9AA32D4f5442bA135C199d310E80eA2e9FbD866
605,15627836,21000,9904406328,21000,0,2,42,0x21b7116CA6083CBed165464D171b6886C9E01672,0xC1B0743a1497A88243f8E04Cf195d3367e3d2778
606,15627836,360000,9630068918,359356,644,138,824,0xF629cBd94d3791C9250152BD8dfBDF380E2a3B9c,0x66C0dAAe82a736A1588DD14Bf0020Aa5D4CAac54
607,15627836,63418,9626271220,62786,632,138,186,0x8B3192f5eEBD8579568A2Ed41E6FEB402f93f73F,0xCEc502288c6244aC5FA2d45e6cc7a342893acf13
608,15627836,224002,9626271220,220786,3216,1034,500,0x68b3465833fb72A70ecDF485E0e4C7bD8665Fc45,0x2b20bE9b4f67101D23EA30C15071E4bC41F03898
609,15627836,21000,9626271220,21000,0,2,1211343,0x13fe58500923e957d51DF55beeba8956f42171bA,0x95A9bd206aE52C4BA8EecFc93d18EACDd41C88CC
610,15627836,531053,9626271220,502653,28400,6666,503,0x1A90B3Dead0113740266b7F7Ea1136e8ED1b48C5,0x62Ef8b356751612Ad33863c454825BF94998AF2E
611,15627836,144513,9626271220,140101,4412,1290,765,0x0000000000c2d145a2526bD8C716263bFeBe1A72,0xB34D2BA72621D1aC89Edc2cCCcbcAa36869c9d5f
612,15627836,85000,9626271220,84512,488,138,153,0xD27dcbcC8778a8AB33AAc529Df36a634567Be325,0xE15Ae90722F476D1ef0c2CA66f97A6705416b502
613,15627836,21000,9626271220,21000,0,2,6578026,0x12D4AA45E6D01FbaDd95aAe09c6D8333eBA413B4,0xeB2629a2734e272Bcc07BDA959863f316F4bD4Cf
614,15627836,70000,9626271220,69392,608,138,517,0xdAC17F958D2ee523a2206206994597C13D831ec7,0xf5491f793D47A6Ea22f5e0B9AD3990CF66c4b40B
615,15627836,263667,9626271220,259187,4480,1420,4,0x881D40237659C251811CEC9c364ef91dC08D300C,0x6A0261f7Cf5B4f289b86692D12e2fD9171Df717B
616,15627836,292710,9626271220,289902,2808,842,174,0x68b3465833fb72A70ecDF485E0e4C7bD8665Fc45,0x66032BCafc5134e88334Cc5b42D3129010120161
617,15627836,207128,9626271220,207128,0,2,3492266,0xF0795d16e4cC951b222C83996aB322143044c4dc,0x56Eddb7aa87536c09CCc2793473599fD21A8b17F
618,15627836,207128,9626271220,206520,608,138,4232321,0xdAC17F958D2ee523a2206206994597C13D831ec7,0xDFd5293D8e347dFe59E90eFd55b2956a1343963d
619,15627836,207128,9626271220,206472,656,138,4468930,0xF629cBd94d3791C9250152BD8dfBDF380E2a3B9c,0x21a31Ee1afC51d94C2eFcCAa2092aD1028285549
620,15627836,42000,9626271220,42000,0,2,329510,0xA91cD611C9077b072FA414725812f67CCc1dF7Ad,0x9430801EBAf509Ad49202aaBC5F5Bc6fd8A3dAf8
621,15627836,21000,9626271220,21000,0,2,52371,0x701c56BD889815C4c6694619C815a37Ad171bA44,0x7c195D981AbFdC3DDecd2ca0Fed0958430488e34
622,15627836,21000,9626271220,21000,0,2,1211344,0x39c2823148240e2B59d9eFC30be1BB385a91DDB1,0x95A9bd206aE52C4BA8EecFc93d18EACDd41C88CC
623,15627836,21000,9626271220,21000,0,2,52372,0xBBdF63e9F762ae90acF96f01c11106b812973001,0x7c195D981AbFdC3DDecd2ca0Fed0958430488e34
624,15627836,70120,9626271220,69548,572,138,3,0x3a5051566b2241285BE871f650C445A88A970edd,0x5c37D7eDdB52c1572e6511739529865e14D16300
625,15627836,500000,9626271220,499404,596,138,1262737,0xdAC17F958D2ee523a2206206994597C13D831ec7,0x89e51fA8CA5D66cd220bAed62ED01e8951aa7c40
626,15627836,21000,9626271220,21000,0,2,1211345,0x22737C4807c50c1dc16aAc5280BC18a326f94969,0x95A9bd206aE52C4BA8EecFc93d18EACDd41C88CC
627,15627836,194476,9626271220,191704,2772,842,832,0x68b3465833fb72A70ecDF485E0e4C7bD8665Fc45,0xdb40cD699FfB888ef3799761BC87964d872F3748
628,15627836,205458,9626271220,202206,3252,1034,27,0x68b3465833fb72A70ecDF485E0e4C7bD8665Fc45,0x28b14888f6dB1E9E40F9ae469F949d3D212321A6
629,15627836,21000,9626271220,21000,0,2,469149,0x6FBFa4B4B346A2A92b7471b7f77037a00Cb34394,0xb739D0895772DBB71A89A3754A160269068f0D45
630,15627836,1872500,9595077606,1834212,38288,9162,38595,0x902F09715B6303d4173037652FA7377e5b98089E,0xe93685f3bBA03016F02bD1828BaDD6195988D950
631,15627836,90000,9580241633,90000,0,2,784401,0xa4fBa35c143fD2BE6a9D650F7D8C946B79281b15,0xcaD621da75a66c7A8f4FF86D30A2bF981Bfc8FdD
632,15627836,100000,9580241633,99332,668,138,1050378,0xF411903cbC70a74d22900a5DE66A2dda66507255,0xf16E9B0D03470827A95CDfd0Cb8a8A3b46969B91
633,15627836,185578,9551525464,183590,1988,522,144,0x53e0e51b5Ed9202110D7Ecd637A4581db8b9879F,0x7e666c2F303B58796cAb1Ba0dd52120Eb8aFd17A
634,15627836,165894,9499676790,165010,884,120,3745,0xb21F51DC9f3067574946D1A530447D9037675CbC,0x10763988715993EaF59905029CE3414adA0b5200
635,15627836,21000,9335098514,21000,0,2,1,0xdb52799f0e08187018089181729Fd64F46edF576,0x512633C3F1f524fADE38DC6b2c0535966Ec4D542
636,15627836,21000,9335098514,21000,0,2,14,0x5A0eECb57134719b63d21cAc95e936ea40E96404,0xC881765Cc285b9e921ebE997542b40B9bdE38081
637,15627836,100000,9273399699,99344,656,138,2,0x4Fabb145d64652a948d72533023f6E7A623C7C53,0xd1f72E59cD159F4a27115a5790D46874E38C5bF7
638,15627836,899957,9236271220,899197,760,202,228,0x9bA41A2C5175d502eA52Ff9A666f8a4fc00C00A1,0xEa80829C827f1633A46E7EA6026Ed693cA54eebD
639,15627836,132194,9200000000,130170,2024,522,1505,0x7a250d5630B4cF539739dF2C5dAcb4c659F2488D,0x382B52f4061865DEE2Dd7Dd8270eDDa7342BaAD6
640,15627836,185928,9142599251,184760,1168,166,2099,0x40Cd64cf6F2Ed6E86790FC39EDC3A91B91cb6d12,0x0ddFF0c42AAA6870CFd79D0050a0387134Aa5163
641,15627836,185298,9126271220,181718,3580,1162,19,0x68b3465833fb72A70ecDF485E0e4C7bD8665Fc45,0xB715cdB77806d154D4cEf39B7374f98054Bcc298
642,15627836,46641,9126271220,46153,488,138,152,0x8ccF065F5C4D3E2fcb025329f22222448dbAbF8b,0x7cc26b600eC01F23209ba6fc80322Af5BD2B7155
643,15627836,143000,9126271220,136424,6576,1802,6,0x00000000006c3852cbEf3e08E8dF289169EdE581,0x996504Fa92f06d25A6a8138C1dAF6Dcab2a5Bdce
644,15627836,46604,9126271220,45660,944,138,31,0x3819f64f282bf135d62168C1e513280dAF905e06,0x0eBAF55AC24cca978f6d63047b42E68DC14AbB15
645,15627836,46331,9126271220,45843,488,138,2464,0xd208EE54FDE79d6Ab54be4CC844d22c40BdE2dDC,0xA17138c0675173B8Ea506Fb1b96FA754BC316cc2
646,15627836,46267,9126271220,45691,576,74,580,0x283Af0B28c62C092C9727F1Ee09c02CA627EB7F5,0x62764715edAC8396C76E8704Ae86509b23b523A2
647,15627836,53818,9126271220,53330,488,138,10,0xe2ddf03ba8cDafd2Bb4884E52f7FB46df4FC7DC1,0x11924c505ECAb6a2434BDFe94BC0Ff1ca081fACb
648,15627836,203858,9126271220,200242,3616,1162,300,0x68b3465833fb72A70ecDF485E0e4C7bD8665Fc45,0xccc743D087A3FF1e310062c63d7d73Bf6630dac3
649,15627836,251076,9126271220,244196,6880,1810,62,0x00000000006c3852cbEf3e08E8dF289169EdE581,0x3A73A38e7b01CaA1251c9779113026A0e448F98b
650,15627836,181104,9126271220,178296,2808,842,19,0x68b3465833fb72A70ecDF485E0e4C7bD8665Fc45,0x1B39365411f37912BA8c6A8A3D375C08572C0AF5
651,15627836,163769,9126271220,157217,6552,1802,258,0x00000000006c3852cbEf3e08E8dF289169EdE581,0x5a3A549Aea8BE363D0CF797C53FB1d0932e2d17A
652,15627836,399931,9126271220,399103,828,266,2128,0xd658A338613198204DCa1143Ac3F01A722b5d94A,0x10c16c7B8b1DDCFE65990ec822DE4379dd8a86dE
653,15627836,46707,9126271220,46219,488,138,346,0xbef7Dcc0335Ec876e2DC530b883F34c8807d61fc,0xA0D50659e3F9ec1e512c5ce9cAaBCC8106fa30c5
654,15627836,46267,9126271220,45691,576,74,1841,0x283Af0B28c62C092C9727F1Ee09c02CA627EB7F5,0xA9aa6E7bC4257D7DB05aEf0AAcD3DB14A7fdca2E
655,15627836,65147,9126271220,64195,952,202,457,0x5d95c4C73E152727750dF27ff7DA1C7169430dd6,0x5f7f4144bc896f490875Fe1D919E9892bf84135d
656,15627836,362553,9126271220,360133,2420,714,860,0x000000000000509081d6FCD3ee63e791aD1db763,0x15965EF4652E57BF527dB460a9891C4D891E716a
657,15627836,215622,9126271220,212886,2736,842,9,0x68b3465833fb72A70ecDF485E0e4C7bD8665Fc45,0xd66C0FCBde577D4edC27FA53E1aB855621152200
658,15627836,46103,9126271220,45615,488,138,63,0x346378C67d0F71343F80299ed8C0407aC2Df05eB,0x2FAeA3946a6BA8edEa22aeBD06A4c67748Ae150B
659,15627836,162344,9126271220,155504,6840,1802,3,0x00000000006c3852cbEf3e08E8dF289169EdE581,0x187717242A82037F723609F833ce37E7B51348Ef
660,15627836,46682,9126271220,46194,488,138,393,0x67df41EDf21e1c581A77E939f60db7bAa5E96993,0x3ce0871a9274F2a1E642b1B1F1C208C7a507b4Ce
661,15627836,117738,9126271220,117534,204,74,24,0x7F9306FC1978938d5C1C57Bf6044dc67E07eeB8a,0x9a153C18A5489E97c51f76aF07f07FcB08471A2a
662,15627836,46111,9126271220,45623,488,138,3,0xFB6e20268256ed02Ad06fD983E80a48E87759F29,0xD25D8a90C5745Fe56d9E8a4e80F1509E9fAcCe63
663,15627836,59450,9126271220,52558,6892,2122,306,0x00000000006c3852cbEf3e08E8dF289169EdE581,0x1c4C2537DE5D53670dc47657CB4bdf081023fE8a
664,15627836,149246,9126271220,142694,6552,1802,191,0x00000000006c3852cbEf3e08E8dF289169EdE581,0x243068AeB086dB5287ac8787F2Fe295dD6cdD20f
665,15627836,53999,9126271220,53427,572,138,156,0x6de7aC835EC6841Af9b94fd1273dB83B8d69e3f7,0xa32FEa02958ED63aF164C83A2d8318471d30030F
666,15627836,288962,9126271220,286626,2336,522,259,0x283Af0B28c62C092C9727F1Ee09c02CA627EB7F5,0x64Fd17F50269e7E0Cfb37845DA49EDcce1378a3d
667,15627836,27938,9126271220,27874,64,10,358,0xC02aaA39b223FE8D0A0e5C4F27eAD9083C756Cc2,0x22546BD574B81D9C8A29099080dE09537Fd72A3E
668,15627836,197706,9126271220,192618,5088,1418,8,0x68b3465833fb72A70ecDF485E0e4C7bD8665Fc45,0xF8Fd8F8742B0810EEA4eA04F45e6B23732E52C3b
669,15627836,46580,9126271220,46092,488,138,2465,0x07a13eea351D501cFedf96BDA8528bBC71CA5D80,0xA17138c0675173B8Ea506Fb1b96FA754BC316cc2
670,15627836,44847,9126271220,43895,952,202,93,0x32973908FaeE0Bf825A343000fE412ebE56F802A,0xcf3B9dFB29EaE12b6389EB6ccd19a03DE02318D9
671,15627836,182780,9126271220,179576,3204,842,5,0xea968E6AC95A95c68bF66DEcc803A1B2848cdc4A,0xFb0C2B9739F96313f6370E0862E2D683d0F2F25A
672,15627836,237349,9126271220,234517,2832,842,211,0x68b3465833fb72A70ecDF485E0e4C7bD8665Fc45,0x4f102e320c8046242eEbaD43A6174678CCe1e8CC
673,15627836,200387,9126271220,193787,6600,1802,265,0x00000000006c3852cbEf3e08E8dF289169EdE581,0xFB1953Ae926fB89fBEDF4B3eCcF321E7CBf35365
674,15627836,53827,9126271220,53339,488,138,99,0xa9BA1A433Ec326bca975aef9a1641B42717197e7,0x85E7377EBc3A15a8b80b8Ae982c0C3732c86D58A
675,15627836,46286,9126271220,45642,644,138,11,0x1EA48B9965bb5086F3b468E50ED93888a661fc17,0x0dfE3D29F1599De07a81E5Fa9B6B8304711d087a
676,15627836,21000,9126271220,21000,0,2,99,0xe166bD5AEdE229cE636C581664EffeB7333E3A1f,0x5E04964927E07e8F9ef8f091837774E7ADE9F97F
677,15627836,94382,9126271220,94130,252,74,413,0xfc4913214444aF5c715cc9F7b52655e788A569ed,0x4e37C2c189139EFfCB2CACEF8F643cB0D7d5a11a
678,15627836,21000,9126271220,21000,0,2,221,0xc623483a440A6Fb5C0D41f8E30a9F3dF49a237Ad,0xcE221B774F85324c77f91149C8919B687a81A4B2
679,15627836,182954,9126271220,176126,6828,1802,7,0x00000000006c3852cbEf3e08E8dF289169EdE581,0xd1ffbF3b0738900Cbd303b2CA2B8A1140554A423
680,15627836,141974,9126271220,135498,6476,1746,107,0x00000000006c3852cbEf3e08E8dF289169EdE581,0x2Fb99221fb673D1bed25204C069879206b481715
681,15627836,21000,9126271220,21000,0,2,74,0xfF287B588f6A76875E08685FA10eC56b256952BE,0x65518A5f3da6E9A89C66cE4c46484aCA2Da2d034
682,15627836,468241,9126271220,461065,7176,1226,14133,0x4C36d2919e407f0Cc2Ee3c993ccF8ac26d9CE64e,0xD54e4f8A55247487dd7C8c59f14EE5c0c2889477
683,15627836,132277,9126271220,125921,6356,1674,18,0x00000000006c3852cbEf3e08E8dF289169EdE581,0x1FC756FD86a8c4Dd9773aD83e540dA0267419846
684,15627836,99226,9126271220,98630,596,138,18,0xA0b86991c6218b36c1d19D4a2e9Eb0cE3606eB48,0x213Ba72BD0Faf97E49f31bFECb9b00B01074F8DB
685,15627836,130451,9126271220,129511,940,202,0,0xe6A05f25A051a90D5d144C04F783f6999e48e32D,0xaD08e883649c660e134C2208c6a56684E69803bc
686,15627836,128107,9126271220,127347,760,202,2,0xcDA72070E455bb31C7690a170224Ce43623d0B6f,0x79cbD246d8f2b2885e63427dE9Cb75b3140bECb6
687,15627836,1200000,9126271220,1199796,204,74,6,0x6AE0D3b09f87319807cf1AF13C8eE41832075CB5,0x51BbbD7dcC7d30C5C4162333d9320D467597C8E4
688,15627836,49175,9126271220,48687,488,138,984,0xD27dcbcC8778a8AB33AAc529Df36a634567Be325,0xF1bEE1Eb3664f3bf7f67aB0A5F8CE8b3631b9d8C
689,15627836,287583,9126271220,285259,2324,522,338,0x283Af0B28c62C092C9727F1Ee09c02CA627EB7F5,0x0e05FC263cB57dB89aa9f32cc3f4743244520c45
690,15627836,46267,9126271220,45691,576,74,223,0x283Af0B28c62C092C9727F1Ee09c02CA627EB7F5,0x57679F905F9618d50a638cc1fe272003A831cec1
691,15627836,56446,9126271220,55802,644,138,4,0x08c32b0726C5684024ea6e141C50aDe9690bBdcc,0xAF3F1725726613958CB255547b8D7d976c511162
692,15627836,46155,9126271220,45667,488,138,2466,0xE4D0E33021476Ca05aB22C8BF992D3b013752B80,0xA17138c0675173B8Ea506Fb1b96FA754BC316cc2
693,15627836,47097,9126271220,45529,1568,330,51,0x4976fb03C32e5B8cfe2b6cCB31c09Ba78EBaBa41,0xE9FFd2d4c1e3eAF13f6e17DfDCD615a66f357dF4
694,15627836,805378,9126271220,788774,16604,6666,3482,0x657E383EdB9A7407E468acBCc9Fe4C9730c7C275,0xC458e1a4eC03C5039fBF38221C54Be4e63731E2A
695,15627836,46111,9126271220,45623,488,138,8,0xFB6e20268256ed02Ad06fD983E80a48E87759F29,0x7d39d36D3d5E9397C2A76637264C323AC86Eb841
696,15627836,309548,9126271220,306204,3344,1098,63,0xC36442b4a4522E871399CD717aBDD847Ab11FE88,0x30379F151e4FE4C50a3Fa15F797A34Db6374b10B
697,15627836,334774,9090376544,329938,4836,1292,938,0x881D40237659C251811CEC9c364ef91dC08D300C,0x6DD5D07f6868D5dB3B055791b9dce502d0F159c8
698,15627836,70000,9041873177,69392,608,138,57,0xA0b86991c6218b36c1d19D4a2e9Eb0cE3606eB48,0xe536137f932bEA872F40e349308d60c2B98E9289
699,15627836,299233,8957274850,297053,2180,522,9838,0xFA103c21ea2DF71DFb92B0652F8B1D795e51cdEf,0xf06443E71c4778Fe8813a6bb9E036d8d10f4adeE
700,15627836,80131,8957274850,77915,2216,522,9961,0xFA103c21ea2DF71DFb92B0652F8B1D795e51cdEf,0x20eb8f8a937380b16F7121841fa7FaeA87b8FB78
701,15627836,330708,8727271220,328488,2220,650,100933,0xA69babEF1cA67A37Ffaf7a485DfFF3382056e78C,0x431B5A84aCC1297Eda88259f300262F1bc3A74f3
702,15627836,120000,8681271220,119404,596,138,96276,0xdAC17F958D2ee523a2206206994597C13D831ec7,0x14c4017f81675F7aC1321218d4a385a2D3117328
703,15627836,21000,8629769653,21000,0,2,9,0x1ED566bef24e06D4741d6329B2BD190236b05dF5,0xE164851a7D93FEf79CE1D9ceB8073dC1C36DbEAb
704,15627836,43057,8626271220,42805,252,74,42,0x1748B24faf9780B74E5A9f3Feb41553E712E94aa,0x6819eA7792CC89394fEEE84FC70d54a67cD0B765
705,15627836,175110,8626271220,173546,1564,394,117,0x1Fa8559e873f698292766790AeCf8080A66433F6,0x213308370cbb4D77742B370866Df6dED2877ED3d
706,15627836,21000,8626271220,21000,0,2,205,0x88EC22a9285AFC2381147aEAc07178021510be3D,0x936bd33f4F684ADCD6DA3B96FD1F72e034EA54d4
707,15627836,117533,8626271220,117341,192,74,14,0xfc33E8b6E160A81DdB442B07355D01DF711EFEee,0xBb0Dc647F127c3752135A048355D6EC05C8A2929
708,15627836,213572,8626271220,209980,3592,1162,763,0x68b3465833fb72A70ecDF485E0e4C7bD8665Fc45,0xB4cEF3CA34db5A5ea3116dcd924d318bCbD7Ad17
709,15627836,181458,8626271220,179906,1552,394,72,0x1Fa8559e873f698292766790AeCf8080A66433F6,0x7b709038240cC62140003a28CDF084621981D03d
710,15627836,101263,8626271220,100691,572,138,38,0x1Fa8559e873f698292766790AeCf8080A66433F6,0x450423ddFf2125B52EC524c8ec35B46552054aBc
711,15627836,170074,8626271220,169870,204,74,2371,0x008F603F0f9Aaa2C05db0F4De44cdE91fcFF430a,0x9b8952ABA6f9Fb5B097Cd55f597511757f6937Ae
712,15627836,88517,8626271220,87617,900,266,149,0xd588b586D61C826A0e87919b3D1a239206d58bf2,0xdF2B5ae21772d879068eC6df25eFBa8Cfb2089b4
713,15627836,146706,8442300698,140130,6576,1802,1476,0x00000000006c3852cbEf3e08E8dF289169EdE581,0xD710c25b900C6827352001c98aDFf4E702533eFC
714,15627836,338628,8400433536,336264,2364,362,6143,0xED77777586D73C58EB4D6BEBDF9c85C2d5F56C2d,0x38AccdeB1c62DADE625bCAbDca85701d5f6C8618
715,15627836,270435,8160562688,266403,4032,1226,129,0x68b3465833fb72A70ecDF485E0e4C7bD8665Fc45,0x9AF085059D7C9e4B129F41DaCe749d15201fF504
716,15627836,69163,8160562688,68555,608,138,2,0xdAC17F958D2ee523a2206206994597C13D831ec7,0x85F33e19173fC474b21a9f3E81EC6b10a074C8A1
717,15627836,244000,8160562688,243416,584,138,72,0x7fbe407159DD628e75aB1ff7d20899d7686FF9Cf,0xDCde4Ec1A00cceAB37237D06Fec20c2Dd5e84FC6
718,15627836,518766,8160562688,518314,452,138,105,0x2d77B594B9BBaED03221F7c63Af8C4307432daF1,0x8a706170885CBEBC17a70EBdb0b8f7a53320C9D3
719,15627836,31500,8000000000,31500,0,2,5,0x477b8D5eF7C2C42DB84deB555419cd817c336b6F,0x364fE08Bea1bc8bC2759BD30074925A19877d955
720,15627836,90000,8000000000,89380,620,138,19765,0x514910771AF9Ca656af840dff83E8264EcF986CA,0x356f029FB2f673ca083ea223D5835F4ac00539DD
721,15627836,212832,8000000000,212640,192,74,59,0x6a9f9d6F5D672a9784c5E560a9648de6cbe2c548,0xb7ACA523780Ed5F75F9d53948554A63e765F17a0
722,15627836,191055,8000000000,185035,6020,1674,11,0x00000000006c3852cbEf3e08E8dF289169EdE581,0xE6e2600c014D49660Cc8a2E653DcfA6E84aDf673
723,15627836,21000,7995898005,21000,0,2,150319,0xA8F2397E3C498ddc9F99E2F94afeacd8DC8a05b9,0x1C727a55eA3c11B0ab7D3a361Fe0F3C47cE6de5d
724,15627836,105000,7629769653,105000,0,2,138551,0x98b0A9e12763374E1C95127959f3dfc11995277f,0x974CaA59e49682CdA0AD2bbe82983419A2ECC400
725,15627836,105000,7995898005,105000,0,2,138552,0xC8A1f707bea1432eeB8f2504d5eCbd28676E5905,0x974CaA59e49682CdA0AD2bbe82983419A2ECC400
726,15627836,105000,7995898005,105000,0,2,138553,0xba430C1a5c8d0A70Bdc68F1E01A66035208bAD42,0x974CaA59e49682CdA0AD2bbe82983419A2ECC400
727,15627836,80000,7629769653,79056,944,138,0,0xdAC17F958D2ee523a2206206994597C13D831ec7,0x15EBA5E008dA954c3C7Dda1a48714b702D709B61
728,15627836,51352,7629769653,50744,608,138,1,0x083D41d6DD21EE938f0c055CA4fb12268DF0EfaC,0xA099d1e8bd76eDFB10fe8F62DBe5A3B150b60f0C
729,15627836,21000,7629769653,21000,0,2,77,0x94383fa024F23e5417093a8d61A2FE2aF3E08161,0x2b0D7B32487B9B6B728A1e1aCcE2cf1DcFd19B20
730,15627836,26000,7626271220,26000,0,2,12017,0xfFEE087852cb4898e6c3532E776e68BC68b1143B,0xDAFEA492D9c6733ae3d56b7Ed1ADB60692c98Bc5
731,15627837,21000,10803582852,21000,0,2,25,0x06E6132BE474dD4f115637a19b288deD605EE6E6,0x62f559bAaAfF1E123D210EF1b287B2A18F9B3D78
732,15627837,50000,10394667406,50000,0,2,476118,0xE08eeb70f4bb466572B3ECe0BA1D1c5fdC245988,0x4d846dA8257BB0Ebd164EFf513DfF0F0c2C3c0ba
733,15627837,21000,9904406328,21000,0,2,116,0xD4C8811025d20C7E7219d0C4704AACbbd8bA9F4F,0xE40236601fD70016c041882E7C19032e7591BAB0
734,15627837,423786,9803582852,420110,3676,1162,466,0x68b3465833fb72A70ecDF485E0e4C7bD8665Fc45,0xF4aac9421fb27d6f969015333EEE52BceD4A0c82
735,15627837,49175,9803582852,48687,488,138,527,0xD27dcbcC8778a8AB33AAc529Df36a634567Be325,0x50F898f22eB15EaAAfD0F40C754f9b6F68BAaA5a
736,15627837,500000,9803582852,497292,2708,714,121113,0x78E851C35326c9296485E9720D85CB3Bd153b428,0x088876687aC7c4C60cBC0690A4bFae0971964162
737,15627837,181476,9803582852,179912,1564,394,2609,0x1Fa8559e873f698292766790AeCf8080A66433F6,0x24245e6c515187aB9b103BD278dAd0d5A08EdBaA
738,15627837,565782,9413582852,553974,11808,3914,287,0xDEF171Fe48CF0115B1d80b88dc8eAB59176FEe57,0x17D065070486Ca0fC8b4B382b946BE79Fb4fF10D
739,15627837,551946,9313582852,550938,1008,266,176,0xA79828DF1850E8a3A3064576f380D90aECDD3359,0x6792c4bDc1b45EfA131ecCa985A28EF5c4622E48
740,15627837,46255,9303582852,45691,564,74,1097,0x283Af0B28c62C092C9727F1Ee09c02CA627EB7F5,0x067D3E5459Fa588aA5a5001FC9608b314E7e4A01
741,15627837,21000,9303582852,21000,0,2,321,0x3434407e6230E0addbA621285049f97f821a751C,0xD781EECbcB4c60203dE0F5b12f4893F5CbDA3BAF
742,15627837,146733,9303582852,140117,6616,1810,46,0x00000000006c3852cbEf3e08E8dF289169EdE581,0x8485C883024d0E61D8B90Eec2D5b76D538361388
743,15627837,59282,9303582852,52558,6724,2122,307,0x00000000006c3852cbEf3e08E8dF289169EdE581,0x1c4C2537DE5D53670dc47657CB4bdf081023fE8a
744,15627837,203190,9303582852,185714,17476,4426,7,0x00000000006c3852cbEf3e08E8dF289169EdE581,0x7378711DE38d222F984B4a6C1CC550C1efBFa113
745,15627837,203692,9303582852,195400,8292,2186,15,0x00000000006c3852cbEf3e08E8dF289169EdE581,0x6a7fA479337bE103e0c580bd33d6c6bD41D225aB
746,15627837,46663,9303582852,46175,488,138,6,0x0C6822ca73dE6871f27ACD9ca05A05b99294B805,0x133dE21365966e1C2919f67Cd98122592cFc2DE1
747,15627837,46172,9303582852,45600,572,138,803,0x5D004ddB5D92938dAF8448b9eac1CaA593cd26Ca,0x17C2549B78439F056024EF500149EE75D818Bf7E
748,15627837,189709,9303582852,186129,3580,1162,48,0x68b3465833fb72A70ecDF485E0e4C7bD8665Fc45,0x67d23b6f5E652F637c2f168a85BA6327BA529A70
749,15627837,78984,9303582852,78984,0,2,100,0x9BACE6C8A3b6802adb8A8db1D373d6C6DAFda74a,0x0443E05dd3Bcff32AD4E74d32a70aFF2BbD730Cc
750,15627837,330000,9303582852,317220,12780,3914,135,0x7f6CDf5869BD780ea351DF4d841F68D73cBCc16b,0x36920E436FAe6365Fa495e943C891Fd6Ea64459f
751,15627837,740000,9303582852,729208,10792,2506,53813,0x06E78B05e234b78DeD83f06CEC708d18D74525eb,0xe3E0596AC55Ae6044b757baB27426F7dC9e018d4
752,15627837,55923,9303582852,54979,944,138,433,0xD309A8d0498Cc73f53481e46094DC0d3aaB0d9dd,0x45B5b71d3A359ac378A9f1eD3AF158CF16672A14
753,15627837,94777,9303582852,94193,584,138,29,0xdAC17F958D2ee523a2206206994597C13D831ec7,0xBC18043D1677dB090f3EFf62E2c4b755a3C005Ca
754,15627837,65329,9303582852,64377,952,202,18,0x61CEcE14E222385D5aC83f3d0cbd518f5fEB3559,0x5630bab8549Aaaf78435023c389c586aA0c356Ae
755,15627837,178176,9303582852,177820,356,138,13,0x851064752Bb08FFccA6897a3d4E76362EF78DfDf,0x37ddf294C9F8597A6CB573CE6412b1c3fd8CE622
756,15627837,46103,9303582852,45615,488,138,5975,0x346378C67d0F71343F80299ed8C0407aC2Df05eB,0x2d3162890E0a81bB0F4A1F65E8878D20853f6216
757,15627837,21000,9303582852,21000,0,2,136,0xf9B22664112563B57E781D05036bb158ac130FB2,0x02100194A72Da4092500A2Aa153E109B45A9f134
758,15627837,53646,9022131059,52702,944,138,829,0x32F19B8c25333bF68FaCe58041858f185c17CF74,0xba28267b3aA1a1E1503f31ff58fd081451Fc505b
759,15627837,660100,9000000000,657880,2220,650,11611,0x0fc584529a2AEfA997697FAfAcbA5831faC0c22d,0xF165D353abDDb7Cb00052d610254249FCc12a8C7
760,15627837,21000,8803582852,21000,0,2,8265743,0x54EB542A149c3c8f6A66ABaB2c9532a4910B4B39,0xb5d85CBf7cB3EE0D56b3bB207D5Fc4B82f43F511
761,15627837,21000,8803582852,21000,0,2,469150,0x7C70707328acba9Bac824c86f648C3e1bC367992,0xb739D0895772DBB71A89A3754A160269068f0D45
762,15627837,21000,8803582852,21000,0,2,346916,0x1Cf9CCAb6dD187919517F34a19591A802e54017E,0x77696bb39917C91A0c3908D577d5e322095425cA
763,15627837,21000,8803582852,21000,0,2,1783200,0x0007AE86ec165A00E2F33385a6D8F23f16EBC13b,0x503828976D22510aad0201ac7EC88293211D23Da
764,15627837,21000,8803582852,21000,0,2,1211346,0x1e7709152a4a2FfE7FEBc5395CB6190DC522541f,0x95A9bd206aE52C4BA8EecFc93d18EACDd41C88CC
765,15627837,21000,8803582852,21000,0,2,469151,0xf77f8e6dceE2B45642D757462aECAE95C18b1516,0xb739D0895772DBB71A89A3754A160269068f0D45
766,15627837,48780,8803582852,48184,596,138,11018,0xA0b86991c6218b36c1d19D4a2e9Eb0cE3606eB48,0xCe352e98934499be70F641353f16A47D9E1E3aBd
767,15627837,21000,8803582852,21000,0,2,52373,0xdf3a217F92FE696E59991f100fDbf621CC8121f7,0x7c195D981AbFdC3DDecd2ca0Fed0958430488e34
768,15627837,21000,8803582852,21000,0,2,6578027,0x3ac08BDD2AB1B61B8fA8F71FfcB2778def3EBe33,0xeB2629a2734e272Bcc07BDA959863f316F4bD4Cf
769,15627837,23300,8803582852,23300,0,2,1,0xA9D1e08C7793af67e9d92fe308d5697FB81d3E43,0xF369fDFdC58dB72aA8c29a8Fc50849D7e76F7fc7
770,15627837,23300,8803582852,23300,0,2,1,0xA9D1e08C7793af67e9d92fe308d5697FB81d3E43,0xa6cA76A66eD905ad157f5BBA8920662c90AC683E
771,15627837,23300,8803582852,23300,0,2,8,0xA9D1e08C7793af67e9d92fe308d5697FB81d3E43,0x636ee22F9B7B2FBfFBa2986361e1dd98B9e3d997
772,15627837,23300,8803582852,23300,0,2,10,0xA9D1e08C7793af67e9d92fe308d5697FB81d3E43,0xf43336f3367b87298da1A43E38D3810a32640Bf4
773,15627837,23300,8803582852,23300,0,2,0,0xA9D1e08C7793af67e9d92fe308d5697FB81d3E43,0x9B2259bbEcC5b365926d26433CABb8EAABA6A775
774,15627837,23300,8803582852,23300,0,2,5720,0xA9D1e08C7793af67e9d92fe308d5697FB81d3E43,0x4675C7e5BaAFBFFbca748158bEcBA61ef3b0a263
775,15627837,21000,8803582852,21000,0,2,10,0x3cD751E6b0078Be393132286c442345e5DC49699,0x045D2871bd3e16cb2e06596466B5C679AaD44812
776,15627837,515560,8420497508,489088,26472,8138,8395,0x9008D19f58AAbD9eD0D60971565AA8510560ab41,0xb20B86C4e6DEEB432A22D773a221898bBBD03036
777,15627837,399914,8337874320,396298,3616,1162,226,0x68b3465833fb72A70ecDF485E0e4C7bD8665Fc45,0xF1393126Fec644D21AD2DFcd0aD695781eD0BF8B
778,15627837,92747,8046029587,91795,952,202,39,0xE5C7D9A18df4fDc12DB723761A862845612917bA,0x16bdE61314Dc8a4AE4a0CdCc9e9d3ca070B64a9f
779,15627837,30000,8000000000,30000,0,2,3197,0x3e6722f32CBE5b3C7BD3dcA7017c7FfE1b9E5A2A,0x2240FFCB2330177D49578954B11445d7C7Db1e29
780,15627838,298242,194855099078,298242,0,2,97406,0x76e40D0a69Fd81826B5eb7D18145626d46EAFdef,0x76e40D0a69Fd81826B5eb7D18145626d46EAFdef
781,15627838,227606,189899133008,226510,1096,220,11926,0xBEEFBaBEeA323F07c59926295205d3b7a17E8638,0x8dAB36Ee57328E700380D1fD6588BC3De5Fe8Ec3
782,15627838,21014,100017473754,21014,0,2,92673,0x5E2B6c6B2240d582995537D3FafdB556E4A3822F,0x5E2B6c6B2240d582995537D3FafdB556E4A3822F
783,15627838,500000,100000000000,498012,1988,522,7505,0x7a250d5630B4cF539739dF2C5dAcb4c659F2488D,0xC5C018EDb7Ec3e4217728C1e1F608b28057Dd507
784,15627838,450000,52116855726,447988,2012,522,98,0x7a250d5630B4cF539739dF2C5dAcb4c659F2488D,0x761d9D7d97044ab387b8B3CaEbdf8AEEb8F13E00
785,15627838,700000,47116855726,698456,1544,330,1160,0x95B05Bc8f6c59847E7d2D484E8542363D422e341,0x47ec31abc6b86e49933dC7B2969EBEbE3De662cA
786,15627838,21000,45000000000,21000,0,2,27,0xBbad472505daF2ba3B724eC2f9cC4A801Fd254e8,0x8eB6e38e9E654f8A72F643E7F20b3dAc96070fC4
787,15627838,152701,7116855726,152117,584,78,5180,0x00000000A991C429eE2Ec6df19d40fe0c80088B8,0x77ad3a15b78101883AF36aD4A875e17c86AC65d1
788,15627838,234894,8116855726,232134,2760,842,101,0x68b3465833fb72A70ecDF485E0e4C7bD8665Fc45,0x66652384b46ABD9439CaA4fF82C5e1c15989217B
789,15627838,129093,128191592975,128201,892,118,5181,0x00000000A991C429eE2Ec6df19d40fe0c80088B8,0x77ad3a15b78101883AF36aD4A875e17c86AC65d1
790,15627838,888888,38116855726,887028,1860,458,255,0x7a250d5630B4cF539739dF2C5dAcb4c659F2488D,0x63aaC08e966f7Cc16e89102b7e882a867492A69f
791,15627838,350217,34678722854,344909,5308,1018,196480,0x0000000000007F150Bd6f54c40A34d7C3d5e9f56,0x0197ABe48f0a9826D10F44DaD7050f26586Eb9bA
792,15627838,258556,7116855726,256420,2136,650,117895,0xA69babEF1cA67A37Ffaf7a485DfFF3382056e78C,0x26bce6eCb5b10138e4bf14aC0ffcc8727FEF3B2e
793,15627838,100000,30000000000,99344,656,138,7,0x1f9840a85d5aF5bf1D1762F925BDADdC4201F984,0x6438e6FeA0E8bc40dbe469308f4888ecB9FBfb8D
794,15627838,500000,28800000000,497976,2024,522,1254,0xd9e1cE17f2641f24aE83637ab66a2cca9C378B9F,0x89Fd7A2127E462c3D7D14f8a5D08a8372C8028F5
795,15627838,300014,18643967383,298710,1304,330,224453,0x98C3d3183C4b8A650614ad179A1a98be0a8d6B8E,0x91aaE0aAfd9D2d730111b395c6871f248d7Bd728
796,15627838,101277,17306767770,100621,656,138,2188220,0xD2d8D78087D0E43BC4804B6F946674b2Ee406b80,0x75e89d5979E4f6Fba9F97c104c2F0AFB3F1dcB88
797,15627838,152293,17306767770,151661,632,138,2188221,0xc5fB36dd2fb59d3B98dEfF88425a3F425Ee469eD,0x75e89d5979E4f6Fba9F97c104c2F0AFB3F1dcB88
798,15627838,101277,17306767770,100633,644,138,2188222,0xD2d8D78087D0E43BC4804B6F946674b2Ee406b80,0x75e89d5979E4f6Fba9F97c104c2F0AFB3F1dcB88
799,15627838,259090,17116855726,257666,1424,402,2196,0x1111111254fb6c44bAC0beD2854e76F90643097d,0x1A63CD1aaF13e424DFA370D8D4dD326b5Fb4014a
800,15627838,5049560,17000000000,5042424,7136,1098,274,0x0a39DA505DfB5E0BBc6bd84428281A8ba1bC7753,0x495E889d1A6cEB447a57dcc1C68410299392380c
801,15627838,100000,13460000000,99056,944,138,159,0x956F47F50A910163D8BF957Cf5846D573E7f87CA,0x3C325DfeafaC6F08DB973E7dfD6E25490aE00Af1
802,15627838,268392,13320000000,262692,5700,1418,373,0x76f4eeD9fE41262669D0250b2A97db79712aD855,0xabC67a49D7d75bD04fA1DAE22cD4b8c4F796540a
803,15627838,800000,12116855726,796516,3484,1162,124,0x68b3465833fb72A70ecDF485E0e4C7bD8665Fc45,0xB18721357a023418A75310576D6787B22469C3E5
804,15627838,800000,12116855726,796600,3400,1162,127,0x68b3465833fb72A70ecDF485E0e4C7bD8665Fc45,0xe001b672D7e2E779fDc34D0E69bB223994621403
805,15627838,222222,12000000000,220658,1564,394,898,0x1Fa8559e873f698292766790AeCf8080A66433F6,0xF8796603477b641Ca33301F3c9BbeA2dBFBfC3a6
806,15627838,22000,11194257207,22000,0,2,20,0xf78Bf349211877E3B186f284E05a3b54D1DAF764,0xD430bA02Ad379fb79C72D7bc539fB5e109F8d1B3
807,15627838,191041,11000000000,190165,876,266,1384,0xd588b586D61C826A0e87919b3D1a239206d58bf2,0xC22d03e13B888Dabb33A1575e4F6542f0e996622
808,15627838,200000,11000000000,199784,216,74,163,0xb47e3cd837dDF8e4c57F05d70Ab865de6e193BBB,0x5E14f28F217cA7e20A4108e08C91686fBdd912D5
809,15627838,2000000,11000000000,1993460,6540,1874,7754,0x1111111254fb6c44bAC0beD2854e76F90643097d,0xe709837A251a8995e6f7A7AcA9D821a48C499Ce9
810,15627838,63000,10853283889,63000,0,2,2710044,0xcdF456f3C74C4cAe9E60b84a77EBfeCd306301DF,0xC098B2a3Aa256D2140208C3de6543aAEf5cd3A94
811,15627838,83211,10853283889,82567,644,138,4709899,0x3506424F91fD33084466F402d5D97f05F8e3b4AF,0x2FAF487A4414Fe77e2327F0bf4AE2a264a776AD2
812,15627838,350000,10664813663,350000,0,2,6925028,0xD631Bc52b1b69Bd79151be24B7d004e0Bc33f8aB,0x46340b20830761efd32832A74d7169B29FEB9758
813,15627838,21000,10284482681,21000,0,2,0,0x7E50433e8EF43112497A515FA4e313E8E11CB6cb,0x73C223D2dcAa6703EDC3bE9C91a151058683fd91
814,15627838,30000,10000000000,30000,0,2,3198,0x3e6722f32CBE5b3C7BD3dcA7017c7FfE1b9E5A2A,0x2240FFCB2330177D49578954B11445d7C7Db1e29
815,15627838,50000,10000000000,50000,0,2,718998,0x8b0D183156BE36A341dC61B14291f59Dec331D20,0xA4e5961B58DBE487639929643dCB1Dc3848dAF5E
816,15627838,327045,9616855726,321465,5580,842,2,0xC1E729cd98766b2cbDD337f4E76268a7A9Ea467b,0x5182EE69907ba935DDc8e22a196c4a2B9c111Afc
817,15627838,21000,9616855726,21000,0,2,19,0x46E485AD085103cb2b90A739b459918A75C71c8b,0xD854B4E12828328624b0a51748452E5A55c7188c
818,15627838,129691,9616855726,129487,204,74,250,0x7F9306FC1978938d5C1C57Bf6044dc67E07eeB8a,0x1E372D919Fa97242aa89eb0C6aad4778eD45e57f
819,15627838,143796,9616855726,143592,204,74,1164,0x7F9306FC1978938d5C1C57Bf6044dc67E07eeB8a,0x5dD9807d76c5204E79802e25977FC8D8433197F5
820,15627838,171345,9616855726,170697,648,266,429,0x77BD077fFFe51EdFC4913Ee50506a3e59063bbEa,0xcc4405Ee3eE4Db06E96B8CF74f7A55B7a9D194f5
821,15627838,143796,9616855726,143592,204,74,207,0x7F9306FC1978938d5C1C57Bf6044dc67E07eeB8a,0x81A1C87e8BcA4833944Eb93433828bC815F90A08
822,15627838,143796,9616855726,143592,204,74,12,0x7F9306FC1978938d5C1C57Bf6044dc67E07eeB8a,0x667d266bF464E657a1CCA3C7259777F9b912BAA9
823,15627838,136551,9516855726,136551,0,2,504,0xcB16aBb152c5119B1c239735309B3a6C65ed17B3,0xcB16aBb152c5119B1c239735309B3a6C65ed17B3
824,15627838,136551,9516855726,136551,0,2,2753,0x584456aaB0110A0f1B177D8a1Cde7AFF6D09A292,0x584456aaB0110A0f1B177D8a1Cde7AFF6D09A292
825,15627838,136551,9516855726,136551,0,2,531,0x8765984fF2C562cE411eF5549245CfD66DD29946,0x8765984fF2C562cE411eF5549245CfD66DD29946
826,15627838,136551,9516855726,136551,0,2,438,0x10157e8F70A8a971Fa16aED7982A58FfC8E9bF2c,0x10157e8F70A8a971Fa16aED7982A58FfC8E9bF2c
827,15627838,136551,9516855726,136551,0,2,252,0x800b87c7602976bFB7c4b05F454ea68F7229f01f,0x800b87c7602976bFB7c4b05F454ea68F7229f01f
828,15627838,136551,9516855726,136551,0,2,548,0xD98Dc21ae71606f11E5FB4Bd6BD8315BB1078D5d,0xD98Dc21ae71606f11E5FB4Bd6BD8315BB1078D5d
829,15627838,136551,9516855726,136551,0,2,466,0x21F11929694Bef09B17632125A7df0E2cb60D615,0x21F11929694Bef09B17632125A7df0E2cb60D615
830,15627838,136551,9516855726,136551,0,2,453,0x80c8Ed1080A2D8AEC288136Df3044b5c55f47E2C,0x80c8Ed1080A2D8AEC288136Df3044b5c55f47E2C
831,15627838,136551,9516855726,136551,0,2,739,0x8B5684791B923ce9e6E65639EcA74fcC058033eE,0x8B5684791B923ce9e6E65639EcA74fcC058033eE
832,15627838,136551,9516855726,136551,0,2,421,0x1b59ebD2eA04FC6a54b388e4408d6E7e4DA9A456,0x1b59ebD2eA04FC6a54b388e4408d6E7e4DA9A456
833,15627838,67695,9376488210,67631,64,10,56,0x88A27F3Ce2f7374b841e15E316E00AbE19339B84,0xBdded97972826D81caA65Bae117eF81b1DbF79d3
834,15627838,354319,9200000000,352259,2060,522,275,0x7a250d5630B4cF539739dF2C5dAcb4c659F2488D,0x80957e1cb928685AF3b034D4E811dDA69C159947
835,15627838,244782,9116855726,242022,2760,842,68,0x68b3465833fb72A70ecDF485E0e4C7bD8665Fc45,0x275b926d2448663b5C5C88976529378b56D6cF47
836,15627838,42000,9116855726,42000,0,2,329511,0x4B88654160c51DddAD67b28B242Ba349654D8183,0x9430801EBAf509Ad49202aaBC5F5Bc6fd8A3dAf8
837,15627838,100000,9116855726,99036,964,202,88931,0xA0b86991c6218b36c1d19D4a2e9Eb0cE3606eB48,0x3018018c44338B9728d02be12d632C6691E020d1
838,15627838,46267,9116855726,45691,576,74,30,0x283Af0B28c62C092C9727F1Ee09c02CA627EB7F5,0xA808AdD1FAFb2D4f8B25895c2733A518771635Ba
839,15627838,450781,9116855726,449489,1292,330,2737,0x7d2768dE32b0b80b7a3454c06BdAc94A69DDc7A9,0x1777281a2b6610D40FF726C3e03BbdC3b93D31aD
840,15627838,583622,9116855726,579970,3652,1162,12,0x68b3465833fb72A70ecDF485E0e4C7bD8665Fc45,0xF5d42c297DDEdb9c5B133CC4e2E86004e7b589f5
841,15627838,21000,9116855726,21000,0,2,12,0x61aB3d3637f27573bc5409f219cba6841e7bD18c,0x0Ca61df6FaC325a586B30a60468B068Bb13F9810
842,15627838,39617,9116855726,39353,264,74,700,0xC02aaA39b223FE8D0A0e5C4F27eAD9083C756Cc2,0x485D183Bb27af4B1E8e3c2b69a92f41f918F92bD
843,15627838,207128,9116855726,206532,596,138,3199165,0xdAC17F958D2ee523a2206206994597C13D831ec7,0x9696f59E4d72E237BE84fFD425DCaD154Bf96976
844,15627838,207128,9116855726,207128,0,2,4708687,0x759e2D316A8A9f8DD631608a09F098bc67f48230,0x28C6c06298d514Db089934071355E5743bf21d60
845,15627838,207128,9116855726,206520,608,138,3492267,0xdAC17F958D2ee523a2206206994597C13D831ec7,0x56Eddb7aa87536c09CCc2793473599fD21A8b17F
846,15627838,207128,9116855726,206532,596,138,4468931,0xdAC17F958D2ee523a2206206994597C13D831ec7,0x21a31Ee1afC51d94C2eFcCAa2092aD1028285549
847,15627838,100000,9116855726,100000,0,2,220347,0xAb792a852B9f849849aB11711FF97eaF9b9C29f7,0x079A892628EBf28d0Ed8f00151cff225A093dc63
848,15627838,21000,9116855726,21000,0,2,1,0xf89d7b9c864f589bbF53a82105107622B35EaA40,0x29Ef14Ba8b02881E40B8d73949490AAD87978BE1
849,15627838,21000,9116855726,21000,0,2,0,0xf89d7b9c864f589bbF53a82105107622B35EaA40,0xbd1F5c3f9FD9F932d79D8F259A5629ADB82381E7
850,15627838,113310,9116855726,113106,204,74,2052,0x5D004ddB5D92938dAF8448b9eac1CaA593cd26Ca,0x508B610a51bed4F2C8fF98CfD820271DA7AC231A
851,15627838,60799,9116855726,53271,7528,2506,122,0x00000000006c3852cbEf3e08E8dF289169EdE581,0x42Aa209d752AD365Dc81a9693E2ee1e2E68E3A6a
852,15627838,70000,9116855726,69404,596,138,147,0xdAC17F958D2ee523a2206206994597C13D831ec7,0xFA39AD2b6C403D60Dbf1deEd9c64FE78eC034702
853,15627838,30732,9116855726,30668,64,10,5,0xC02aaA39b223FE8D0A0e5C4F27eAD9083C756Cc2,0xB83976FF9Ab26d5Dfa0D8581C5b82Fd9f2E2Ce60
854,15627838,30732,9116855726,30668,64,10,259,0xC02aaA39b223FE8D0A0e5C4F27eAD9083C756Cc2,0x1096b85A3421794C801bdAa757efe5EF6E0Ca135
855,15627838,500000,9116855726,498224,1776,458,57376,0xa24787320ede4CC19D800bf87B41Ab9539c4dA9D,0xA83B11093c858c86321FBc4c20FE82cdbd58E09E
856,15627838,331316,9116855726,328364,2952,650,71,0x03f7724180AA6b939894B5Ca4314783B0b36b329,0xfCDc25ba0D9D9C16A40506802a50C6c0870d5BC6
857,15627838,46638,9116855726,46150,488,138,327,0xCF3bc939f9B2487092936F21cC0757b2b523B7aA,0xcc58C190F7b55eEe00F09437D766F05913194f7e
858,15627838,334834,9116855726,320874,13960,4618,62,0x83C8F28c26bF6aaca652Df1DbBE0e1b56F8baBa2,0x2d7540E2258a0504efEa1cf5433E651823714668
859,15627838,70000,9116855726,69392,608,138,518,0xdAC17F958D2ee523a2206206994597C13D831ec7,0xf5491f793D47A6Ea22f5e0B9AD3990CF66c4b40B
860,15627838,328689,9116855726,311013,17676,4106,504,0x1A90B3Dead0113740266b7F7Ea1136e8ED1b48C5,0x62Ef8b356751612Ad33863c454825BF94998AF2E
861,15627838,895572,9081855726,893560,2012,522,7990,0x7a250d5630B4cF539739dF2C5dAcb4c659F2488D,0x11191bcfe30c6aE7bBEF74c6De97c8D52FF957F9
862,15627838,179420,9000000000,177064,2356,586,165,0x75cdA57917E9F73705dc8BCF8A6B2f99AdBdc5a5,0x190fb3B4118e5633820184fE9217049A88f07FCF
863,15627838,50000,9000000000,50000,0,2,0,0x077D360f11D220E4d5D831430c81C26c9be7C4A4,0x0873f5d2Bd198b01Ae98DFeE309D1900c16AaCf1
864,15627838,275899,8940226871,273507,2392,586,56,0x53e0e51b5Ed9202110D7Ecd637A4581db8b9879F,0x1B87F20F5F648C92FBd867EbB05185Eb240891c7
865,15627838,130000,8940226871,129380,620,138,145,0x473037de59cf9484632f4A27B509CFE8d4a31404,0x7e666c2F303B58796cAb1Ba0dd52120Eb8aFd17A
866,15627838,200000,8835207118,198432,1568,330,3091,0x660802Fc641b154aBA66a62137e71f331B6d787A,0x1318d5c0C24830D86Cc27Db13Ced0CED31412438
867,15627838,30105,8821339031,30105,0,2,48493,0x4dC9e781Fef18fa4Dc5217A5Ee1156f668B5aF55,0x4dC9e781Fef18fa4Dc5217A5Ee1156f668B5aF55
868,15627838,250000,7116855726,249500,500,78,1079,0x9b873B45b23965CC69b81b5596e4Bf4DFE31b6bA,0x1c3F3ab470B3712424DBf22D39C343F0aa042F76
869,15627838,381781,8054200501,376953,4828,1546,327,0x68b3465833fb72A70ecDF485E0e4C7bD8665Fc45,0x8ff30523088a50Bbac9e2CB240d74AA676d7Bb77
870,15627838,250000,11836764471,249168,832,118,1080,0x9b873B45b23965CC69b81b5596e4Bf4DFE31b6bA,0x1c3F3ab470B3712424DBf22D39C343F0aa042F76
871,15627838,62288,8680000000,61608,680,138,4,0x95aD61b0a150d79219dCF64E1E6Cc01f0B64C4cE,0x3e3Fd307Ee520Ad5896D1603D21BF5fc2dd94F5A
872,15627838,2100005,8634816542,2094125,5880,1304,6995,0xE4000004000bd8006e00720000d27d1FA000d43e,0xFB2875efe1AA73F02d48046Fb2faD0308bc01E5d
873,15627838,159875,7116855726,159231,644,90,103234,0x01FF6318440f7D5553a82294D78262D5f5084EFF,0x5AA17fC7F2950ECa85376C3A8CB1509e8e4B39dF
874,15627838,301920,8116855726,298696,3224,906,317,0x68b3465833fb72A70ecDF485E0e4C7bD8665Fc45,0x95b3d459E5F5105E190E877bF99e73e2Cfa4A2d9
875,15627838,156264,11343193600,155300,964,130,103235,0x01FF6318440f7D5553a82294D78262D5f5084EFF,0x5AA17fC7F2950ECa85376C3A8CB1509e8e4B39dF
876,15627838,2267430,8626855726,2266978,452,138,46,0xe5f77F9D4974045E9c7f474ECC0E1065b93ccB50,0x22728FB916C38d23a70cE66Af2fc7c4C3a961a75
877,15627838,21000,8617855726,21000,0,2,56932,0x446dBdE3Ba2E03d9Aec5470d424A8d528053525B,0xa21A16EC22a940990922220E4ab5bF4C2310F556
878,15627838,157839,8616855726,155843,1996,778,135,0x03c545163bd114D756c65DDA1D97D37b89dA2236,0x43DD2d966D661e65a06861Aa42B9137D452E421E
879,15627838,320548,8616855726,317536,3012,650,3,0x7a250d5630B4cF539739dF2C5dAcb4c659F2488D,0x478AEC926aA00D69F004874f08558d1819c30848
880,15627838,46685,8616855726,46197,488,138,2467,0x133BA8F869F3ae35A5CA840BA20acfa31B0e2A61,0xA17138c0675173B8Ea506Fb1b96FA754BC316cc2
881,15627838,108144,8616855726,104068,4076,1290,491,0x0000000000c2d145a2526bD8C716263bFeBe1A72,0xC5e615b39dE5E528458094d476fD6708c2793E4a
882,15627838,491498,8616855726,487846,3652,1162,97,0x68b3465833fb72A70ecDF485E0e4C7bD8665Fc45,0x55E6B74AC10feB23B8A6b206345F9bEAc57e5011
883,15627838,47297,8616855726,46345,952,202,1,0xF7b8aabC98D169020b9EE716FC55541cF3e8B55B,0xbbC9D42A0d5F25aDf611017c2F37d6b3E98DE957
884,15627838,99655,8616855726,99451,204,74,0,0xB092Ec81F41c619EEa434357477ea8A4b1455755,0x4272Dd8C721133596E1Fe904af7bce6f10E8a84C
885,15627838,99262,8616855726,98642,620,138,633,0xA0b86991c6218b36c1d19D4a2e9Eb0cE3606eB48,0xa4a5C3591ABBfEd86ea1ED80495d7E27ef05200A
886,15627838,55923,8616855726,54979,944,138,94,0x19A4e33581c3b0ded84E6ce3Ba8515a4D45b5001,0x728441FE041422D6Ce3b2094C25FD3B00D190bcF
887,15627838,21000,8616855726,21000,0,2,185,0xc623483a440A6Fb5C0D41f8E30a9F3dF49a237Ad,0xeED22AE5286C1326a84F865C4c55a5Ad2c4cbB93
888,15627838,45399,8616855726,44447,952,202,396,0xC86664e7d2608f881f796ee8E24FA9d4d7598406,0x7D3E5dD617EAF4A3d42EA550C41097086605c4aF
889,15627838,204934,8616855726,198162,6772,1738,416,0x00000000006c3852cbEf3e08E8dF289169EdE581,0xB8ef7f2082a0783aef1a8F85ecf89f06CD94F812
890,15627838,98768,8616855726,98272,496,202,504,0x616D4635ceCf94597690Cab0Fc159c3A8231C904,0x27D48ec6907D30d759e9b1FcA802C624862A44e3
891,15627838,167180,8616855726,160628,6552,1802,22,0x00000000006c3852cbEf3e08E8dF289169EdE581,0x238D1e2c4078e43d24118e1306f4b6c1b80E5151
892,15627838,188642,8616855726,185378,3264,1034,159,0x68b3465833fb72A70ecDF485E0e4C7bD8665Fc45,0x09814ccb0D6688d708Aa20364C89818806B711C2
893,15627838,46065,8616855726,45577,488,138,153,0x29D7Ebca656665C1A52a92F830E413E394db6b4F,0x7cc26b600eC01F23209ba6fc80322Af5BD2B7155
894,15627838,21000,8616855726,21000,0,2,33,0xFBC7310f0df9D611775865d8Fe869B8B735821ed,0x1f80979fF683a101C8cDB90826743e0EB20e207e
895,15627838,21000,8616855726,21000,0,2,6,0x8d1644c1fA4EbfF287946293612bF7bD1E5DD5e8,0x25ed2e1444f103ae2C35B99E6Ad28c91301Aea92
896,15627838,46267,8616855726,45691,576,74,108,0x283Af0B28c62C092C9727F1Ee09c02CA627EB7F5,0x4D631b7130f4d6c46C5469d17D4B4aa9dE905378
897,15627838,370989,8616855726,370689,300,74,531,0x886a12483Babc4d0A8c422Dd4Ad2E50Eac1108db,0xB156C425F325d750968702D4Bd4226573EDC3aED
898,15627838,55923,8616855726,54979,944,138,95,0x19A4e33581c3b0ded84E6ce3Ba8515a4D45b5001,0x728441FE041422D6Ce3b2094C25FD3B00D190bcF
899,15627838,195779,8616855726,188971,6808,1810,68,0x00000000006c3852cbEf3e08E8dF289169EdE581,0xb231E5B824119E2a7AE637eb6a68bBfAfa059af6
900,15627838,60803,8616855726,53271,7532,2514,1083,0x00000000006c3852cbEf3e08E8dF289169EdE581,0x9072c5BC8976992265F7A72112Cc9d34EdB697c9
901,15627838,157447,8616855726,155195,2252,522,2,0xf4F1e0B0b93b7b2b7b6992B99F2A1678b07Cd70C,0x323383EE38c1F9eA332b3a52ba3D2Ad683ee2b1c
902,15627838,112544,8616855726,110520,2024,522,22,0x20362c5B7Ea1beDc84d28deEcd47d6807beBB18a,0x9a2BBc3a1b644Df5AD1E47D810A6Ce7397497115
903,15627838,328423,8616855726,325223,3200,906,224,0x68b3465833fb72A70ecDF485E0e4C7bD8665Fc45,0xa7C1d32B4bB7155Ad5e9e53F472b9CE61BB37ddc
904,15627838,149495,8616855726,143615,5880,1610,18,0x00000000006c3852cbEf3e08E8dF289169EdE581,0xA2e6FB5Bc88FB29a857c5fA8D07500B135dc1d55
905,15627838,21000,8616855726,21000,0,2,39,0x3E9A02FfcB1699B82C0861E047053D393Df88E0E,0x6079a3b75793D5125467d29860ee834fcB5CC9C7
906,15627838,46183,8616855726,45611,572,138,1516,0xD497A414bB00803E846B53d07Fcb742831B24906,0x9197f339ccA98b2Bc14e98235ec1a59cb2090d77
907,15627838,46267,8616855726,45691,576,74,257,0x283Af0B28c62C092C9727F1Ee09c02CA627EB7F5,0x34A19a7fd3383e89C943B3E44073c4d21837695C
908,15627838,46103,8616855726,45615,488,138,1705,0x34Bc797F40Df0445c8429d485232874B15561728,0x3CCA25E5920e61B2729f80aAf63df53A5Aba7284
909,15627838,46663,8616855726,46175,488,138,2468,0xDD2AafF62840048f48F006a822583133dD455773,0xA17138c0675173B8Ea506Fb1b96FA754BC316cc2
910,15627838,261721,8616855726,261517,204,74,195,0x55f1C36Bb7aE0d7D6caE97902E30A2306686Ec73,0x5bAB06Aab8aEcD0E60c8287391233F2285ad7071
911,15627838,46179,8616855726,45691,488,138,1335,0x64fdE08E23b4e3eaBaBCB8B0a52378B9e8cdFCa5,0x81093Ff97BEc7E0a499579EA4492bEcf3BC35b28
912,15627838,125078,8616855726,124802,276,74,12,0x8Bc3702c35D33E5DF7cb0F06cb72a0c34Ae0C56F,0x0dfE3D29F1599De07a81E5Fa9B6B8304711d087a
913,15627838,330044,8616855726,327868,2176,586,584,0xFbdDaDD80fe7bda00B901FbAf73803F2238Ae655,0x44137Aa861C4ED350f4Da91C2D7c1A3Dce378601
914,15627838,158978,8616855726,156170,2808,842,865,0x68b3465833fb72A70ecDF485E0e4C7bD8665Fc45,0x98610180C108AFc898043c3725a64DCb1da6bF27
915,15627838,131394,8616855726,125726,5668,1738,21,0xDef1C0ded9bec7F1a1670819833240f027b25EfF,0x9686b6A96083b7Ed7cef93319B05c96D4D0cf0d9
916,15627838,147042,8616855726,140402,6640,1810,317,0x00000000006c3852cbEf3e08E8dF289169EdE581,0xccAD221D9c55EFe5F46E69867e94698320B54dF4
917,15627838,55896,8616855726,54952,944,138,183,0x88A9A52F944315D5B4e917b9689e65445C401E83,0x6BfE59e8fEaDDfBdBb97F7Da8c6B4550a8bD4ffd
918,15627838,21000,8616855726,21000,0,2,9,0x5eEee9e52549F60C86e47DC31c5871ed84fa1F41,0xAfFa97795639c2fe77dce72dC1cdE9710B7Fd88E
919,15627838,46110,8616855726,45622,488,138,791,0x282A7D13152b3f51a3E31D46A2Ca563F8554d85D,0x4800FfC1E498702A52B499BC623a2CD2694f72Ef
920,15627838,170115,8616855726,169875,240,74,281,0xf11ED77fD65840b64602526DDC38311E9923c81B,0xAFfB93AfaD9570199BFdB00f1cA297287c30dcaf
921,15627838,56713,8616855726,55769,944,138,23,0x8a34D707189fBFa46930ABFDe3D22abDC48AB73D,0x8001E22B2b3948E8B2cEDCa34e0c1eAF24a7B648
922,15627838,227644,8616855726,224896,2748,842,231,0x68b3465833fb72A70ecDF485E0e4C7bD8665Fc45,0xf58f66Cb1ab1cEf422e193f7Cc70ee96e3a658BD
923,15627838,46616,8616855726,46128,488,138,147,0xe67F0887d22409c329054EdFcbF6ac0d0D4Cf3b1,0x3bc0Ca33F98B815AcD663A6Dd9F2bB5f46bdcde0
924,15627838,224449,8616855726,221617,2832,842,1133,0x68b3465833fb72A70ecDF485E0e4C7bD8665Fc45,0x6d01af8711133DEE2B2edfC54DC6Ce38223f8396
925,15627838,53799,8616855726,53311,488,138,45,0x7Ad53e7236D8d4Bf261dd5460c0aB31351b2b5A3,0x0cE10eB5640705DB40aB406F8d7EC2387909a040
926,15627838,150756,8616855726,150692,64,10,2,0x65c2e54a4c75ff6da7b6B32369c1677250075fb2,0x374e143dd089e27486563B417241B75cCc0568eB
927,15627838,21000,8616855726,21000,0,2,1,0xF87B63f9690D393cFc53359E833364633fCa5ddb,0xD56f5e165617d6346A1F2932Ca8B0806bF5d90d9
928,15627838,30732,8616855726,30668,64,10,311,0xC02aaA39b223FE8D0A0e5C4F27eAD9083C756Cc2,0x8788A09c09fE22Fae8edEa716FE770563d2da37f
929,15627838,153213,8616855726,145685,7528,1162,48147,0x271682DEB8C4E0901D1a1550aD2e64D568E69909,0xd13b46290f61dB3E6638bE2746e88F0c04AB883F
930,15627838,56739,8616855726,55795,944,138,15,0xEa466d99914Aec270d8537fAEb2c4b165534A09d,0x2373FF0e52B0355Ac56c11A046D5257C5ECFBfce
931,15627838,49175,8616855726,48687,488,138,589,0xeF3739eE528B8D74D0C2a906Aa469C67233c6B44,0xFC11E0eA39b41b39455AA6E9BA1Ebc0dFD48Db6B
932,15627838,21000,8616855726,21000,0,2,224,0xD1B9F05fC03Fa339859400EF87cF8a4BcA3014ef,0x0405dB1F582f6BA4064F6dA8d7660F13A850ef8A
933,15627838,261721,8616855726,261517,204,74,196,0x55f1C36Bb7aE0d7D6caE97902E30A2306686Ec73,0x5bAB06Aab8aEcD0E60c8287391233F2285ad7071
934,15627838,61351,8616855726,53271,8080,2506,137,0x00000000006c3852cbEf3e08E8dF289169EdE581,0xcdBf795F4bF9C2aefdF6E2b37268D832e40563C6
935,15627838,1583190,8616855726,1575802,7388,2442,1034,0x000000000000509081d6FCD3ee63e791aD1db763,0xeeD14aE0BC6555b6E8103fAda45d47E077d4C42b
936,15627838,21000,8616855726,21000,0,2,161,0x81835C904Dbc064C93eCE04368FCDE45122bc730,0x6a781932B54fd486B31e67d71dce63f59A4b65BA
937,15627838,94813,8616855726,94205,608,138,36,0xdAC17F958D2ee523a2206206994597C13D831ec7,0x953a144c352aC8220685F8E09B83b9A494d261AE
938,15627838,206729,8616855726,187241,19488,4682,642,0x00000000006c3852cbEf3e08E8dF289169EdE581,0x103246339988c3A3eC32086A179d6D6b8dE34c4F
939,15627838,46150,8616855726,45662,488,138,2469,0xdD0D63220265927b29646Cb7D4684D5Fa6dF4CB8,0xA17138c0675173B8Ea506Fb1b96FA754BC316cc2
940,15627838,108215,8616855726,107659,556,202,112,0xcDA72070E455bb31C7690a170224Ce43623d0B6f,0xBEe355672ab8fb7a531D7948555faFBd16f2B31c
941,15627838,79321,8616855726,78189,1132,394,6,0xAe833d9846385eC4a84465e33DC1A25401148B2c,0xFb0C2B9739F96313f6370E0862E2D683d0F2F25A
942,15627838,148122,8616855726,141446,6676,1810,102,0x00000000006c3852cbEf3e08E8dF289169EdE581,0x3b6915847D3c961de0f8BF994BeBb84A0e2f4929
943,15627838,46103,8616855726,45615,488,138,135,0x34Bc797F40Df0445c8429d485232874B15561728,0x3c96Fe5A26faD91ea4feF2522146bBFbD3814A4b
944,15627838,182322,8616855726,179514,2808,842,261,0x68b3465833fb72A70ecDF485E0e4C7bD8665Fc45,0x26e35CDb264614d6843B57D444082EA62709c4f9
945,15627838,73345,8616855726,72401,944,138,0,0xdAC17F958D2ee523a2206206994597C13D831ec7,0xe13819Cfe400f3bd0b96B5E8A94d7239B6c2A197
946,15627838,399914,8616855726,396298,3616,1162,81,0x68b3465833fb72A70ecDF485E0e4C7bD8665Fc45,0x2d9a7184A5f48B05b8D56068a2228e1F481D8Dc5
947,15627838,674674,8616855726,672098,2576,522,109,0x89d38cAaDc03B08D7f2e1674e34720A468aDD61E,0xae74824e9171BdFdDE0c2e3BE72b77AE27A97255
948,15627838,261721,8616855726,261517,204,74,197,0x55f1C36Bb7aE0d7D6caE97902E30A2306686Ec73,0x5bAB06Aab8aEcD0E60c8287391233F2285ad7071
949,15627838,46106,8616855726,45618,488,138,582,0x698FbAACA64944376e2CDC4CAD86eaa91362cF54,0xa0BC9F544453061B18202a377854ae28F837cD24
950,15627838,127670,8616855726,126742,928,394,74,0xeBD218aB65a793Ef506AF561093D0E7E9C9224f2,0x5E96591aA52BDcD1C0d2ba2566e2d9490055dAcF
951,15627838,3236366,8616855726,3233582,2784,842,33,0x68b3465833fb72A70ecDF485E0e4C7bD8665Fc45,0xB1C438BE81560a91317498AC82763Bf94e506464
952,15627838,21000,8616855726,21000,0,2,156,0xc623483a440A6Fb5C0D41f8E30a9F3dF49a237Ad,0x5cfF517E14BBD3134A9B11926AD4295BE8Baf339
953,15627838,21000,8616855726,21000,0,2,241,0x11a5B0a6fE34296bC94d81a6B3B29dB8698211d7,0x5746A5e8F8d695De82Db2C1346c7b2BAb4225766
954,15627838,46766,8616855726,46194,572,138,77,0x67df41EDf21e1c581A77E939f60db7bAa5E96993,0xd38c7F08B7fb62d24F371ff354d66fb74f8aFB34
955,15627838,50000,8561000000,49332,668,138,0,0xdAC17F958D2ee523a2206206994597C13D831ec7,0x739DA3B0522790530D61862445De86ed655E25E2
956,15627838,351711,8541639374,345643,6068,912,7123,0x0000000000036414940324055C43E75f56B7d016,0x8729539b95216E4fdD82957C05766CfeBaf75960
957,15627838,242472,8451489027,242472,0,2,111038,0x36a454aEF52938c8637CD4689B2980C1Cfd43389,0x36a454aEF52938c8637CD4689B2980C1Cfd43389
958,15627838,309016,8326857926,303256,5760,1676,538,0x881D40237659C251811CEC9c364ef91dC08D300C,0x949297c9675770f765d2796D99249Ee78Fb7A200
959,15627838,63589,8580961050,63325,264,74,72,0xC02aaA39b223FE8D0A0e5C4F27eAD9083C756Cc2,0x85E6cC88F3055b589eb1d4030863be2CFcc0763E
960,15627838,199419,8335403933,198067,1352,402,349,0x1111111254fb6c44bAC0beD2854e76F90643097d,0x4DFa78Fc61a7c4d09A9454327f70fA7C9214a429
961,15627838,289318,8335403933,287446,1872,458,3387,0x7a250d5630B4cF539739dF2C5dAcb4c659F2488D,0x2f2648328497A95aB21fB3E3ce5039F271686F36
962,15627838,23300,8116855726,23300,0,2,42,0xA9D1e08C7793af67e9d92fe308d5697FB81d3E43,0xFf0d2B2390D556fEf4Ef4e8D0Da7398A5Ec63A9b
963,15627838,23300,8116855726,23300,0,2,0,0xA9D1e08C7793af67e9d92fe308d5697FB81d3E43,0x312ef3cFff87C328965be834D3c9C098C604771a
964,15627838,23300,8116855726,23300,0,2,0,0xA9D1e08C7793af67e9d92fe308d5697FB81d3E43,0x50D558D5513dfF28D2B391f57840532b8EbD31dA
965,15627838,23300,8116855726,23300,0,2,1,0xA9D1e08C7793af67e9d92fe308d5697FB81d3E43,0x39F5A77428DC507190839C159026796fFCcb1F15
966,15627838,21000,8116855726,21000,0,2,28,0x3cD751E6b0078Be393132286c442345e5DC49699,0x67638c807eF0BD99F97C531AAA416801D582678D
967,15627838,21000,8116855726,21000,0,2,6,0x3cD751E6b0078Be393132286c442345e5DC49699,0x3b95CCbDB3F143c3285401eC8637b94479BE02CD
968,15627838,21000,8116855726,21000,0,2,0,0x3cD751E6b0078Be393132286c442345e5DC49699,0x9962C7f49444871643320523A7fCec5D51fBA7E2
969,15627838,23300,8116855726,23300,0,2,18,0xA9D1e08C7793af67e9d92fe308d5697FB81d3E43,0xA6dbA006d7C7d82541a77D1a6203780A19900F32
970,15627838,21000,8116855726,21000,0,2,5,0x3cD751E6b0078Be393132286c442345e5DC49699,0x6E2ae8D2CeF3B9f849F29BeD96e698210e57e391
971,15627838,21000,8116855726,21000,0,2,0,0x3cD751E6b0078Be393132286c442345e5DC49699,0x10749B963282E0300a641aDc9927d2cbb827417F
972,15627838,21000,8116855726,21000,0,2,0,0x3cD751E6b0078Be393132286c442345e5DC49699,0xB87f53934Be5E004E42eF5AA80fF26E9f4D72e92
973,15627838,21000,8116855726,21000,0,2,0,0x3cD751E6b0078Be393132286c442345e5DC49699,0xE34CE525fE2af389986E3e820aEdbd9EE8bA796E
974,15627838,21000,8116855726,21000,0,2,4,0x3cD751E6b0078Be393132286c442345e5DC49699,0x23F1eb2D34E402b346F90dcB397e068a97eE5b61
975,15627838,315118,8116855726,313690,1428,266,14885,0xF71530c1f043703085B42608ff9DCcCc43210a8E,0xF90029931C7a9A27E350cd35c91cbEdbB58350c4
976,15627838,461905,8116855726,460221,1684,292,26581,0xC8046263d5B5544F6413a98B4693488499195A46,0xEf5a3745F822f8F83693564c54904d7FF156CFb2
977,15627838,21000,8116855726,21000,0,2,0,0x3cD751E6b0078Be393132286c442345e5DC49699,0xDEA9551B2b817EFE30372b1635D66124E74c32d8
978,15627838,383724,8116855726,378500,5224,1018,105721,0x0000000000007F150Bd6f54c40A34d7C3d5e9f56,0x60530f5Ca4CB9907e0FBE67cA3AFCbFE56D19A5c
979,15627838,46336,8116855726,45848,488,138,225,0x00b469E0703710C65DB9Af22e7451F4D4d2FfDEe,0x68a9360E07a5fe96a2209A64Fa486bB7B2dF217B
980,15627838,21000,8116855726,21000,0,2,469152,0x0925cb64Dba09874e23d7913Dd033A8599445428,0xb739D0895772DBB71A89A3754A160269068f0D45
981,15627838,21000,8116855726,21000,0,2,8265744,0xBD9Fdfe98324C75ce3f46639aCFa5E735b1163E4,0xb5d85CBf7cB3EE0D56b3bB207D5Fc4B82f43F511
982,15627838,67532,8116855726,66068,1464,458,229,0x7852f8Be40B050b7984cF7a8Ab7ffDc0C90073C2,0x0fccd63c11bDB7155aa8De1262F273140C91007d
983,15627838,175110,8116855726,173546,1564,394,2548,0x1Fa8559e873f698292766790AeCf8080A66433F6,0x9b1acD4336EBF7656f49224d14A892566fd48e68
984,15627838,297198,8116855726,293898,3300,1034,485,0x68b3465833fb72A70ecDF485E0e4C7bD8665Fc45,0x7862958ee0797a7ABD33A65030fC608a656febB7
985,15627838,2000000,8116855726,1992096,7904,1866,171032,0xA9D1e08C7793af67e9d92fe308d5697FB81d3E43,0x7830c87C02e56AFf27FA8Ab1241711331FA86F43
986,15627838,21000,8116855726,21000,0,2,469153,0x2cDc85729c6986c940e49A4d3D654CDb96DD574C,0xb739D0895772DBB71A89A3754A160269068f0D45
987,15627838,21000,8116855726,21000,0,2,7100793,0x843A0D6B5796Ce821300c36769CaA1B3d0848548,0xddfAbCdc4D8FfC6d5beaf154f18B778f892A0740
988,15627838,21000,8116855726,21000,0,2,6578028,0x25D26E77Ca7b80a8097Af03f36c61967D5dE1366,0xeB2629a2734e272Bcc07BDA959863f316F4bD4Cf
989,15627838,224901,8116855726,223333,1568,402,9,0x1111111254fb6c44bAC0beD2854e76F90643097d,0x94f01B39a69C825b30Aab18f638A8693C6E17de4
990,15627838,2000000,8116855726,1991080,8920,1930,171033,0xA9D1e08C7793af67e9d92fe308d5697FB81d3E43,0x7830c87C02e56AFf27FA8Ab1241711331FA86F43
991,15627838,53915,8116855726,53427,488,138,406,0x6de7aC835EC6841Af9b94fd1273dB83B8d69e3f7,0x2d42e1EeC1c61dD9d1dDff2405E91BA6179Aa0B8
992,15627838,21000,8116855726,21000,0,2,469154,0x3964101b0F3c52343DF5CADa80C86F32516a4689,0xb739D0895772DBB71A89A3754A160269068f0D45
993,15627838,21000,8116855726,21000,0,2,469155,0xa8E1Cee40Cb3419F0d1F1A8bc400Cb7396e7125e,0xb739D0895772DBB71A89A3754A160269068f0D45
994,15627838,203272,8116855726,200440,2832,842,70,0x68b3465833fb72A70ecDF485E0e4C7bD8665Fc45,0x66f54Ca911390De3F6C92158a7c516B4B169fBd0
995,15627838,55747,8116855726,54803,944,138,172,0x461B71cff4d4334BbA09489acE4b5Dc1A1813445,0x06f0e4207Ac4e8b1c798113f4cc977d0331d1A1B
996,15627838,54685,8116855726,53721,964,394,2353,0x645E9324f4be25be581BB62163cfa86c40b01D07,0xc5009AFEd2D6DA219538aD165998F63B553185B1
997,15627838,584563,8054200501,579859,4704,1418,2,0xa2398842F37465f89540430bDC00219fA9E4D28a,0xf8bb90EBF6CFb5D162777AEd13Cb7fd34B5881B6
998,15627838,21000,8000000000,21000,0,2,45,0x14456c6FbAa40fF6Cba201117B5D479d873B92DC,0x3c0FF5B8b11cCD241B8F2466e98461093BAd85BB
999,15627838,381786,8000000000,376958,4828,1546,3495,0x68b3465833fb72A70ecDF485E0e4C7bD8665Fc45,0x8C0BD42871560151705F3d0a2d6714e0bd8c4a06
1000,15627838,70000,8000000000,69736,264,74,4342,0x91D74E31A2734F4E519861aB9917048822f0B489,0xEB8202A72868229b2Ad8f4Dd41AfcD14708B9079
1001,15627838,191077,7995898005,190177,900,266,85,0xd588b586D61C826A0e87919b3D1a239206d58bf2,0x710E29C9c3bD8904Eb3d993b05E1bE418Bc715aa
1002,15627838,187640,7678937517,186956,684,92,287,0xdb7A53E6AE058E1Dcf4502341E2ADFA522E2B29F,0xa23cABeCa2145Ce4e6fdD81a45be8fB53A4F9535
1003,15627838,289947,7651147194,286619,3328,970,17,0x68b3465833fb72A70ecDF485E0e4C7bD8665Fc45,0xf7246349B50B35E33d97dAACF5119358Ab7a3b71
1004,15627838,73206,7651147194,72586,620,138,342,0xA0b86991c6218b36c1d19D4a2e9Eb0cE3606eB48,0x5912e6c2A1d9FB496a80e77a7c6926f8Aa919cb4
1005,15627838,21000,7624651845,21000,0,2,1228,0x3A763f1048B1B0806088e3237920EeFd924ecd62,0xb879e2BFc51DF4f25EAFA7A99C1baf09baF3c020
1006,15627838,421376,7304324681,175700,245676,30956,183239,0x5E4e65926BA27467555EB562121fac00D24E9dD2,0x6887246668a3b87F54DeB3b94Ba47a6f63F32985
1007,15627838,93112,7133384384,91948,1164,266,70,0xd588b586D61C826A0e87919b3D1a239206d58bf2,0xD3a0a2344d889a58FF3Ea581a57F97C9A4183f16
1008,15627838,26000,7116855726,26000,0,2,12018,0x4e9Cc05F7F944D618DE85396e669922c2CF6813E,0xDAFEA492D9c6733ae3d56b7Ed1ADB60692c98Bc5
1009,15627839,90000,15000000000,89392,608,138,12620,0x05237E2bd2dfAb39a135d254cABAE94b183C8baD,0xFd25F5A3415e29f0AeeB5746E5D513DE67169225
1010,15627839,146694,15000000000,140222,6472,1738,246,0x00000000006c3852cbEf3e08E8dF289169EdE581,0x92e2316186d5406ba37193c054e0752de7b74a33
1011,15627839,21000,9650154522,21000,0,2,61,0x2cE8742c390143c8fB7ce4118550183990e35815,0x2EfAaf089050FC3ADdf6E05EaEfA294CE663976B
1012,15627839,237334,9650154522,234514,2820,842,152,0x68b3465833fb72A70ecDF485E0e4C7bD8665Fc45,0x4d7618a7a2A8CE5155986841ad09cb1e003D87Ef
1013,15627839,90000,9650154522,90000,0,2,93924,0xA9E37368004605E856991a0A21ac766703429BD5,0xf89d7b9c864f589bbF53a82105107622B35EaA40
1014,15627839,740000,9150154522,729004,10996,2506,94405,0x2Abfc56AaA39be7a946ec39aAC5d452e30614dF1,0xb976d01275B809333E3EfD76D1d31fE9264466D0
1015,15627839,143335,9150154522,136711,6624,1802,5797,0x00000000006c3852cbEf3e08E8dF289169EdE581,0x2f3A54BF279d3CDc31DD363E380c69346EFd2d9d
1016,15627839,203714,9150154522,197102,6612,1802,74,0x00000000006c3852cbEf3e08E8dF289169EdE581,0x9CAb85210e4F82f2128c0975429c256e31FdEfC5
1017,15627839,83636,9150154522,79332,4304,1290,559,0xA52Fd396891E7A74b641a2Cb1A6999Fcf56B077e,0xe7Ad7d90639A565FE3A6F68A41AD0B095f631F39
1018,15627839,21000,9150154522,21000,0,2,3,0x7BCE759BC34f7FD60D20D197604576B45a8cb564,0xDE09227eA34664Bf9204C694ccC2BcAb988624EF
1019,15627839,46112,9150154522,45624,488,138,2470,0xF3FCd0F025c21F087dbEB754516D2AD8279140Fc,0xA17138c0675173B8Ea506Fb1b96FA754BC316cc2
1020,15627839,199875,9150154522,199811,64,10,81,0xBBe3B63484345148D32feabE0912c308a60c879a,0xCB43078C32423F5348Cab5885911C3B5faE217F9
1021,15627839,179835,9150154522,173183,6652,1810,43,0x00000000006c3852cbEf3e08E8dF289169EdE581,0xD618A0da87593d5Ea4830bA45bD21E5F62318fB3
1022,15627839,241614,9150154522,236662,4952,714,62,0x000000000000509081d6FCD3ee63e791aD1db763,0xb90Af6078C786462aeFC440B0fD7F80B9e2C7786
1023,15627839,227502,9150154522,222390,5112,1418,9,0x68b3465833fb72A70ecDF485E0e4C7bD8665Fc45,0xD1dfEcC553dcD62dc416CC55593ECD33689FB7E2
1024,15627839,46119,9150154522,45631,488,138,129,0xB852c6b5892256C264Cc2C888eA462189154D8d7,0xd02Cf0BFae434D95E634F7A303452b85e14b65a9
1025,15627839,68780,9051893909,68184,596,138,0,0xA0b86991c6218b36c1d19D4a2e9Eb0cE3606eB48,0xFfD3776F68F8C65eFBB5396C0183Fc69f82E5EDa
1026,15627839,21000,9025154522,21000,0,2,56933,0xC4A0f2a9E6D375bcD51f1613618AbEFaaD725B7A,0xa21A16EC22a940990922220E4ab5bF4C2310F556
1027,15627839,90000,9000000000,90000,0,2,449974,0x6840c622Fd4aD7A7Fe1061FdBbC6b9A6eeD4092d,0x077D360f11D220E4d5D831430c81C26c9be7C4A4
1028,15627839,254317,8650154522,247661,6656,1938,9,0x11111112542D85B3EF69AE05771c2dCCff4fAa26,0x5E76aB7d210c5F1C9cD931257e59591391d50E1e
1029,15627839,250000,8650154522,250000,0,2,45337030,0x67840aB2387033aB4AC1C43a86FE6e00f2517311,0xEA674fdDe714fd979de3EdF0F56AA9716B898ec8
1030,15627839,250000,8650154522,250000,0,2,45337031,0xbAE1AeAf99c13bFa765a00AB6334cA9F5A0173Fc,0xEA674fdDe714fd979de3EdF0F56AA9716B898ec8
1031,15627839,21000,8157950641,21000,0,2,4457,0xaA072f4427c07E1F222e39984deb05bE98DE4328,0x6306A2D99FdeeBF725e7d60D73e0Eb4A8ff39584
1032,15627839,361861,8000000000,359837,2024,522,23,0x7a250d5630B4cF539739dF2C5dAcb4c659F2488D,0x03f08c89362DC4d3416ab59e6947fC313f6202bd
1033,15627840,21000,50000000000,21000,0,2,29068,0x2017BD725F9432Cee396dc43e34680d5C649d129,0x8b8a4abc707F16dA24B795e3e46ed22975A9D329
1034,15627840,21000,30000000000,21000,0,2,1005592,0x4cB05F13e831F6CF30Adf9772645B6F493f6A634,0xc5a93444Cc4dA6EfB9e6FC6e5D3CB55A53b52396
1035,15627840,21000,30000000000,21000,0,2,1005593,0xD1305FbDA97C035F86FdAA7785fb568C203174E1,0xc5a93444Cc4dA6EfB9e6FC6e5D3CB55A53b52396
1036,15627840,21000,16000000000,21000,0,2,44,0x60427a370Fb2AAdD19f83a07DD2E19C69EEfc4DA,0xEd679373Da425385A7c759Ae42C73512d28ad91c
1037,15627840,21000,15000000000,21000,0,2,46,0x4AD8d9cF9424B477E77a0d7c339c4de792B92Fc6,0xab3532631180Ba92C6155ea8a5A96824d5cD792a
1038,15627840,21000,13000000000,21000,0,2,52,0x052B52deB866d3878943484F778303e494F3D260,0x507515e2330F439DA0112C60b0E037a446269140
1039,15627840,30000,12857731690,30000,0,2,626253,0xF93DA16dc5cBA20BADa4Cef18199F3D2453d4089,0xB01cb49fe0D6D6E47EDf3A072d15dfe73155331C
1040,15627840,100000,12188771887,99404,596,138,3,0xdAC17F958D2ee523a2206206994597C13D831ec7,0xd0AdF39A711B2349A49F4E4703E74c129dA3bd3d
1041,15627840,63398,12188771887,62790,608,138,2,0xdAC17F958D2ee523a2206206994597C13D831ec7,0x147124a654927511d2136e4ab988F598d3904b6b
1042,15627840,21000,12000000000,21000,0,2,116,0x75CE0A06A40b86D5c9D43F9f9c14D8b060C3E7F8,0xD6B66097B8f07138c210fCB6103B16Ab64799Ebe
1043,15627840,21000,11743049760,21000,0,2,0,0xCBD6832Ebc203e49E2B771897067fce3c58575ac,0x7233d2B091a159982C6eAAbd42EA1200B8363C85
1044,15627840,21000,11000000000,21000,0,2,2323,0xaac22D4Cfe4E62fba6CE5b1ab1561c4023FFFea6,0xce0df2BA6c2BD425F3Ffbbea708F0B5f21ae1e6a
1045,15627840,30000,11000000000,30000,0,2,3199,0x3e6722f32CBE5b3C7BD3dcA7017c7FfE1b9E5A2A,0x2240FFCB2330177D49578954B11445d7C7Db1e29
1046,15627840,226670,10857731690,215662,11008,3466,1362,0x74312363e45DCaBA76c59ec49a7Aa8A65a67EeD3,0x259E4BD1F1f803Db79ee71aB19Ad49E43C0E1B0B
1047,15627840,350000,10664813663,350000,0,2,6925029,0xc90Cc98182737FbF037E443d8d16d61099e5e2cD,0x46340b20830761efd32832A74d7169B29FEB9758
1048,15627840,350000,10664813663,350000,0,2,6925030,0x5BB9a7ee203588652eED0CD9479BE24027D68d6B,0x46340b20830761efd32832A74d7169B29FEB9758
1049,15627840,350000,10945946742,349356,644,138,6925031,0x514910771AF9Ca656af840dff83E8264EcF986CA,0x46340b20830761efd32832A74d7169B29FEB9758
1050,15627840,63000,10655446721,63000,0,2,183630,0xfDA65B9412b1a4c9eEc57F19769B26E5C338F94b,0x25eAff5B179f209Cf186B1cdCbFa463A69Df4C45
1051,15627840,21000,9940000000,21000,0,2,21,0x6C1A1642E9A7C9eEc623a1ae18051e90470de989,0xE8b6083156aBcf37a243d2E54CD1768cD3958b60
1052,15627840,163781,9900000000,157217,6564,1802,471,0x00000000006c3852cbEf3e08E8dF289169EdE581,0x2dC6cC948353d2DaE3FeB95afE5DA5eC5f6b8c48
1053,15627840,850000,9857731690,848072,1928,522,114,0x7a250d5630B4cF539739dF2C5dAcb4c659F2488D,0x35328a6bbb43BB53f0838Ec98225C46Bc367087d
1054,15627840,21000,9857731690,21000,0,2,0,0xD91664F23a70374107c7128975Ed3FD37ACeF304,0x7EcdeaD9965507b03C8aD1902C595975d2B836ef
1055,15627840,276822,9857731690,274986,1836,458,85,0x7a250d5630B4cF539739dF2C5dAcb4c659F2488D,0x5688bCe725aF46e3058D144045BA7FBe1c16A592
1056,15627840,55978,9857731690,55034,944,138,86,0xd4cB651749953988647eEE9b51DDB8DB5aeb3410,0x5688bCe725aF46e3058D144045BA7FBe1c16A592
1057,15627840,46649,9357731690,45705,944,138,256,0xd4cB651749953988647eEE9b51DDB8DB5aeb3410,0x63aaC08e966f7Cc16e89102b7e882a867492A69f
1058,15627840,143796,9357731690,143592,204,74,556,0x7F9306FC1978938d5C1C57Bf6044dc67E07eeB8a,0x6b1Fd5D876771b764D0131746dF48C1054e37f73
1059,15627840,278499,9357731690,274831,3668,906,10,0x197492CCB4B1acaAAcd43432657A17832E36AB49,0xf5B4Fbc8B5A4d193D7cFB3dC0022DBF201654a3c
1060,15627840,70000,8857731690,69392,608,138,33,0xdAC17F958D2ee523a2206206994597C13D831ec7,0x19BF43045B58Eb08E6c1701f1Bfb629fd08A7e69
1061,15627840,21000,8857731690,21000,0,2,25,0x44FFCb49cf4F143267d5e3EE74532e1BB7b39236,0x9913ac6011C6301487c1eaEAd7B2B59f5aA43680
1062,15627840,181476,8857731690,179912,1564,394,198,0x1Fa8559e873f698292766790AeCf8080A66433F6,0x7dCc54460D8aB80809C49BC775143A0A9a1485c3
1063,15627840,50000,8857731690,50000,0,2,170061,0xA0443c95178fE24331378ab223Ff8E5642C6132b,0x8D56f551b44a6dA6072a9608d63d664ce67681a5
1064,15627840,42000,8857731690,42000,0,2,329512,0xEb8D5725A73296C209A22425805099FE1e29C04D,0x9430801EBAf509Ad49202aaBC5F5Bc6fd8A3dAf8
1065,15627840,1094326,8857731690,1077074,17252,2442,38,0xbB0600De90a6f9a3407F8D9149D0c901dB650E47,0xa23CB57ccC903e18dd5B4399826B7FC8c68D0C9C
1066,15627840,30732,8857731690,30668,64,10,47,0xC02aaA39b223FE8D0A0e5C4F27eAD9083C756Cc2,0x0565df3f5aad5a45D340B98D1e95F255e238cDc3
1067,15627840,300000,8857731690,299000,1000,202,93,0xaBEA9132b05A70803a4E85094fD0e1800777fBEF,0x4d3EAC87E7aB16a20FBC84220333BB3c92352C5d
1068,15627840,248900,8857731690,246140,2760,842,467,0x68b3465833fb72A70ecDF485E0e4C7bD8665Fc45,0xF4aac9421fb27d6f969015333EEE52BceD4A0c82
1069,15627840,308615,8857731690,299171,9444,2636,5555,0x881D40237659C251811CEC9c364ef91dC08D300C,0x34E2cB7513A50b19f450a067ed5230A86c13A2E9
1070,15627840,39865,8857731690,39801,64,10,3570,0x37861cCdDB1e36a9Dc732eb12ea570438173f0b6,0xCE222910bA7524cADc75DDC7c57Ec5b97E8bFfc9
1071,15627840,143796,8857731690,143592,204,74,2284,0x7F9306FC1978938d5C1C57Bf6044dc67E07eeB8a,0xED04d3792C439b8Af827B3e46EE626827De53Db5
1072,15627840,56667,8857731690,55723,944,138,367,0xB97Ad583dacB8Bd46F75b3593c6eF2ec598Ef37e,0xc4331008949DEe0eb51B3fb8262a8d842FA6a372
1073,15627840,39617,8857731690,39353,264,74,1061,0xC02aaA39b223FE8D0A0e5C4F27eAD9083C756Cc2,0x050C1C3D2E802dD6208Acee28806CC65f35F9327
1074,15627840,207128,8857731690,207128,0,2,3199166,0xf063312ac32C29D5Bd0D4120D1226151A30DA9D2,0x9696f59E4d72E237BE84fFD425DCaD154Bf96976
1075,15627840,207128,8857731690,207128,0,2,4468932,0xBc2eF17D0243b9ddeeaB5C5C5E06E71c40f36313,0x21a31Ee1afC51d94C2eFcCAa2092aD1028285549
1076,15627840,41907,8857731690,41843,64,10,137,0xC02aaA39b223FE8D0A0e5C4F27eAD9083C756Cc2,0x5E9cD215CE51d819Cc8A27C52B02CaaE6F7F4965
1077,15627840,21000,8857731690,21000,0,2,7,0x7c50f97AE5C5704752597170e65fe7E38f191D88,0x065459A36F775FEB852097e9030c0927723bE8c4
1078,15627840,21000,8790000000,21000,0,2,26,0x292f04a44506c2fd49Bac032E1ca148C35A478c8,0xC8f711E90d4f77d60c0C3F266c68CA640a427408
1079,15627840,21000,8780226871,21000,0,2,0,0xBb3fd383d1C5540E52EF0A7bcb9433375793aEAF,0x46E485AD085103cb2b90A739b459918A75C71c8b
1080,15627840,74355,8645168691,73699,656,138,463302,0x3506424F91fD33084466F402d5D97f05F8e3b4AF,0xB8001C3eC9AA1985f6c747E25c28324E4A361ec1
1081,15627840,286257,8357731690,278981,7276,2314,9,0x0000000000c2d145a2526bD8C716263bFeBe1A72,0x7d39d36D3d5E9397C2A76637264C323AC86Eb841
1082,15627840,168329,8357731690,161737,6592,1810,89,0x00000000006c3852cbEf3e08E8dF289169EdE581,0x7Fa4Fe89790DCFfCf3F155ea49781DE4b4eA9b34
1083,15627840,100239,8357731690,99287,952,202,53,0xba30E5F9Bb24caa003E9f2f0497Ad287FDF95623,0x58d057a9F7b5825f3aCeEFB3af79e6E1baCdF4e9
1084,15627840,133832,8357731690,112116,21716,7242,74,0x00000000006c3852cbEf3e08E8dF289169EdE581,0x9Fc923e741a7a8258CbFEa60050348adE2B07a49
1085,15627840,342209,8357731690,338401,3808,970,82,0xF849de01B080aDC3A814FaBE1E2087475cF2E354,0xFB96D60ce3ee83ed4BC71c6E0da10C537601b77C
1086,15627840,102226,8357731690,102010,216,74,716,0x64Ad353BC90A04361c4810Ae7b3701f3bEb48D7e,0xC7b72Bb1aCDcE3eB45f9B38F43cD31e4927C725b
1087,15627840,237349,8357731690,234517,2832,842,1134,0x68b3465833fb72A70ecDF485E0e4C7bD8665Fc45,0x6d01af8711133DEE2B2edfC54DC6Ce38223f8396
1088,15627840,60727,8357731690,53271,7456,2506,583,0x00000000006c3852cbEf3e08E8dF289169EdE581,0x87328d520C9801d00EE97DCA74e4ed5D9d298dB9
1089,15627840,21000,8357731690,21000,0,2,31,0x80626F32C252EB332C1963F21836969f6c03629E,0x7F0ceB3F82f7E150ECf89d96a87B800f46312a1b
1090,15627840,144827,8357731690,144623,204,74,0,0xB092Ec81F41c619EEa434357477ea8A4b1455755,0xA0f081aD0a561c6e65d005cA846A34bE4FD3ac07
1091,15627840,79132,8357731690,78476,656,138,6,0x55296f69f40Ea6d20E478533C15A6B08B654E758,0xb1EFcCAE4963A89c4cfBcb034e5177043F188977
1092,15627840,250644,8357731690,245768,4876,1546,154,0x0000000000c2d145a2526bD8C716263bFeBe1A72,0x7cc26b600eC01F23209ba6fc80322Af5BD2B7155
1093,15627840,46179,8357731690,45691,488,138,2471,0xA23147f7757f94DF82Bc9C062B9F58ff1e1D69bC,0xA17138c0675173B8Ea506Fb1b96FA754BC316cc2
1094,15627840,1979322,8357731690,1848554,130768,43402,70,0x83C8F28c26bF6aaca652Df1DbBE0e1b56F8baBa2,0x836ec3A096B15Ad91d344A836738e9FAB149675E
1095,15627840,46267,8357731690,45691,576,74,224,0x283Af0B28c62C092C9727F1Ee09c02CA627EB7F5,0x57679F905F9618d50a638cc1fe272003A831cec1
1096,15627840,236352,8357731690,233580,2772,842,1451,0x68b3465833fb72A70ecDF485E0e4C7bD8665Fc45,0xe41739c0156b0Ca57a402CBe3BeeF47bd273070D
1097,15627840,176982,8357731690,170354,6628,1810,68,0x00000000006c3852cbEf3e08E8dF289169EdE581,0x2a0C7667A873D09Dd059b88E7311C3AE2C33AC2F
1098,15627840,231014,8357731690,225070,5944,1738,14,0x68b3465833fb72A70ecDF485E0e4C7bD8665Fc45,0xF6756b3C8C36480B15a74C491c6FC1193B764eFC
1099,15627840,202725,8357731690,199881,2844,842,277,0x68b3465833fb72A70ecDF485E0e4C7bD8665Fc45,0x8013F0aEB145e4527d31032A3370f3B581C92152
1100,15627840,134628,8357731690,128748,5880,1610,1620,0x00000000006c3852cbEf3e08E8dF289169EdE581,0x7F6A23E4E952c4C7CD9ba83978Eb29964984946C
1101,15627840,88083,8357731690,87231,852,266,20,0xfc33E8b6E160A81DdB442B07355D01DF711EFEee,0xdBd8642Fc457dA6275d854571358dAE55CE96D3F
1102,15627840,92393,8357731690,92189,204,74,618,0x0D16d8F2d2f5D0EFdaBaAD98656c50c5A2A27F79,0x643ce52422B668F0E226dd21B4bB8D3A1fAbcA51
1103,15627840,117738,8357731690,117534,204,74,25,0x7F9306FC1978938d5C1C57Bf6044dc67E07eeB8a,0x9a153C18A5489E97c51f76aF07f07FcB08471A2a
1104,15627840,21000,8357731690,21000,0,2,44,0x1Df8A81ceff8905B9448713C8443CAFADC7C052f,0x2771c8d33218038f208B0ab7da04c8413eeF9C69
1105,15627840,180520,8357731690,176892,3628,1162,29,0x68b3465833fb72A70ecDF485E0e4C7bD8665Fc45,0x4286066191295F70b10878a79C3F36B282DbE01d
1106,15627840,305932,8357731690,303572,2360,522,6,0x283Af0B28c62C092C9727F1Ee09c02CA627EB7F5,0x409Eb9D78a4d5D6863947f2e5A7AD1E4f5b47C76
1107,15627840,201102,8357731690,197486,3616,1162,1681,0x68b3465833fb72A70ecDF485E0e4C7bD8665Fc45,0x931b23DaC01EF88BE746d752252D831464a3834C
1108,15627840,254616,8357731690,245536,9080,2826,19,0x00000000006c3852cbEf3e08E8dF289169EdE581,0x2CEe2fA9D80E503EcFe4547017DeF1cfDF8c3762
1109,15627840,94795,8357731690,94199,596,138,47,0xdAC17F958D2ee523a2206206994597C13D831ec7,0x59360ed468D454bc069cA583CC6bE239dB46BDf8
1110,15627840,191284,8357731690,188044,3240,1034,21,0x68b3465833fb72A70ecDF485E0e4C7bD8665Fc45,0x389d96a6eE133EdA37138d63b10EB7Cf614AD6e5
1111,15627840,59981,8357731690,58005,1976,450,0,0x4D9079Bb4165aeb4084c526a32695dCfd2F77381,0x293D3b85d7d151B64135CCd1470A4440e9247e72
1112,15627840,21000,8357731690,21000,0,2,1455,0xb41eb83113Aecd6082fDf005294F7A510A60d326,0x023D0355195dae794095e87824e538Ba60E3c360
1113,15627840,46859,8357731690,46371,488,138,5,0x197492CCB4B1acaAAcd43432657A17832E36AB49,0x16d04b941d48da89B9f6BD02E1178eeC443b2aa6
1114,15627840,46682,8357731690,46194,488,138,962,0x421446f756235aE519cf474c794ff58777256586,0x5A776Ea5e89d6F4504b208A6BD459D912A2ee22e
1115,15627840,54819,8357731690,54323,496,202,113,0x17D084106C2f1C716ce39fa015AB022757d30C9A,0x9dCf8caA1c12e5557843abeFba778795E79633ce
1116,15627840,150000,8263748852,149760,240,74,638772,0xA0b86991c6218b36c1d19D4a2e9Eb0cE3606eB48,0x55FE002aefF02F77364de339a1292923A15844B8
1117,15627840,53568,8134443152,52624,944,138,186,0x576E916f0d2aBec05957b303050Fb99cDfB583BB,0x20a97121343C7a2CED11f969588aa29d0Aa79007
1118,15627840,276606,8134443152,274746,1860,458,3388,0x7a250d5630B4cF539739dF2C5dAcb4c659F2488D,0x2f2648328497A95aB21fB3E3ce5039F271686F36
1119,15627840,70000,8000000000,69368,632,138,168675,0x6B175474E89094C44Da98b954EedeAC495271d0F,0x4E5B2e1dc63F6b91cb6Cd759936495434C7e972F
1120,15627840,92151,8000000000,92087,64,10,31,0x4Dbd4fc535Ac27206064B68FfCf827b0A60BAB3f,0xA04a58dC365E5c088e8212fEdDC1470d8003BcE7
1121,15627840,84354,8000000000,84150,204,74,91,0x9b9D659D4f2cF68b6616Cc0a65683f1951Eb725C,0xAE37C4C57854f7aC6D054D64fb2226bD7fFfaa2C
1122,15627840,84354,8000000000,84150,204,74,95,0x9b9D659D4f2cF68b6616Cc0a65683f1951Eb725C,0x37407CdCF792aAc00397e39cedC0262368F4A2b5
1123,15627840,84354,8000000000,84150,204,74,94,0x9b9D659D4f2cF68b6616Cc0a65683f1951Eb725C,0x838d8B141d3E14E4746D91f7bfB610Ab22B50317
1124,15627840,250000,7857731690,250000,0,2,45337032,0x7CDE12F947A992659E622CE0A50Ae8ff9BeC158a,0xEA674fdDe714fd979de3EdF0F56AA9716B898ec8
1125,15627840,250000,7857731690,250000,0,2,45337033,0xB5Ff69260f7533eaC1a3CCa541bC09126F65d0C7,0xEA674fdDe714fd979de3EdF0F56AA9716B898ec8
1126,15627840,250000,7857731690,250000,0,2,45337034,0xc05127901a2e129f9bb20eF76Fdd5645d5479aC6,0xEA674fdDe714fd979de3EdF0F56AA9716B898ec8
1127,15627840,181476,7857731690,179912,1564,394,2392,0x1Fa8559e873f698292766790AeCf8080A66433F6,0xe1e2E153e785118Fa7b50e93e6b8cf887F025Bc7
1128,15627840,250000,7857731690,250000,0,2,45337035,0xdf88C71Bd6E696F074E7F73aB077092A75733A2C,0xEA674fdDe714fd979de3EdF0F56AA9716B898ec8
1129,15627840,200000,7857731690,199428,572,138,248,0x8B69ec87c5059991C1A863bd988D055aF32FF72e,0x148ef557738B8BC51bD19Ee1365d9D04BD46ab04
1130,15627840,250000,7857731690,250000,0,2,45337036,0xD86aA23b23c294Cf05665D8adf0831C3bb93C3Ad,0xEA674fdDe714fd979de3EdF0F56AA9716B898ec8
1131,15627840,250000,7857731690,250000,0,2,45337037,0xc135332D950d92Ce6cb0586F17ee06C3ce3E3712,0xEA674fdDe714fd979de3EdF0F56AA9716B898ec8
1132,15627840,250000,7857731690,250000,0,2,45337038,0xE5c3D0A82158f795C62076906dFc65427a153193,0xEA674fdDe714fd979de3EdF0F56AA9716B898ec8
1133,15627840,250000,7857731690,250000,0,2,45337039,0x86961116bA4a79f9749CAe4604d94D08Ab3dD7a5,0xEA674fdDe714fd979de3EdF0F56AA9716B898ec8
1134,15627840,250000,7857731690,250000,0,2,45337040,0x60453cc1faEf5f8c7b872e7b2ddc5A392d464557,0xEA674fdDe714fd979de3EdF0F56AA9716B898ec8
1135,15627840,250000,7857731690,250000,0,2,45337041,0xC14465346e9b7c0EDce2C7cac82661ABb63Cf893,0xEA674fdDe714fd979de3EdF0F56AA9716B898ec8
1136,15627840,58143,7857731690,56307,1836,458,30,0x4976fb03C32e5B8cfe2b6cCB31c09Ba78EBaBa41,0x061F16fA27e2E76179F01fB5810526C9b08d21b2
1137,15627840,175110,7857731690,173546,1564,394,90,0x1Fa8559e873f698292766790AeCf8080A66433F6,0x6b54a8Ecb8a823A6Bd3Fc9A3D7e1292bfA32369D
1138,15627840,248727,7857731690,248663,64,10,26,0x84927e55Ed03EA00732F17FdAA89f482AD12c005,0xBeD84af8cC672cE154dC1f5A7255771Dbb15Ec46
1139,15627840,128709,7839817430,128065,644,138,540,0xD0Cd466b34A24fcB2f87676278AF2005Ca8A78c4,0xAF293854c232c3DE882D6D15217a83c2ae83D46b
1140,15627840,163818,7839817430,157230,6588,1802,470,0x00000000006c3852cbEf3e08E8dF289169EdE581,0x223063C26d94f8692e979144538Fbbfd1E6da304
1141,15627840,149445,7795076465,145365,4080,914,41,0x1111111254fb6c44bAC0beD2854e76F90643097d,0x64974Bcdb6e3ccA6035804D80550Bc7DFbDc6CfE
1142,15627840,117738,7392023158,117534,204,74,4,0x7F9306FC1978938d5C1C57Bf6044dc67E07eeB8a,0x5D2a22896Ab8D4F3A623D7C51a38C339e037F162
1143,15627840,77824,7392023158,77168,656,138,6,0x95aD61b0a150d79219dCF64E1E6Cc01f0B64C4cE,0x30863e7DC04eDDB2F69ab9d39cDfc525e2878483
1144,15627840,182565,7365527809,181165,1400,402,8,0x1111111254fb6c44bAC0beD2854e76F90643097d,0x40fC24Da69AA37268c87F6c076F0b0a3917B6304
1145,15627840,223618,7316900000,220846,2772,842,33,0x68b3465833fb72A70ecDF485E0e4C7bD8665Fc45,0xcEA2B5aaE34Dbd6932fD266FdF490b2aC70fd96C
1146,15627840,105000,7316855726,105000,0,2,138554,0xc919cC63a66e099a9E40cC10d2A65560E1bC7aD5,0x974CaA59e49682CdA0AD2bbe82983419A2ECC400
1147,15627840,600000,7316855726,599392,608,138,138555,0xdAC17F958D2ee523a2206206994597C13D831ec7,0x974CaA59e49682CdA0AD2bbe82983419A2ECC400
1148,15627840,105000,7316855726,105000,0,2,138556,0xe020feDFa1757C35c61a1925700f18d5Fe8aC45e,0x974CaA59e49682CdA0AD2bbe82983419A2ECC400
1149,15627840,191275,7316855726,190243,1032,266,411,0xd588b586D61C826A0e87919b3D1a239206d58bf2,0xd7188770a2962C73CCBc8A451455a29bD38FD965
1150,15627840,105000,7316855726,105000,0,2,138557,0xe9292fa198778331496E114Be2B906a2D179DcB2,0x974CaA59e49682CdA0AD2bbe82983419A2ECC400
1151,15627840,205686,7316855726,203862,1824,458,578,0xEfF92A263d31888d860bD50809A8D171709b7b1c,0x58907c67d8F0aaE8A98cE84Ae8484AF7648704Bc
1152,15627840,21000,7257731690,21000,0,2,263286,0x3e836e3a55692C1dAf0392d79A2358E27aE4Af1e,0x9C19B0497997Fe9E75862688a295168070456951
1153,15627840,21000,7100000000,21000,0,2,28486,0x7A652c36e23c522B5492Db102ED23DDb58720ea0,0x5d807e7F124EC2103a59c5249187f772c0b8D6b2
1154,15627840,1000000,7071731690,998276,1724,330,109716,0x2796317b0fF8538F253012862c06787Adfb8cEb6,0x230A1AC45690B9Ae1176389434610B9526d2f21b
1155,15627840,78625,7054148838,77025,1600,394,53,0x495f947276749Ce646f68AC8c248420045cb7b5e,0x01Bf514344dD25906E3F001e98dBE1f52391b721
1156,15627840,165970,7054148838,164390,1580,402,48,0x1111111254fb6c44bAC0beD2854e76F90643097d,0xCD8F79C321807C14827e2f1D6F86Ff08c82c5fA0
1157,15627840,191077,7000000000,190177,900,266,827,0xd588b586D61C826A0e87919b3D1a239206d58bf2,0x18772056026D50300ad9A23e153d20409abFd827
1158,15627840,191077,7000000000,190177,900,266,828,0xd588b586D61C826A0e87919b3D1a239206d58bf2,0x18772056026D50300ad9A23e153d20409abFd827
1159,15627840,191077,7000000000,190177,900,266,829,0xd588b586D61C826A0e87919b3D1a239206d58bf2,0x18772056026D50300ad9A23e153d20409abFd827
1160,15627840,191077,7000000000,190177,900,266,830,0xd588b586D61C826A0e87919b3D1a239206d58bf2,0x18772056026D50300ad9A23e153d20409abFd827
1161,15627840,70000,6918806162,69380,620,138,122,0xdAC17F958D2ee523a2206206994597C13D831ec7,0xe40E243ee0D5C3A5D814925e454148463d408Df2
1162,15627840,142078,6894931648,137426,4652,1290,0,0x20F780A973856B93f63670377900C1d2a50a77c4,0x1AB0fa572F8a5268F443c536Bc322954877aCCBa
1163,15627840,122512,6876058557,121264,1248,458,289,0x4e32004D8b81847A670b4a1778ACe4dCF2bBA01E,0x42f678DBE97bF17c7a75d6Df81C62DA45a29c110
1164,15627840,192421,6876058557,185833,6588,1802,707,0x00000000006c3852cbEf3e08E8dF289169EdE581,0x871a185222966B2dDE7c811117431A32Ad3d166F
1165,15627840,329032,6876058557,324688,4344,1034,13,0x197492CCB4B1acaAAcd43432657A17832E36AB49,0xba43776ed93B647C9FD2070B745acBBdFDC3250D
1166,15627841,173736,323492142110,172376,1360,190,2295,0x9507c04B10486547584C37bCBd931B2a4FeE9A41,0x10045CF950fd303847010DFBFf57Eb1a6D978Ee1
1167,15627841,800000,200000000000,796952,3048,650,4,0x7a250d5630B4cF539739dF2C5dAcb4c659F2488D,0xFE4E1E81081d7A351C3617626476cE571d10764E
1168,15627841,175647,62800342146,174359,1288,190,5409,0x9507c04B10486547584C37bCBd931B2a4FeE9A41,0x800AD322aa10ce8de372B2b5e1F05f6180c70b04
1169,15627841,257602,55444175144,255342,2260,586,12236,0xBEEFBaBEeA323F07c59926295205d3b7a17E8638,0x74678B900d450bd0e5FaEa87dba8d49C77c79527
1170,15627841,279924,55023475090,277668,2256,650,122587,0xA69babEF1cA67A37Ffaf7a485DfFF3382056e78C,0x1c8F6A5F009E051CaB9C3851ca2DA2c936b2775A
1171,15627841,253138,52832294898,253138,0,2,119826,0xeCa2e2D894D19778939bD4DfC34D2a3C45E96456,0xeCa2e2D894D19778939bD4DfC34D2a3C45E96456
1172,15627841,298242,52690859286,298242,0,2,111039,0x36a454aEF52938c8637CD4689B2980C1Cfd43389,0x36a454aEF52938c8637CD4689B2980C1Cfd43389
1173,15627841,223072,48867491540,221768,1304,264,12059,0xBEEFBaBEeA323F07c59926295205d3b7a17E8638,0xb0305E86B143fe018663a5cE6a3781FfCcEcb719
1174,15627841,227606,48821308085,226522,1084,220,12017,0xBEEFBaBEeA323F07c59926295205d3b7a17E8638,0xb77168354546DcFE69511eD375F1E1259CDd4DcA
1175,15627841,305634,6771282210,303534,2100,650,44523,0x5050e08626c499411B5D0E0b5AF0E83d3fD82EDF,0xe9F82f15910E161999777036e20CB4108F4Df800
1176,15627841,270873,37771282210,268933,1940,522,16,0x7a250d5630B4cF539739dF2C5dAcb4c659F2488D,0x76B7e3b26DcEc9c447193bE3073a260a4A9e2B7B
1177,15627841,21000,30844417031,21000,0,2,126773,0x3fCcc08A250a1c2e37cC4d6D2B22c7f0b7B132Ff,0x87cbc48075d7aa1760Ac71C41e8Bc289b6A31F56
1178,15627841,244533,26000000000,242697,1836,458,655,0x25553828F22bDD19a20e4F12F052903Cb474a335,0x00B81C48d7820d1AC0668eFc77a336811516463c
1179,15627841,276962,25420348586,276962,0,2,111457,0x065e3DbaFCb2C26A978720f9eB4Bce6aD9D644a1,0x065e3DbaFCb2C26A978720f9eB4Bce6aD9D644a1
1180,15627841,21014,25386487381,21014,0,2,134152,0x8e8f818d3371F797A2Db7eDB32803607c8b3c6A9,0x8e8f818d3371F797A2Db7eDB32803607c8b3c6A9
1181,15627841,90000,25000000000,90000,0,2,104416,0x1ABF5512744a9B8165364887bD7E5f53a5A6d0b5,0x83cc754DDA833a93f1c7d4e1566B4785C27522d4
1182,15627841,521689,23000000000,519737,1952,522,7237,0x7a250d5630B4cF539739dF2C5dAcb4c659F2488D,0x7a83e700F385233C644c30a4eCb029183AC53C47
1183,15627841,521689,23000000000,519725,1964,522,3142,0x7a250d5630B4cF539739dF2C5dAcb4c659F2488D,0x449475a8555B535aBa72f17878C4fF58823f8Ab8
1184,15627841,297245,22289083560,295605,1640,336,10945,0xe2b8Eb988735f7709D08B7d07B41460073904830,0x7Dacfce9EAcdCA48CaD5Ba0b61560586c375890B
1185,15627841,21000,18200000000,21000,0,2,0,0x808733de3d46d4167cFFe372975fe3b6e0522e8F,0xC1105641d5ddaCD4ef4b91d8431389fe9c7C619C
1186,15627841,302558,17240956739,300290,2268,650,116837,0xA69babEF1cA67A37Ffaf7a485DfFF3382056e78C,0x6046945C5B5eF5933b8E73a98A6AD7bF3e031df7
1187,15627841,5049304,17000000000,5042216,7088,1098,275,0x0a39DA505DfB5E0BBc6bd84428281A8ba1bC7753,0x495E889d1A6cEB447a57dcc1C68410299392380c
1188,15627841,21000,15000000000,21000,0,2,7971,0x7F424Dd46760a4Da4026135D20221aA59f2755bd,0x4F0326D14097DF72B0D46F75f05798515c7820cd
1189,15627841,261066,14525857108,258066,3000,842,81000,0x4A137FD5e7a256eF08A7De531A17D0BE0cc7B6b6,0x0087C5900B9Bbc051B5F6299f5bCE92383273B28
1190,15627841,336354,14142135553,335290,1064,180,2262,0x9507c04B10486547584C37bCBd931B2a4FeE9A41,0xd2c5b711E50c592A46f96C6e76E714178FD9AD89
1191,15627841,289304,13692591690,287444,1860,458,3389,0x7a250d5630B4cF539739dF2C5dAcb4c659F2488D,0x2f2648328497A95aB21fB3E3ce5039F271686F36
1192,15627841,21000,13561155527,21000,0,2,1,0xC098B2a3Aa256D2140208C3de6543aAEf5cd3A94,0xc57cbEfe25ee1D2A141C3514bF6229aF42e3c996
1193,15627841,100000,12188771887,99404,596,138,0,0xdAC17F958D2ee523a2206206994597C13D831ec7,0x3be57329D2DaB345Ec60C7772C4a8ED389c48494
1194,15627841,21000,12041379218,21000,0,2,132644,0x01Ed2b67638f7a0d053Db3A041495Ffe6546E837,0x63A395B574D5E23C3dbC6986Be5994Ef6743aFA8
1195,15627841,72042,12041379218,71446,596,138,1,0xdAC17F958D2ee523a2206206994597C13D831ec7,0xA3cf1550b3ba03e5166fa3300eD4022837cCfc29
1196,15627841,21000,12024879396,21000,0,2,118,0x25eAff5B179f209Cf186B1cdCbFa463A69Df4C45,0x3FbB8e4807f79c11e9F57221f253FF395A013240
1197,15627841,21000,12024879396,21000,0,2,2,0x25eAff5B179f209Cf186B1cdCbFa463A69Df4C45,0xFb38b2C8ED3f82Bd7c6D4d9D604e2ccD623aF354
1198,15627841,222222,12000000000,220658,1564,394,605,0x1Fa8559e873f698292766790AeCf8080A66433F6,0x72E2b5633F2A409CA6A154120dEB32f4320469fB
1199,15627841,21000,11641509783,21000,0,2,16,0xCBD6832Ebc203e49E2B771897067fce3c58575ac,0x381B317Df5c8b8D2A454e72167FCA29aF43436aE
1200,15627841,21000,11539544664,21000,0,2,38,0xCBD6832Ebc203e49E2B771897067fce3c58575ac,0x940833a51Fa35DF3369D2Be3594561dd9BF16623
1201,15627841,60000,11044024483,57056,2944,586,2,0x52dE8D3fEbd3a06d3c627f59D56e6892B80DCf12,0xe132e4618e501C40cFc22f6A7580b8a00187c359
1202,15627841,191041,11000000000,190165,876,266,1385,0xd588b586D61C826A0e87919b3D1a239206d58bf2,0xC22d03e13B888Dabb33A1575e4F6542f0e996622
1203,15627841,297680,10953906472,296412,1268,264,11945,0xBEEFBaBEeA323F07c59926295205d3b7a17E8638,0x1B57262A312E75f62Ac0D72005F2C721b734cBD2
1204,15627841,178757,10771282210,177233,1524,230,5438,0x9507c04B10486547584C37bCBd931B2a4FeE9A41,0x75995F240e6EeE8E80CE5898Cdb3960da06AAa54
1205,15627841,410358,10771282210,404878,5480,1482,79,0x68b3465833fb72A70ecDF485E0e4C7bD8665Fc45,0x6db44a1B913B1Fb787Ee53Da3970CE7Fa0A8B7a4
1206,15627841,100000,10567800967,99392,608,138,181426,0x473037de59cf9484632f4A27B509CFE8d4a31404,0x6238872A0Bd9F0E19073695532a7Ed77ce93C69E
1207,15627841,100000,10567800967,99380,620,138,181427,0x473037de59cf9484632f4A27B509CFE8d4a31404,0x6238872A0Bd9F0E19073695532a7Ed77ce93C69E
1208,15627841,21000,10567800967,21000,0,2,181428,0xF627fFbD0597F34052D4D64d0f3BE4De8Fb85c08,0x6238872A0Bd9F0E19073695532a7Ed77ce93C69E
1209,15627841,73330,10507710373,72722,608,138,355144,0xdAC17F958D2ee523a2206206994597C13D831ec7,0x7abE0cE388281d2aCF297Cb089caef3819b13448
1210,15627841,97395,10492162650,96787,608,138,4709900,0xA0b86991c6218b36c1d19D4a2e9Eb0cE3606eB48,0x2FAF487A4414Fe77e2327F0bf4AE2a264a776AD2
1211,15627841,76676,10492162650,75732,944,138,0,0xdAC17F958D2ee523a2206206994597C13D831ec7,0x071FC8027a605A4F6607BE1a48D4F9E651497c98
1212,15627841,76221,10492162650,75233,988,202,4709901,0xdAC17F958D2ee523a2206206994597C13D831ec7,0x2FAF487A4414Fe77e2327F0bf4AE2a264a776AD2
1213,15627841,76381,10492162650,75437,944,138,0,0x3506424F91fD33084466F402d5D97f05F8e3b4AF,0xd5D8B2376Ae7224cD8D756f830d1DC03C57080A0
1214,15627841,84290,10492162650,83302,988,202,4709902,0xA0b86991c6218b36c1d19D4a2e9Eb0cE3606eB48,0x2FAF487A4414Fe77e2327F0bf4AE2a264a776AD2
1215,15627841,90912,10486703662,89968,944,138,0,0xA0b86991c6218b36c1d19D4a2e9Eb0cE3606eB48,0x6e76Bb3C710298022eD92687EFC867FF051b4D17
1216,15627841,76207,10486703662,75231,976,202,355145,0xdAC17F958D2ee523a2206206994597C13D831ec7,0x7abE0cE388281d2aCF297Cb089caef3819b13448
1217,15627841,333444,10189553755,331260,2184,650,106621,0xA69babEF1cA67A37Ffaf7a485DfFF3382056e78C,0x9AAb3F81604c683a1a0D14019FBfe15bef7aA1ee
1218,15627841,100000,10000000000,99036,964,202,705864,0xdAC17F958D2ee523a2206206994597C13D831ec7,0x6dfc34609a05bC22319fA4Cce1d1E2929548c0D7
1219,15627841,90000,9967699358,90000,0,2,784402,0x5F278C6FEA190Aa1a714D35843C5D4aD043bd544,0xcaD621da75a66c7A8f4FF86D30A2bF981Bfc8FdD
1220,15627841,90000,9967699358,90000,0,2,784403,0x2E62474da7FAd6423eb44B5AAE94a3d68Ca7A9d4,0xcaD621da75a66c7A8f4FF86D30A2bF981Bfc8FdD
1221,15627841,100000,9967699358,99380,620,138,1050379,0xA0b86991c6218b36c1d19D4a2e9Eb0cE3606eB48,0xf16E9B0D03470827A95CDfd0Cb8a8A3b46969B91
1222,15627841,21000,9820000000,21000,0,2,0,0x6dfc34609a05bC22319fA4Cce1d1E2929548c0D7,0xD4e682D103B0bF1935cFe847cf556D3E54165750
1223,15627841,21000,9820000000,21000,0,2,0,0x6dfc34609a05bC22319fA4Cce1d1E2929548c0D7,0x402cb04f489c0383bF300c50D9c044b073f5159f
1224,15627841,21000,9771282210,21000,0,2,5607,0x3F041d4d6D16A4c1bF81648F29c9C4752AFE0666,0x2Cc3941D7E7a3Fa5d55D75b25748e497e4F83C46
1225,15627841,21000,9771282210,21000,0,2,5608,0x66B85D8501892a7d9DBC8431304220928E73155A,0x2Cc3941D7E7a3Fa5d55D75b25748e497e4F83C46
1226,15627841,103832,9771282210,103628,204,74,191,0x7F9306FC1978938d5C1C57Bf6044dc67E07eeB8a,0xE536FfBacbB00b6358dDAFC82603074a9a869d0f
1227,15627841,21000,9600000000,21000,0,2,16,0x34c2Cd3A76988101c965ec9301f94B8abAE1700f,0xE928E6ced34Df4e749F2ea3dd79AF62f7389b8a1
1228,15627841,21000,9540226871,21000,0,2,4,0x8B9E822704b92F0D1f6895B14Aacb4B20388d14E,0x5e3Bd6d716E3b820eEC568b730b1ee2814053787
1229,15627841,500000,9350154522,497676,2324,714,8305,0x3f9Bc3B2E2ded7b096D50da562D4F21bBACfe8BA,0x49C528eDDa912BD2a1853FB831fC0bcCb2f14421
1230,15627841,21000,9273282210,21000,0,2,12,0x5770815B0c2a09A43C9E5AEcb7e2f3886075B605,0x623aed619D9611532aF58e0C5b24B3900636781f
1231,15627841,21000,9273282210,21000,0,2,195476,0xFB8373A0FC3Eeaa30F2866DF2E70987e4424A41A,0xB287eaC48aB21c5FB1d3723830d60b4c797555B0
1232,15627841,217045,9271282210,214081,2964,650,82,0x6a0846a80A2bded21D2a4f30479691B3bC090caA,0xA862F4916645D77Ce96D1EB1aC03F89f0064762c
1233,15627841,21000,9271282210,21000,0,2,67394,0x1c0cf501DfD39e8d380A942E90F8838E3A7da26A,0x963737C550E70FFe4D59464542a28604eDb2eF9a
1234,15627841,21000,9271282210,21000,0,2,2889,0xD464048df6fDbC96C1A3a8787FcCEDfc9c5BD8bA,0xD80f0D03579D1CAe085ba34c3e909c33E710a52d
1235,15627841,146784,9271282210,146580,204,74,28,0x7F9306FC1978938d5C1C57Bf6044dc67E07eeB8a,0xd5725a11E34a786D79a244FaE9AFD276BD2334dc
1236,15627841,143796,9271282210,143592,204,74,58,0x7F9306FC1978938d5C1C57Bf6044dc67E07eeB8a,0xc97b32D413Bdf3039B7293c3246CC8FdcB864BcB
1237,15627841,155748,9271282210,155544,204,74,185,0x7F9306FC1978938d5C1C57Bf6044dc67E07eeB8a,0x32d9E641035dF1129A37F6fA1d6962C62AF2e20d
1238,15627841,200540,9271282210,198500,2040,650,607,0x2B2e8cDA09bBA9660dCA5cB6233787738Ad68329,0x1e799C0EA1504D3d93f6777Eca479335d8D5d636
1239,15627841,330490,9271282210,327794,2696,714,39,0x86ca49D37015a8541642B1B5A90Af0115eC61994,0xbC44a5f0B5849f423e0cAB308472610159654E4B
1240,15627841,48792,9000000000,48184,608,138,11,0xA0b86991c6218b36c1d19D4a2e9Eb0cE3606eB48,0x00A6426e17279926FF37E72B8F735d0C57d2c3dd
1241,15627841,55854,8821282210,54910,944,138,9,0x3845badAde8e6dFF049820680d1F14bD3903a5d0,0x2daA1FCF5b4553b8B50F82C1468b78282eb3F598
1242,15627841,21000,8810000000,21000,0,2,0,0x6dfc34609a05bC22319fA4Cce1d1E2929548c0D7,0xE5D5CDD72B173EAF33D76CEF54c6Ef2Df9Dd1ED2
1243,15627841,124624,8771282210,124420,204,74,703,0x7F9306FC1978938d5C1C57Bf6044dc67E07eeB8a,0x09DDfF305d65F019c4611fbDF57DE848F8102E4c
1244,15627841,124624,8771282210,124420,204,74,121,0x7F9306FC1978938d5C1C57Bf6044dc67E07eeB8a,0x027425D941EE947B66adEC81763ABF99Da9A6A9F
1245,15627841,124624,8771282210,124420,204,74,227,0x7F9306FC1978938d5C1C57Bf6044dc67E07eeB8a,0xB8546dc9dBA305e6136899d4783CDe2efCf5F35A
1246,15627841,124624,8771282210,124420,204,74,187,0x7F9306FC1978938d5C1C57Bf6044dc67E07eeB8a,0x86A4BBeA92F18A564e609f4Dd379eed4bEc00037
1247,15627841,124624,8771282210,124420,204,74,993,0x7F9306FC1978938d5C1C57Bf6044dc67E07eeB8a,0xb4b6cB2789BAD42A9907493068996c358e1E5e0e
1248,15627841,124624,8771282210,124420,204,74,82,0x7F9306FC1978938d5C1C57Bf6044dc67E07eeB8a,0xD4516cF36e27C89d3bDCa98E6F7319E6ebed3D49
1249,15627841,124624,8771282210,124420,204,74,73,0x7F9306FC1978938d5C1C57Bf6044dc67E07eeB8a,0x72679F3c7E55F8d31CFeBc2ab532e6D041B58AC6
1250,15627841,124624,8771282210,124420,204,74,419,0x7F9306FC1978938d5C1C57Bf6044dc67E07eeB8a,0xf8A329bCe2A0085e01e410ed4981a9C1aF11fAA6
1251,15627841,181476,8771282210,179912,1564,394,334,0x1Fa8559e873f698292766790AeCf8080A66433F6,0xaFcbf95c1432220F344dD86bb3557a84f483e138
1252,15627841,124624,8771282210,124420,204,74,371,0x7F9306FC1978938d5C1C57Bf6044dc67E07eeB8a,0x67c8dAD0265cb5EC9D85A6Ae118016b42E75b442
1253,15627841,124624,8771282210,124420,204,74,354,0x7F9306FC1978938d5C1C57Bf6044dc67E07eeB8a,0xDd3811D3688f1675323BBbD7d2F256F121D40065
1254,15627841,124624,8771282210,124420,204,74,403,0x7F9306FC1978938d5C1C57Bf6044dc67E07eeB8a,0xc90c3a6F16b211C3Ad7711F1a04fd71d9340e9bF
1255,15627841,124624,8771282210,124420,204,74,431,0x7F9306FC1978938d5C1C57Bf6044dc67E07eeB8a,0xbec0F91113ecB2e58eD38204Fba8796E70F2B4b4
1256,15627841,124624,8771282210,124420,204,74,374,0x7F9306FC1978938d5C1C57Bf6044dc67E07eeB8a,0x1900516b55133db14B8cE5ef0F85F9eD26F8dA19
1257,15627841,124624,8771282210,124420,204,74,442,0x7F9306FC1978938d5C1C57Bf6044dc67E07eeB8a,0x18512898c791334313d6DbE44CDea21ea021027d
1258,15627841,124624,8771282210,124420,204,74,454,0x7F9306FC1978938d5C1C57Bf6044dc67E07eeB8a,0xc01542Eb312f7A817EFE7f40C2E94fCf1a519452
1259,15627841,124624,8771282210,124420,204,74,139,0x7F9306FC1978938d5C1C57Bf6044dc67E07eeB8a,0x1F8F63B02C2aC1c8d740C1dfDA7eF38B836198B0
1260,15627841,124624,8771282210,124420,204,74,369,0x7F9306FC1978938d5C1C57Bf6044dc67E07eeB8a,0x92f119Ec92B2b671fc13A4CB205d8ec11Bad45f6
1261,15627841,124624,8771282210,124420,204,74,136,0x7F9306FC1978938d5C1C57Bf6044dc67E07eeB8a,0x83b4ECA752452d3bA87a085BA1c4f4a6edA736c1
1262,15627841,124624,8771282210,124420,204,74,140,0x7F9306FC1978938d5C1C57Bf6044dc67E07eeB8a,0xdB2b4bae2c26Ac0d24B36b42220826E57a75FE51
1263,15627841,124624,8771282210,124420,204,74,134,0x7F9306FC1978938d5C1C57Bf6044dc67E07eeB8a,0xCC10bCF3e6FF56F7CedEACaF05734EeD136d24A1
1264,15627841,124624,8771282210,124420,204,74,132,0x7F9306FC1978938d5C1C57Bf6044dc67E07eeB8a,0x23eA9062eb0201Ed82E080D6b037e2D8a40bC0C3
1265,15627841,124624,8771282210,124420,204,74,137,0x7F9306FC1978938d5C1C57Bf6044dc67E07eeB8a,0xE35325A84D56729b6A2166fFBdF44669F6127640
1266,15627841,124624,8771282210,124420,204,74,128,0x7F9306FC1978938d5C1C57Bf6044dc67E07eeB8a,0xC42724C5253773A626Ab15a4E800FbD50B2fC939
1267,15627841,124624,8771282210,124420,204,74,143,0x7F9306FC1978938d5C1C57Bf6044dc67E07eeB8a,0x11dDd2eB0bD45c373AA19940964882FA516263Ba
1268,15627841,124624,8771282210,124420,204,74,145,0x7F9306FC1978938d5C1C57Bf6044dc67E07eeB8a,0xabe1aA61c0aDe6A826DE6e55F3869D1502A2e5CB
1269,15627841,124624,8771282210,124420,204,74,141,0x7F9306FC1978938d5C1C57Bf6044dc67E07eeB8a,0x502ca494f14bAd99f320a1A9bb68D0761B0cd22F
1270,15627841,21000,8771282210,21000,0,2,6,0x265B4A8fC4738b31d81B28C7904EF4594CF04751,0x66056e5CA0f2F1d0512871c01AF5baF2F264a5aa
1271,15627841,21000,8771282210,21000,0,2,72339,0x134E5788ABa7DE10BA531500794D4703D9B4386A,0xab97925eB84fe0260779F58B7cb08d77dcB1ee2B
1272,15627841,227189,8771282210,215193,11996,2826,505,0x1A90B3Dead0113740266b7F7Ea1136e8ED1b48C5,0x62Ef8b356751612Ad33863c454825BF94998AF2E
1273,15627841,143796,8771282210,143592,204,74,13,0x7F9306FC1978938d5C1C57Bf6044dc67E07eeB8a,0xF017F8573705D5f230707934FcaC79532ADEF072
1274,15627841,111031,8771282210,110459,572,138,13794,0xFf8bf98d2F7AD3bBF454B4a73B9B4E898230bD10,0xdAb1a1854214684acE522439684a145E62505233
1275,15627841,49542,8771282210,49478,64,10,836,0xC02aaA39b223FE8D0A0e5C4F27eAD9083C756Cc2,0x35fD1a27e82962C9E9e59E40bdd3cAd527079f0f
1276,15627841,245943,8771282210,242291,3652,1162,901,0x68b3465833fb72A70ecDF485E0e4C7bD8665Fc45,0x1aa4bf5728Cd3a415D9aEcea807C1292d1C96f1C
1277,15627841,55951,8771282210,55007,944,138,69,0xeE3FC268418f54cFEb7817cc52C642489A5DF098,0x275b926d2448663b5C5C88976529378b56D6cF47
1278,15627841,500000,8771282210,499344,656,138,166338,0x514910771AF9Ca656af840dff83E8264EcF986CA,0xc6bed363b30DF7F35b601a5547fE56cd31Ec63DA
1279,15627841,269594,8771282210,266762,2832,842,248,0x68b3465833fb72A70ecDF485E0e4C7bD8665Fc45,0xF9B811DfD49c67D1B1cb488A808E7dB1Cb32B4E2
1280,15627841,42000,8771282210,42000,0,2,329513,0x0220FB53Ed047E1dbe851294e67278ddD377d0fc,0x9430801EBAf509Ad49202aaBC5F5Bc6fd8A3dAf8
1281,15627841,240543,8771282210,237795,2748,842,1968,0x68b3465833fb72A70ecDF485E0e4C7bD8665Fc45,0x947c8b3deb1014774850Aa8864f8Fc568CcdB3af
1282,15627841,244726,8771282210,240482,4244,1098,1,0xe66B31678d6C16E9ebf358268a790B763C133750,0xD0bAba19e41dD1363050307B1b7fDFC3334B9b6F
1283,15627841,135539,8771282210,128835,6704,1698,4507,0x00000000006c3852cbEf3e08E8dF289169EdE581,0x5F6D3d4F90aB31064E90046745F72E89eB38FF79
1284,15627841,63418,8771282210,62786,632,138,187,0x8B3192f5eEBD8579568A2Ed41E6FEB402f93f73F,0xCEc502288c6244aC5FA2d45e6cc7a342893acf13
1285,15627841,264974,8771282210,259862,5112,1484,319,0x881D40237659C251811CEC9c364ef91dC08D300C,0x452B03D3f07BEf1e413228837cD63B77C921018D
1286,15627841,70000,8771282210,69392,608,138,519,0xdAC17F958D2ee523a2206206994597C13D831ec7,0xf5491f793D47A6Ea22f5e0B9AD3990CF66c4b40B
1287,15627841,161578,8771282210,154990,6588,1802,1283,0x00000000006c3852cbEf3e08E8dF289169EdE581,0x4a9c2b7204570C8272Ea72933176D4D591B08424
1288,15627841,225902,8771282210,223794,2108,522,4,0xEfF92A263d31888d860bD50809A8D171709b7b1c,0xbc35Db3730D05e5E96710Cf710fBb9010f6658e5
1289,15627841,21000,8460000000,21000,0,2,34,0x292f04a44506c2fd49Bac032E1ca148C35A478c8,0x42525B10C8472a5446021A2222465180A21aBACa
1290,15627841,565782,8381282210,553962,11820,3914,288,0xDEF171Fe48CF0115B1d80b88dc8eAB59176FEe57,0x17D065070486Ca0fC8b4B382b946BE79Fb4fF10D
1291,15627841,21000,8272282210,21000,0,2,57298,0x7D4D5Db8d5Ef675fF2865bA9fB060A4Bbb679F5c,0xCfC0F98f30742B6d880f90155d4EbB885e55aB33
1292,15627841,290290,8271282210,287894,2396,522,579,0x283Af0B28c62C092C9727F1Ee09c02CA627EB7F5,0x0db7b27b7A3Ea8035D3F66F3ba7532221eF06abE
1293,15627841,195966,8271282210,187934,8032,2122,283,0x00000000006c3852cbEf3e08E8dF289169EdE581,0x0e8d6fa80544566470b80cE24FD6B17801229009
1294,15627841,21000,8271282210,21000,0,2,17,0xB0A574160A8477Ac403E855292cdB356f990C179,0xF340Eb34ABD1dAD2B4377c0223cA955Fa23A2445
1295,15627841,1000000,8271282210,999404,596,138,4121128,0x467719aD09025FcC6cF6F8311755809d45a5E5f3,0x0D0707963952f2fBA59dD06f2b425ace40b492Fe
1296,15627841,50719,8271282210,50111,608,138,330,0xdAC17F958D2ee523a2206206994597C13D831ec7,0x39720BE11DA41f0b0BF37a3cC918B5D89a949cE9
1297,15627841,46616,8271282210,46128,488,138,680,0xcF3B19C229922B09196d24c4473F03a00549fc8B,0x37eE385451267FAd11D007d6028D78dA61Af4C29
1298,15627841,21000,8271282210,21000,0,2,77,0x5E6242063850e14693eb6b8dad9BEEe9cB7952cD,0x2D44A2551dD400f2719A22575e7d0718a5816EcE
1299,15627841,150135,8271282210,143571,6564,1802,437,0x00000000006c3852cbEf3e08E8dF289169EdE581,0x5bb3D5e0c3992354307f48D4c31F8abC933FABb9
1300,15627841,188378,8271282210,185558,2820,842,10,0x68b3465833fb72A70ecDF485E0e4C7bD8665Fc45,0x1f88524B599d7B6c2cE92394933f081FC362a071
1301,15627841,307299,8271282210,303971,3328,970,3,0x68b3465833fb72A70ecDF485E0e4C7bD8665Fc45,0x7Cd5E31875A0F3D96D01A8bcDD074844593C2434
1302,15627841,246416,8271282210,243596,2820,842,1077,0x68b3465833fb72A70ecDF485E0e4C7bD8665Fc45,0xC4C80f9917a537a41b27825E4B55c6bd4A5b4b95
1303,15627841,51651,8271282210,51047,604,202,40,0x084b1c3C81545d370f3634392De611CaaBFf8148,0x05E254cD48778b37001fa982441a557682E113f2
1304,15627841,353514,8271282210,351310,2204,906,635,0xDd49A93FDcae579AE50B4b9923325e9e335ec82B,0x514E494c86F9249CfDc0e072f71f71a97cf33e65
1305,15627841,65147,8271282210,64195,952,202,13,0x5d95c4C73E152727750dF27ff7DA1C7169430dd6,0x36491ad4137C183810C328b6cc9956E4dc309E20
1306,15627841,21000,8271282210,21000,0,2,33,0x110C3047602385081132342Fa5bbE1cBb582F166,0x1F738d5E9db9fBFdbE6942F62B938A9D79Ee661d
1307,15627841,214382,8271282210,212534,1848,458,75,0x7a250d5630B4cF539739dF2C5dAcb4c659F2488D,0x82EEe77F98B8748D365dD2F18738f723Bb5cF309
1308,15627841,1000000,8271282210,999344,656,138,4121129,0x0E192d382a36De7011F795Acc4391Cd302003606,0x0D0707963952f2fBA59dD06f2b425ace40b492Fe
1309,15627841,318010,8271282210,307534,10476,3338,7,0x0000000000c2d145a2526bD8C716263bFeBe1A72,0x133dE21365966e1C2919f67Cd98122592cFc2DE1
1310,15627841,46267,8271282210,45691,576,74,278,0x283Af0B28c62C092C9727F1Ee09c02CA627EB7F5,0xA5Dc6d8522ba72eA8cC4d9Fc6e07EaBd21b4dF49
1311,15627841,213717,8271282210,210957,2760,842,66,0x68b3465833fb72A70ecDF485E0e4C7bD8665Fc45,0x4dd8B9829329a16A743ebf6fCD125f719D9ABF6C
1312,15627841,199952,8271282210,199052,900,266,1405,0xcDA72070E455bb31C7690a170224Ce43623d0B6f,0xeB10F919d15740e4D1a695FF2fF5A239850b351B
1313,15627841,62528,8271282210,60788,1740,266,43,0xcCbCa4F9651Ef122D58d7EC5acCa27D806840209,0xCEE4E58A05CB74cD553F3b3728Fc78f3C645085B
1314,15627841,202711,8271282210,199879,2832,842,1135,0x68b3465833fb72A70ecDF485E0e4C7bD8665Fc45,0x6d01af8711133DEE2B2edfC54DC6Ce38223f8396
1315,15627841,45897,8271282210,44953,944,138,176,0x57f1887a8BF19b14fC0dF6Fd9B2acc9Af147eA85,0x0Cd1Fc00237A73CF2888Ca564e64831770134aeF
1316,15627841,208186,8271282210,205018,3168,842,810,0x00000000009726632680FB29d3F7A9734E3010E2,0x2e67869829c734ac13723A138a952F7A8B56e774
1317,15627841,195248,8271282210,188636,6612,1802,6,0x00000000006c3852cbEf3e08E8dF289169EdE581,0x8B864EA84b4f6B2DBD2F3eB16Db5920071c823B7
1318,15627841,73036,8271282210,72092,944,138,8,0x45804880De22913dAFE09f4980848ECE6EcbAf78,0xD64592AaC64F558BCeC5B582F2379f7937cA2DC3
1319,15627841,49175,8271282210,48687,488,138,1406,0x7f738Ad7072187909384B2ffBaEEdC3C1DA1b686,0xCD0e0c8009D0933668dD36A32Ecc2EFE69eA9F8c
1320,15627841,55951,8271282210,55007,944,138,11,0x2a852CAe26caa790AAc006EAF86f17FD03fE555b,0x2556b534cb6F36F14C965229aC86320054Ad0b02
1321,15627841,289792,8271282210,287420,2372,522,294,0x283Af0B28c62C092C9727F1Ee09c02CA627EB7F5,0xBd3aE808d527a8d17531274A4a604eEd708f73Dd
1322,15627841,312205,8271282210,309089,3116,906,245,0x68b3465833fb72A70ecDF485E0e4C7bD8665Fc45,0xb9365cdf2eDeb28656e382F82d253B807D14ed2E
1323,15627841,286047,8271282210,271579,14468,4746,1260,0x83C8F28c26bF6aaca652Df1DbBE0e1b56F8baBa2,0x88827068bef89E95510e7d9F009Ac139A18D0dbd
1324,15627841,21000,8271282210,21000,0,2,109,0x677da4eD1AA5888A64016cc132E9d6aAdCF5237D,0xa4101E68783F138e7508Af1981019073230Eb055
1325,15627841,46267,8271282210,45691,576,74,7,0x283Af0B28c62C092C9727F1Ee09c02CA627EB7F5,0x409Eb9D78a4d5D6863947f2e5A7AD1E4f5b47C76
1326,15627841,40962,8271282210,40746,216,74,214,0x39ee2c7b3cb80254225884ca001F57118C8f21B6,0x7DBa349F416B24e67af85F96BfAd69CE6e060a79
1327,15627841,320172,8271282210,317128,3044,906,971,0x4e32004D8b81847A670b4a1778ACe4dCF2bBA01E,0x9D2FD63C49509E82C7ABE56D864dEABF41Ff4a1E
1328,15627841,150756,8271282210,150692,64,10,11,0x65c2e54a4c75ff6da7b6B32369c1677250075fb2,0x1F2A9c9Cf259262A4E4E7A41D2C029779E47246E
1329,15627841,117533,8271282210,117341,192,74,35,0xfc33E8b6E160A81DdB442B07355D01DF711EFEee,0xcca9695618c8cfA160aC4b469f2332BE9c89f510
1330,15627841,46088,8271282210,45600,488,138,21,0x5D004ddB5D92938dAF8448b9eac1CaA593cd26Ca,0xE379885d50e60e29089490876fea4CfAbFcB46b3
1331,15627841,21000,8271282210,21000,0,2,470,0x9D606D13846861008e921A3C161395FE1AE5a155,0x6D35B11621BC52BD328abe15178709C59369Afc7
1332,15627841,243390,8271282210,241554,1836,842,636,0xDd49A93FDcae579AE50B4b9923325e9e335ec82B,0x514E494c86F9249CfDc0e072f71f71a97cf33e65
1333,15627841,99226,8271282210,98630,596,138,11,0xA0b86991c6218b36c1d19D4a2e9Eb0cE3606eB48,0x4d8Bd8A9950022BFB52D5Cb1e9634043720418D3
1334,15627841,255525,8271282210,251885,3640,1162,487,0x68b3465833fb72A70ecDF485E0e4C7bD8665Fc45,0xf9e3b9153dDd7738740cF115b4Fc3d418BF1AcE7
1335,15627841,196246,8271282210,195878,368,138,237,0x8652168693827ff341f2ad5AD9a091f2A975710A,0x6c4b9296b1bE0617933bF7D9073a9e7bff2bCa7e
1336,15627841,73188,8271282210,72580,608,138,178,0xA0b86991c6218b36c1d19D4a2e9Eb0cE3606eB48,0xC2606254E1c3bD456B19650c9488F031823a8c77
1337,15627841,296045,8271282210,295397,648,266,122,0xcED3bE59Cfb246b83f18c48495DEA992D10f29E9,0x6BbEc209939727DaD223C9D1E3b24F327c7dcDCD
1338,15627841,93561,8271282210,92609,952,202,19,0x71772bEFF1FB348Eb7d5f9F1E0b5f11Bc49aB5e4,0xe0eB3A0d414C8785c3aB5C88b20b08dCfF4DF30F
1339,15627841,6292138,8271282210,6268058,24080,8970,307,0x000000000000509081d6FCD3ee63e791aD1db763,0x61D47f40D2D1fD08654CE3133688be88759846AC
1340,15627841,143060,8271282210,136424,6636,1802,5,0x00000000006c3852cbEf3e08E8dF289169EdE581,0xb5B7F1efd4D1344f7f6ea331EF34B93a6dde1F00
1341,15627841,192339,8271282210,192147,192,74,30,0x04556d845f12Ff7D8Ff04a37F40387Dd1B454c4b,0x1C2bEc615Ec89674e718b0966c686D5343EDc127
1342,15627841,365111,8271282210,336871,28240,3628,213,,0xEF45Ff55B1135a7270727F59050abFC950F0610c
1343,15627841,195950,8271282210,192662,3288,1034,79,0x68b3465833fb72A70ecDF485E0e4C7bD8665Fc45,0xA39EE27eDcc8De26f763EA9A7454f371FbAc058F
1344,15627841,99244,8271282210,98636,608,138,939,0xA0b86991c6218b36c1d19D4a2e9Eb0cE3606eB48,0x6DD5D07f6868D5dB3B055791b9dce502d0F159c8
1345,15627841,148046,8271282210,141446,6600,1802,103,0x00000000006c3852cbEf3e08E8dF289169EdE581,0x3b6915847D3c961de0f8BF994BeBb84A0e2f4929
1346,15627841,65000,8271282210,64404,596,138,646165,0xdAC17F958D2ee523a2206206994597C13D831ec7,0x29D5527CaA78f1946a409FA6aCaf14A0a4A0274b
1347,15627841,303334,8271282210,300206,3128,906,262,0x68b3465833fb72A70ecDF485E0e4C7bD8665Fc45,0x2d7F24188DF916c4793eeCd5FBA94B9870A325dc
1348,15627841,128053,8271282210,127765,288,74,32,0xfc4913214444aF5c715cc9F7b52655e788A569ed,0x0eBAF55AC24cca978f6d63047b42E68DC14AbB15
1349,15627841,182734,8271282210,179482,3252,1034,98,0x68b3465833fb72A70ecDF485E0e4C7bD8665Fc45,0x55E6B74AC10feB23B8A6b206345F9bEAc57e5011
1350,15627841,81838,8271282210,81190,648,266,249,0x17D084106C2f1C716ce39fa015AB022757d30C9A,0x964afBC4d4a80346861bB87dbC31a8610AE87fC4
1351,15627841,230000,8271282210,228896,1104,266,0,0xb5588C411ba0bb7D38865fdC51D082d004e519F7,0xC679F875351eFfdd3d35E6d18A52c1F45663841c
1352,15627841,140899,8271282210,140695,204,74,11,0xB092Ec81F41c619EEa434357477ea8A4b1455755,0xea7e049c3dB1BFEAFE8D801334ce770F8426c0E8
1353,15627841,153116,8271282210,146440,6676,1810,160,0x00000000006c3852cbEf3e08E8dF289169EdE581,0x2B5280D2BEFCfe1AaD2028d71D3cf7A4EF3f8C5f
1354,15627841,55923,8271282210,54979,944,138,278,0x19A4e33581c3b0ded84E6ce3Ba8515a4D45b5001,0x8013F0aEB145e4527d31032A3370f3B581C92152
1355,15627841,285312,8271282210,282528,2784,842,83,0x68b3465833fb72A70ecDF485E0e4C7bD8665Fc45,0x5B3E4b5E3C06C7B2024657494C546A5b6609147b
1356,15627841,46458,8271282210,45514,944,138,399,0x6B175474E89094C44Da98b954EedeAC495271d0F,0x1CeD4e3900c73A54eD775ef2740a4e38aC5b54e2
1357,15627841,45038,8271282210,44974,64,10,298,0xC02aaA39b223FE8D0A0e5C4F27eAD9083C756Cc2,0xA31C27766041D2f7DA2aC09D22bbbacB0c691BA1
1358,15627841,21000,8271282210,21000,0,2,8,0xf7B64fdf5e5909a72f6c4D827b2F8B10dE6f9edB,0x091c98aC6dEb67e39Aec6A232c52e8B3E79E06Db
1359,15627841,146966,8271282210,140402,6564,1802,318,0x00000000006c3852cbEf3e08E8dF289169EdE581,0xccAD221D9c55EFe5F46E69867e94698320B54dF4
1360,15627841,77725,8271282210,77093,632,138,19,0xAc0C8dA4A4748d8d821A0973d00b157aA78C473D,0x213Ba72BD0Faf97E49f31bFECb9b00B01074F8DB
1361,15627841,84000,8122282210,83392,608,138,96277,0xA0b86991c6218b36c1d19D4a2e9Eb0cE3606eB48,0x14c4017f81675F7aC1321218d4a385a2D3117328
1362,15627841,53568,8071282210,52624,944,138,94,0x576E916f0d2aBec05957b303050Fb99cDfB583BB,0xB49f3Da1F3A7F9E541A66dCaaEc00EdF3d224455
1363,15627841,264071,8071282210,262683,1388,402,4279,0x1111111254fb6c44bAC0beD2854e76F90643097d,0x404F5A67F72787a6DBDbF73E5cfEBD17216e9D32
1364,15627841,84354,8000000000,84150,204,74,94,0x9b9D659D4f2cF68b6616Cc0a65683f1951Eb725C,0x0C32B2fbE36F6CaCaE010EFf9e8AEC712f7CDa6d
1365,15627841,81858,7871283210,80010,1848,458,9839,0xFA103c21ea2DF71DFb92B0652F8B1D795e51cdEf,0xf06443E71c4778Fe8813a6bb9E036d8d10f4adeE
1366,15627841,271012,7771282210,269212,1800,458,1203,0x7a250d5630B4cF539739dF2C5dAcb4c659F2488D,0xc5ADA957A63f6d5FF0C7C598FE55631779748239
1367,15627841,150756,7771282210,150692,64,10,2,0x65c2e54a4c75ff6da7b6B32369c1677250075fb2,0x74fc9F871010Db0D112023c8060167154cE35b6A
1368,15627841,70891,7771282210,69947,944,138,63,0x83C141Ee88c502cB9654DE93598e9F16555082A8,0x8Af67D82A880607D04b5eC513768cd4ffa733Ac5
1369,15627841,55897,7771282210,54953,944,138,102,0xD42BE5dA474E9658C6969FdAe61b3F132AfC2e63,0x66652384b46ABD9439CaA4fF82C5e1c15989217B
1370,15627841,178398,7771282210,178194,204,74,2354,0x645E9324f4be25be581BB62163cfa86c40b01D07,0xc5009AFEd2D6DA219538aD165998F63B553185B1
1371,15627841,213457,7771282210,212477,980,330,15,0x822E00A929f5A92F3565A16f92581e54af2b90Ea,0x10e7f4c33DB9bee02a6c5F134b72CFEDfafE6739
1372,15627841,21000,7771282210,21000,0,2,263779,0xdC54B0A080e855c5524a8610F2eD1E7C912b59Cc,0x7Bd8EFab672250de65ba4bA3BC6C3aA08120A1c3
1373,15627841,283176,7771282210,280920,2256,650,100934,0xA69babEF1cA67A37Ffaf7a485DfFF3382056e78C,0x431B5A84aCC1297Eda88259f300262F1bc3A74f3
1374,15627841,288750,7771282210,285082,3668,906,0,0x197492CCB4B1acaAAcd43432657A17832E36AB49,0xf2cad23B0F8cC302f1581B1dB7387ecA7f175084
1375,15627841,297198,7771282210,293898,3300,1034,486,0x68b3465833fb72A70ecDF485E0e4C7bD8665Fc45,0x7862958ee0797a7ABD33A65030fC608a656febB7
1376,15627841,21000,7771282210,21000,0,2,263780,0x5Afc0f4907478fa5E8f92CA3e9f44D95242cb94e,0x7Bd8EFab672250de65ba4bA3BC6C3aA08120A1c3
1377,15627841,150000,7532976388,149380,620,138,638773,0xCB574907F6a38687195E3973510a7C86ACe037EF,0x55FE002aefF02F77364de339a1292923A15844B8
1378,15627841,191439,7316855726,190311,1128,266,522,0xd588b586D61C826A0e87919b3D1a239206d58bf2,0x5e635390931aC843c5071767cd180463268C6BCf
1379,15627841,332570,7305573678,328610,3960,1226,1812,0x68b3465833fb72A70ecDF485E0e4C7bD8665Fc45,0x729AAC9048Dd6c07d30E589087360EF1934B3a2C
1380,15627841,56659,7305573678,55715,944,138,163,0x9431DE2DFE10BDB30995bd3791dE03a6c9570054,0x0bAc86B90BdB587edB4aa4033B56341F9C12A643
1381,15627841,21000,7305573678,21000,0,2,21,0x7fAeF9b8a8798c8EdaD02a3bbC9e627e5CD68AF8,0x262cd75Ef4f983a10d2CCCFFdE8b634CF6cd8B8c
1382,15627841,55951,7305573678,55007,944,138,47,0xf88b9eBB1bc3b6DD28A47f6910DA97E530403a0f,0x5fE50e298Ab5e216a5F473424EdE56Ae48790a0B
1383,15627841,309334,7305573678,306890,2444,522,177,0x283Af0B28c62C092C9727F1Ee09c02CA627EB7F5,0x465169037Da9f80F3bA4bf6d3e6DA74e5c1BE182
1384,15627841,70000,7045200645,69068,932,138,0,0xdAC17F958D2ee523a2206206994597C13D831ec7,0x04D0cc60f70fF0E06fbeAFA547602D833f613EB4
1385,15627841,114932,6971282210,111872,3060,650,131317,0x1531b6e3d51BF80f634957dF81A990B92dA4b154,0xCb6Ed7E78d27FDff28127F9CbD61d861F09a2324
1386,15627841,331994,6958751165,161694,170300,21492,183240,0x5E4e65926BA27467555EB562121fac00D24E9dD2,0x6887246668a3b87F54DeB3b94Ba47a6f63F32985
1387,15627841,21000,6831096813,21000,0,2,299,0x3B794929566e3Ba0f25e4263e1987828b5c87161,0xAdeE0D9485820C6d099DeB0b09e312639e665c84
1388,15627841,400000,6797525426,399936,64,10,11,0x89E6E6bc6de6015c2930e0C2d5Ab3A3DEc8643F7,0x6104C122719AA28B0A610e6EDcddc23841b4885A
1389,15627841,57274,6797525426,56286,988,202,890774,0xA0b86991c6218b36c1d19D4a2e9Eb0cE3606eB48,0x340d693ED55d7bA167D184ea76Ea2Fd092a35BDc
1390,15627841,57274,9051893909,56286,988,202,890775,0xA0b86991c6218b36c1d19D4a2e9Eb0cE3606eB48,0x340d693ED55d7bA167D184ea76Ea2Fd092a35BDc
1391,15627841,51712,9051893909,50724,988,202,890776,0xdAC17F958D2ee523a2206206994597C13D831ec7,0x340d693ED55d7bA167D184ea76Ea2Fd092a35BDc
1392,15627841,57262,8202236586,56286,976,202,890777,0xA0b86991c6218b36c1d19D4a2e9Eb0cE3606eB48,0x340d693ED55d7bA167D184ea76Ea2Fd092a35BDc
1393,15627841,80000,6797525426,79056,944,138,0,0x7D1AfA7B718fb893dB30A3aBc0Cfc608AaCfeBB0,0xcB6eE34E42859C3b423d4Cbf933a475159e8a968
1394,15627841,46280,6797525426,45420,860,138,1,0xC02aaA39b223FE8D0A0e5C4F27eAD9083C756Cc2,0xE594F8e4a4518585C4FFC87ADDA973C412E5E895
1395,15627841,88552,6797525426,87628,924,266,4,0xd588b586D61C826A0e87919b3D1a239206d58bf2,0xe4700edD249fA8007e111799B9FC94cF4A8cAf49
1396,15627841,80000,6797525426,79056,944,138,0,0xdAC17F958D2ee523a2206206994597C13D831ec7,0x374BdF4CD3e71c6A56F69157CC40863977495Da1
1397,15627841,21000,6797525426,21000,0,2,0,0xdd2b9DC25c7602ed6ad591b180D445D2bfcDcd18,0xE74DC71f8F5AAbB3ecA21fc46B4cb1C9bA4740C5
1398,15627841,88552,6797525426,87628,924,266,5,0xd588b586D61C826A0e87919b3D1a239206d58bf2,0xe4700edD249fA8007e111799B9FC94cF4A8cAf49
1399,15627841,92716,7771282210,91816,900,266,6,0xd588b586D61C826A0e87919b3D1a239206d58bf2,0xe4700edD249fA8007e111799B9FC94cF4A8cAf49
1400,15627841,92662,8181282210,91798,864,266,7,0xd588b586D61C826A0e87919b3D1a239206d58bf2,0xe4700edD249fA8007e111799B9FC94cF4A8cAf49
1401,15627841,61350,6797525426,58910,2440,778,221,0x4976fb03C32e5B8cfe2b6cCB31c09Ba78EBaBa41,0x00450992BC72AB99Ae55BcCdcE68E160412fdaC0
1402,15627841,191077,6797525426,190177,900,266,68,0xd588b586D61C826A0e87919b3D1a239206d58bf2,0x2270Fe65e8bcaAfB4F595F6D2c4eC34acCACfbC3
1403,15627841,191077,7771282210,190177,900,266,69,0xd588b586D61C826A0e87919b3D1a239206d58bf2,0x2270Fe65e8bcaAfB4F595F6D2c4eC34acCACfbC3
1404,15627841,44036,6797525426,43392,644,138,1,0xf5f06fFa53Ad7F5914F493F16E57B56C8dd2eA80,0x138754e008C90Dc0504c0F63844C225BAA443b9B
1405,15627841,21000,6797525426,21000,0,2,92737,0x7B328840bd7bc6043F75AC3283a2141541376bd1,0xF1300cc9c2Cf347f7902742fEC4dF9dbA952fD7b
1406,15627841,993532,6787087241,983116,10416,1634,27893,0x0eae044f00B0aF300500F090eA00027097d03000,0x05429D641a61eB2C6093905784D2e8C9b5A193C8
1407,15627841,26000,6771282210,26000,0,2,12019,0xfFd22b84fB1d46ef74Ed6530b2635BE61340f347,0xDAFEA492D9c6733ae3d56b7Ed1ADB60692c98Bc5
1408,15627842,252782,28000000000,250734,2048,522,5,0x25553828F22bDD19a20e4F12F052903Cb474a335,0x621Ce505AeDd58694C4e9b4E5e0f69542151a2c6
1409,15627842,105000,20000000000,104392,608,138,1657540,0xdAC17F958D2ee523a2206206994597C13D831ec7,0x0A98fB70939162725aE66E626Fe4b52cFF62c2e5
1410,15627842,100000,13530000000,99056,944,138,374,0xc00e94Cb662C3520282E6f5717214004A7f26888,0xabC67a49D7d75bD04fA1DAE22cD4b8c4F796540a
1411,15627842,21000,12600000000,21000,0,2,5,0x500A746c9a44f68Fe6AA86a92e7B3AF4F322Ae66,0x11f74724A0b187639deA5C5b42aFC7F0052A3F13
1412,15627842,21000,11000000000,21000,0,2,24,0x23f4569002a5A07f0Ecf688142eEB6bcD883eeF8,0x49aB710631ad57b0Ab9E6651F272DD4be3d15120
1413,15627842,100000,9558993595,99404,596,138,88932,0xdAC17F958D2ee523a2206206994597C13D831ec7,0x3018018c44338B9728d02be12d632C6691E020d1
1414,15627842,77485,9558993595,76781,704,138,1,0xa71d0588EAf47f12B13cF8eC750430d21DF04974,0x5e7d5dD1Ff6C1c0f8B54d7D44F6570f53EEEf563
1415,15627842,240335,9558993595,234755,5580,1676,82,0x881D40237659C251811CEC9c364ef91dC08D300C,0x9e49b18c3748dfBca783407415ef7D21E99fa125
1416,15627842,261344,9558993595,255764,5580,1676,14,0x881D40237659C251811CEC9c364ef91dC08D300C,0x4A7E25BF1A61f59c4F31BD7A2Ed11eb56348ad14
1417,15627842,383478,9558993595,377134,6344,1740,41,0x881D40237659C251811CEC9c364ef91dC08D300C,0xA995B87056639FC9C8e96160cE5EbeF8F252F9fa
1418,15627842,21000,9558993595,21000,0,2,2759933,0xec2F03693c68a94123a5C3a1fbf499CB68cA2Fc5,0x267be1C1D684F78cb4F6a176C4911b741E4Ffdc0
1419,15627842,21000,9558993595,21000,0,2,2759934,0x972f9F6214c662e51941321A5D5969f43b3087e1,0x267be1C1D684F78cb4F6a176C4911b741E4Ffdc0
1420,15627842,21000,9558993595,21000,0,2,2759935,0xf82630D6C39A3d0B87dc9CA7E6e7E6fC79Ff333A,0x267be1C1D684F78cb4F6a176C4911b741E4Ffdc0
1421,15627842,200073,9558993595,196881,3192,1034,8,0x68b3465833fb72A70ecDF485E0e4C7bD8665Fc45,0xF72e0F4f52c8B876049B7cc4F8d35912378700BC
1422,15627842,771000,9558993595,766352,4648,1162,80,0xe66B31678d6C16E9ebf358268a790B763C133750,0xb5c76C95E0f7f9f30C554a1560E8282f620c3b3C
1423,15627842,130000,9277924266,129380,620,138,194,0xe3c408BD53c31C085a1746AF401A4042954ff740,0xAC0c871104E17a6094fD98Ed076B748Feb6dBADe
1424,15627842,21000,9229278028,21000,0,2,115,0x456F7A537DB9D10A2EFE1888015023F7AC7565C0,0xe2939E609643d097b695a00ff8e1cddC74B139e3
1425,15627842,207291,9058993595,206587,704,138,306,0x0B452278223D3954F4AC050949D7998e373e7E43,0x39296420a29e71C62e02F4B542661eA7A6Ff5fD8
1426,15627842,56450,9058993595,55506,944,138,262,0x1896451fbD4eB260bf6c09757a59DCe8A2f27A36,0x26e35CDb264614d6843B57D444082EA62709c4f9
1427,15627842,117738,9058993595,117534,204,74,26,0x7F9306FC1978938d5C1C57Bf6044dc67E07eeB8a,0x9a153C18A5489E97c51f76aF07f07FcB08471A2a
1428,15627842,108104,9058993595,107304,800,330,29,0x63d85ec7B1561818Ec03E158ec125a4113038A00,0x081CD37e86B53d4E2A933144ca9915714D788631
1429,15627842,58505,9058993595,57053,1452,458,1308,0x0912DAD1db4643368B029166AF217B8A9818dB15,0x7d864F613e6EFbF61614919A953ebB95b31cE373
1430,15627842,46267,9058993595,45691,576,74,279,0x283Af0B28c62C092C9727F1Ee09c02CA627EB7F5,0xA5Dc6d8522ba72eA8cC4d9Fc6e07EaBd21b4dF49
1431,15627842,284842,9058993595,282690,2152,586,585,0xFbdDaDD80fe7bda00B901FbAf73803F2238Ae655,0x44137Aa861C4ED350f4Da91C2D7c1A3Dce378601
1432,15627842,46151,9058993595,45663,488,138,2472,0x69690fa25f3c2D4CCBf0e4395b098951f7473CcB,0xA17138c0675173B8Ea506Fb1b96FA754BC316cc2
1433,15627842,286783,9058993595,284471,2312,522,8,0x283Af0B28c62C092C9727F1Ee09c02CA627EB7F5,0xDa70fB6592450C4520f23a2E1AE8CE3CCA335294
1434,15627842,123784,9058993595,122816,968,330,636,0x4e32004D8b81847A670b4a1778ACe4dCF2bBA01E,0x0bd3292Ab67D05187f0087C2e0Ae010518D4E830
1435,15627842,60667,9058993595,53271,7396,2506,345,0x00000000006c3852cbEf3e08E8dF289169EdE581,0x097ECfE35725d05A8F6d59ad60F3Bcf17293aC79
1436,15627842,21000,9058993595,21000,0,2,59,0x16612F2301A2a55c4D37C8ea295Ba7cB4071CD19,0x980fB7016D1A94E10CDF11f966B9698244BEb3D0
1437,15627842,46507,9058993595,45563,944,138,13,0xB4a81261b16b92af0B9F7C4a83f1E885132D81e4,0x27Cda06B00a0ecCF4225371792DdE8f1a5eA97EB
1438,15627842,46187,9058993595,45615,572,138,24,0x34Bc797F40Df0445c8429d485232874B15561728,0x49925E488957CD4C57D0d7435e78608e9810b0Ec
1439,15627842,328423,9058993595,325223,3200,906,225,0x68b3465833fb72A70ecDF485E0e4C7bD8665Fc45,0xa7C1d32B4bB7155Ad5e9e53F472b9CE61BB37ddc
1440,15627842,204331,9058993595,203679,652,202,119,0xa6561830c0Ff7C7c52E85cf062e01740Af216e01,0xBb0C445eddA1364Bedd6e90CF0407986E719Eb01
1441,15627842,386930,9058993595,383742,3188,906,143,0x68b3465833fb72A70ecDF485E0e4C7bD8665Fc45,0xCc9625d8dF955bb141aCebb0b428097c015b5E22
1442,15627842,1598986,9058993595,1493262,105724,33994,1,0xaE9C73fd0Fd237c1c6f66FE009d24ce969e98704,0x1d8a73b87345e6693cDf7ef959C9F9757e6D9DBA
1443,15627842,52541,9058993595,51685,856,202,562,0x000000000000509081d6FCD3ee63e791aD1db763,0xC0717434fAe0A3E1FC0615f7e016d06ff6601605
1444,15627842,132488,9058993595,126468,6020,1674,1621,0x00000000006c3852cbEf3e08E8dF289169EdE581,0x7F6A23E4E952c4C7CD9ba83978Eb29964984946C
1445,15627842,43986,9058993595,43558,428,138,11,0xcDA72070E455bb31C7690a170224Ce43623d0B6f,0x16BA96fEAC14743CAFe73Ec74f1F2536E23d8f01
1446,15627842,60655,9058993595,53271,7384,2506,1755,0x00000000006c3852cbEf3e08E8dF289169EdE581,0xD5fF53f48F14e9409B581e41a4cDDFe0E97Dc724
1447,15627842,180000,9000000000,179392,608,138,444357,0xA0b86991c6218b36c1d19D4a2e9Eb0cE3606eB48,0x48c04ed5691981C42154C6167398f95e8f38a7fF
1448,15627842,245101,8777541802,233081,12020,3858,270,0x1111111254fb6c44bAC0beD2854e76F90643097d,0x85b90a9Aad3EEF15CEA4a57cc8c7a055eF3f3721
1449,15627842,276606,8777541802,274746,1860,458,3390,0x7a250d5630B4cF539739dF2C5dAcb4c659F2488D,0x2f2648328497A95aB21fB3E3ce5039F271686F36
1450,15627842,139647,8558993595,139163,484,202,42,0xFD7936Bb96F49f292E61a5F2F7C02e914A0A9d90,0xBEfFEC197aFb189e534b8C1e70Cf50783aB02bf4
1451,15627842,175110,8558993595,173546,1564,394,79,0x1Fa8559e873f698292766790AeCf8080A66433F6,0x2d5D9Db9886dA6Cd782E4425bB34094B949bD314
1452,15627842,212322,8558993595,209526,2796,842,67,0x68b3465833fb72A70ecDF485E0e4C7bD8665Fc45,0xe8C5b857713F88b474Ecd09ABd95905C1FcF44Fa
1453,15627842,6204470,8093285063,6073718,130752,30986,17,0xd1917932A7Db6Af687B523D5Db5d7f5c2734763F,0x5009eE6869021EFcB59D707291e09cBb235F37a7
1454,15627842,259794,8000000000,257982,1812,458,138,0x7a250d5630B4cF539739dF2C5dAcb4c659F2488D,0x7adf56601fbED51ECAbD6503C6C3dE85D9c03042
1455,15627842,223268,7746462550,222328,940,202,7787,0xC9d198089D6c31d0Ca5Cc5B92C97a57A97BBfdE2,0x8aE57A027c63fcA8070D1Bf38622321dE8004c67
1456,15627843,149125,7375745197,148449,676,130,5360,0xE8c060F8052E07423f71D445277c61AC5138A2e5,0xc7Bf1bF8D639Db5aE9C52C905747795752DC967a
1457,15627843,240543,8375745197,237795,2748,842,103,0x68b3465833fb72A70ecDF485E0e4C7bD8665Fc45,0x2e10DCFEFCdA2f726Af7a3D091ecF0A1D6293188
1458,15627843,137879,621482889076,136895,984,170,5361,0xE8c060F8052E07423f71D445277c61AC5138A2e5,0xc7Bf1bF8D639Db5aE9C52C905747795752DC967a
1459,15627843,2000003,7375745197,1998211,1792,346,4771,0x00000000008C4FB1c916E0C88fd4cc402D935e7D,0x36bAF0d6C97eFd5fD6aE995d760a84f936078759
1460,15627843,345596,37375745197,343844,1752,458,107,0x7a250d5630B4cF539739dF2C5dAcb4c659F2488D,0xA7201CDA5d825ffc74360E8CBe8Ee04D52a0f6F6
1461,15627843,374823,253726402349,372615,2208,386,4772,0x00000000008C4FB1c916E0C88fd4cc402D935e7D,0x36bAF0d6C97eFd5fD6aE995d760a84f936078759
1462,15627843,463100,7375745197,458840,4260,1034,119379,0xa57Bd00134B2850B2a1c55860c9e9ea100fDd6CF,0x0cac3d1a887206e0f6169222C4504301A8b4b993
1463,15627843,256324,7375745197,254188,2136,650,96396,0xA69babEF1cA67A37Ffaf7a485DfFF3382056e78C,0xBbAD96336943A36E3e292D973B3382dd0bA4D1EF
1464,15627843,382628,8706748827,376260,6368,1740,26,0x881D40237659C251811CEC9c364ef91dC08D300C,0x3Bfc38d585efA60c2afB26386bC64a6904e8A6c8
1465,15627843,46506,8585747397,45562,944,138,36,0x4c11249814f11b9346808179Cf06e71ac328c1b5,0x1f10F11365C571a921096Ade4b740593158BDFd0
1466,15627843,21000,125000000000,21000,0,2,17,0xF73CC8098A381018823662aA7929d6Da2687804D,0x98819EdfED62F4466A4EC6ad6aF68bD10016e714
1467,15627843,200000,73000000000,199368,632,138,0,0x3a4f40631a4f906c2BaD353Ed06De7A5D3fCb430,0x5c2Aa07ca8541DE3bdB49352Aae0EB4085cbDC96
1468,15627843,350000,64856779007,348824,1176,266,33021,0x00000000ad3FB067501751e1176c9105d6a47CEc,0x1Afa018d9Be65B0Eac856340d919c4526C168FF8
1469,15627843,21000,45000000000,21000,0,2,0,0xD86e3A116Bc98A354253dea47ffd36E86b1A1BC2,0x11a5B0a6fE34296bC94d81a6B3B29dB8698211d7
1470,15627843,420000,30000000000,419392,608,138,1226076,0xdAC17F958D2ee523a2206206994597C13D831ec7,0x5041ed759Dd4aFc3a72b8192C143F72f4724081A
1471,15627843,210000,30000000000,210000,0,2,843592,0x0e8c83C39D46935Cf795A79973182439E9C21180,0xA7EFAe728D2936e78BDA97dc267687568dD593f3
1472,15627843,150000,30000000000,149344,656,138,11173682,0xe3AF9D794F7020313Abf1b7Ca20919f206b69409,0xFBb1b73C4f0BDa4f67dcA266ce6Ef42f520fBB98
1473,15627843,100000,30000000000,99404,596,138,8836,0xaaAEBE6Fe48E54f431b0C390CfaF0b017d09D42d,0xD1305FbDA97C035F86FdAA7785fb568C203174E1
1474,15627843,100000,30000000000,99332,668,138,0,0x95aD61b0a150d79219dCF64E1E6Cc01f0B64C4cE,0x4cB05F13e831F6CF30Adf9772645B6F493f6A634
1475,15627843,5049368,17000000000,5042268,7100,1098,276,0x0a39DA505DfB5E0BBc6bd84428281A8ba1bC7753,0x495E889d1A6cEB447a57dcc1C68410299392380c
1476,15627843,700000,16592849572,698128,1872,458,99,0x7a250d5630B4cF539739dF2C5dAcb4c659F2488D,0x3B5e05c1470B6907aF37Ec8C86E0fD86dbED6Ce2
1477,15627843,700000,15672841557,698140,1860,458,98,0x7a250d5630B4cF539739dF2C5dAcb4c659F2488D,0x0151D1D77Fb539C8c9E19B87e6008Cf1E0f5F66a
1478,15627843,700000,15468683077,698128,1872,458,96,0x7a250d5630B4cF539739dF2C5dAcb4c659F2488D,0x56157B796BEf83dA422860Dde69cd0921A3CA95d
1479,15627843,400000,15375745197,393712,6288,1802,296,0x00000000006c3852cbEf3e08E8dF289169EdE581,0xca4B5B240d02eC8dAaD1d530efED386ea8dceb98
1480,15627843,700000,15366691212,698140,1860,458,95,0x7a250d5630B4cF539739dF2C5dAcb4c659F2488D,0x24B97B003D4BffFd8d05B907582DA2E283a84389
1481,15627843,700000,14505437527,698128,1872,458,95,0x7a250d5630B4cF539739dF2C5dAcb4c659F2488D,0xa72775d7359422BB9292C9FC3FC8758eC0D28940
1482,15627843,2000000,13375745197,1998060,1940,522,47,0x7a250d5630B4cF539739dF2C5dAcb4c659F2488D,0x2eD539e35419d017E6448C932ed8268964883287
1483,15627843,226752,13375745197,223172,3580,1162,564,0x68b3465833fb72A70ecDF485E0e4C7bD8665Fc45,0x4207b21744413D37831833184559D46c49063656
1484,15627843,600000,12375745197,598012,1988,522,33401,0xE592427A0AEce92De3Edee1F18E0157C05861564,0x30c5312d9CF0d873994f000e72F1cbf561D0209C
1485,15627843,56713,12375745197,55769,944,138,2006,0x1C4853Ec0d55e420002c5eFaBc7Ed8e0bA7A4121,0x93392f88b8b4b2C10F2ea356f12777fc50cDEB90
1486,15627843,268839,12375745197,267015,1824,458,244,0x7a250d5630B4cF539739dF2C5dAcb4c659F2488D,0x7F9E6ED093a6c34726F9250320bfC50AdBC9fa82
1487,15627843,41783,11951314797,41091,692,138,1,0x95aD61b0a150d79219dCF64E1E6Cc01f0B64C4cE,0xf242702B411601F4e0d1247bd778Fbbb458fBc0a
1488,15627843,400000,11375745197,393712,6288,1802,627,0x00000000006c3852cbEf3e08E8dF289169EdE581,0x07Ea687C51103D3Ea021c019e2B2ffFA40FCa432
1489,15627843,750000,11375745197,748072,1928,522,1282,0x7a250d5630B4cF539739dF2C5dAcb4c659F2488D,0x9f394569A5D2Af700A5e6eaEFA067373d1b12C3C
1490,15627843,93850,11091166649,93242,608,138,355146,0xdAC17F958D2ee523a2206206994597C13D831ec7,0x7abE0cE388281d2aCF297Cb089caef3819b13448
1491,15627843,250000,11000000000,249392,608,138,270667,0xdAC17F958D2ee523a2206206994597C13D831ec7,0x23f4569002a5A07f0Ecf688142eEB6bcD883eeF8
1492,15627843,350000,10945946742,350000,0,2,6925032,0xEB64d705EBc379459F4D386dcE0BcBF05E5F26bF,0x46340b20830761efd32832A74d7169B29FEB9758
1493,15627843,850000,10375745197,848072,1928,522,94,0x7a250d5630B4cF539739dF2C5dAcb4c659F2488D,0xB35238889C8A3a5659FA0727D6B46E1c3f4Ba837
1494,15627843,207122,10375745197,204262,2860,778,51922,0x1c395af6Ee8F262D1bEFb1Dc3B0045fD6Cb2D5Da,0xeE5c2c81220317aAB869265767eFB9710D2Bc618
1495,15627843,90000,10000000000,89392,608,138,4,0xdAC17F958D2ee523a2206206994597C13D831ec7,0x950e9f9cEF630a2c0970a5143DCfb7129d1bFEbd
1496,15627843,143796,9875745197,143592,204,74,18,0x7F9306FC1978938d5C1C57Bf6044dc67E07eeB8a,0x5508A2e3bB6C7b3658f17002b2f63F22AEe86d28
1497,15627843,84777,9875745197,84713,64,10,1598,0xD495cC8C7c29c7fA3E027a5759561Ab68C363609,0x21935251e90364885d59750D17F1c132ad1Bcacb
1498,15627843,150756,9875745197,150692,64,10,4,0x65c2e54a4c75ff6da7b6B32369c1677250075fb2,0xAe38aE433Ad2C8276587ef704D5470B824956539
1499,15627843,47044,9875745197,45880,1164,458,2246,0xa907Aa001e8e0aE9132E76EEf8e2Ccb0f1936726,0x694367eA528240fec8172581282FF171A6ec39Aa
1500,15627843,285000,9875745197,284428,572,138,11,0x6b3dc1857412828cf056B145c1CB4E64aA9bdc0B,0xb46E53c2e9618fEF57e3374FBCC00cbfDdd7c63b
1501,15627843,236953,9775745197,235117,1836,458,318,0x7a250d5630B4cF539739dF2C5dAcb4c659F2488D,0x096bF23C777c4DD6a20D6dE0bBF5C89C111A8Ef2
1502,15627843,96691,9771282210,95155,1536,458,3,0x0BABA1Ad5bE3a5C0a66E7ac838a129Bf948f1eA4,0x89532E5d25B4fd8A60a67234FbdD0C791bD9B9DB
1503,15627843,225613,9605745197,224265,1348,394,1,0x3b3ae790Df4F312e745D270119c6052904FB6790,0xe13819Cfe400f3bd0b96B5E8A94d7239B6c2A197
1504,15627843,21000,9605083782,21000,0,2,28,0x2Fc06a91400F0Dad658F0B085Ddd202c1BAe1EfC,0xFB8373A0FC3Eeaa30F2866DF2E70987e4424A41A
1505,15627843,21000,9452745197,21000,0,2,251059,0xdFB2670A025765c50002cdFd5a3170f15e6A93B3,0x8216874887415e2650D12D53Ff53516F04a74FD7
1506,15627843,21000,9777745197,21000,0,2,251060,0xA8F124991a745C87e2B60a9992Ac18677007E3fC,0x8216874887415e2650D12D53Ff53516F04a74FD7
1507,15627843,230000,9440000000,229392,608,138,30,0xA0b86991c6218b36c1d19D4a2e9Eb0cE3606eB48,0xFa9f732F19800a6F9f40A545bAF436Cd28a6eaBE
1508,15627843,207128,9375745197,207128,0,2,3199167,0x6De083aCF9079100E8F6a866B183475904fe1916,0x9696f59E4d72E237BE84fFD425DCaD154Bf96976
1509,15627843,207128,9375745197,206520,608,138,4468933,0xdAC17F958D2ee523a2206206994597C13D831ec7,0x21a31Ee1afC51d94C2eFcCAa2092aD1028285549
1510,15627843,21000,9375745197,21000,0,2,58,0xf89d7b9c864f589bbF53a82105107622B35EaA40,0xDbE0328F7109556dB85d414fD9301eB4F09a9a20
1511,15627843,42000,9375745197,42000,0,2,329514,0x818860Ad4e483101F65E9Ea045cf61cd024A695E,0x9430801EBAf509Ad49202aaBC5F5Bc6fd8A3dAf8
1512,15627843,39617,9375745197,39353,264,74,41,0xC02aaA39b223FE8D0A0e5C4F27eAD9083C756Cc2,0xBfFEa57972fc6BD0498992CE29FFb8c14B904327
1513,15627843,181458,9375745197,179906,1552,394,281,0x1Fa8559e873f698292766790AeCf8080A66433F6,0x39847e7C4a5Ddc7ef5766f1C0F13070332Afe726
1514,15627843,55951,9375745197,55007,944,138,446,0xfB4781E644F6ecFe05108Ed66ea80d521B3649A3,0x263835b05ad8972731083fa2751aCd438e6B768e
1515,15627843,91140,9375745197,90196,944,138,720,0xA0b86991c6218b36c1d19D4a2e9Eb0cE3606eB48,0x9B9DB057331A2D70745755D0E458A46C38B948c5
1516,15627843,80000,9375745197,79392,608,138,2,0xdAC17F958D2ee523a2206206994597C13D831ec7,0xA10bA5c8C10Ec7D7B2c485bCe4e1fE0e948815E8
1517,15627843,85000,9375745197,84512,488,138,15,0xaE351b8Ae55B69A5007618E598dDe89d0a092c37,0x83E30Ce2767A44Fe200a1Bf43e491B2a050cA33F
1518,15627843,196221,9375745197,193485,2736,842,98,0x68b3465833fb72A70ecDF485E0e4C7bD8665Fc45,0x39F954C8674009e4bD03c4AFb36ccAf1732D3F7b
1519,15627843,494761,9375745197,491085,3676,1162,150,0x68b3465833fb72A70ecDF485E0e4C7bD8665Fc45,0x20acb94B726d8B2E7b83D11F15ceE344eDB00270
1520,15627843,274400,9375745197,266144,8256,2186,721,0xe66B31678d6C16E9ebf358268a790B763C133750,0x9B9DB057331A2D70745755D0E458A46C38B948c5
1521,15627843,35643,9375745197,34999,644,138,8,0x55296f69f40Ea6d20E478533C15A6B08B654E758,0x9297E95630303097688BE453e28E1Bd87C9c1267
1522,15627843,35655,9375745197,34999,656,138,0,0x55296f69f40Ea6d20E478533C15A6B08B654E758,0x530e4526866A52333Cb348d9aD48AD868C8Af144
1523,15627843,35643,9375745197,34999,644,138,4,0x55296f69f40Ea6d20E478533C15A6B08B654E758,0x45A915fa42f597C618b252F8faeb224A709D3e4C
1524,15627843,250000,9375745197,249060,940,202,0,0x881D4032abe4188e2237eFCD27aB435E81FC6bb1,0xC6D52F665908EeD4866cE4a613e02997dd9a260C
1525,15627843,35643,9375745197,34999,644,138,0,0x55296f69f40Ea6d20E478533C15A6B08B654E758,0x23438EA30A0563D315e568eBA7410Ef085a6ff08
1526,15627843,34857,9375745197,34213,644,138,9,0x4a220E6096B25EADb88358cb44068A3248254675,0x8bC1ceDc62946958931D6b561b8A37DbF13c59F0
1527,15627843,46109,9375745197,45501,608,138,3,0xdAC17F958D2ee523a2206206994597C13D831ec7,0xE4dA83aa53b1843519035101496F346988e9A873
1528,15627843,46109,9375745197,45501,608,138,0,0xdAC17F958D2ee523a2206206994597C13D831ec7,0x49663DB5E906b78f56CDf2487a69978f1A030FA2
1529,15627843,46097,9375745197,45501,596,138,1,0xdAC17F958D2ee523a2206206994597C13D831ec7,0x240Da1cEd9761FAD698C2EA57AcfE0e5BAe001FE
1530,15627843,46109,9375745197,45501,608,138,2,0xdAC17F958D2ee523a2206206994597C13D831ec7,0x169a409695788631393e9C0fB40338EdB99f7635
1531,15627843,35643,9375745197,34999,644,138,0,0x55296f69f40Ea6d20E478533C15A6B08B654E758,0x516D292DB4A8523cd6b0b06C81CCFD06f23A8808
1532,15627843,35643,9375745197,34999,644,138,0,0x55296f69f40Ea6d20E478533C15A6B08B654E758,0xB5c0d71d3e07F5DC4CCd7B795AEb16b002981c64
1533,15627843,35643,9375745197,34999,644,138,5,0x55296f69f40Ea6d20E478533C15A6B08B654E758,0x5bc17d9D5e2Da038460D237E34c86348d7F448E6
1534,15627843,48792,9375745197,48184,608,138,0,0xA0b86991c6218b36c1d19D4a2e9Eb0cE3606eB48,0xE276394ac009618de138b27adADf0a0e49A31b89
1535,15627843,35643,9375745197,34999,644,138,10,0x55296f69f40Ea6d20E478533C15A6B08B654E758,0x0D1779A804575c7833eD14B45250ffd5b48c5D24
1536,15627843,48792,9375745197,48184,608,138,16,0xA0b86991c6218b36c1d19D4a2e9Eb0cE3606eB48,0xE0D55ACCE65d159190C6D8A5889c59C9e054F59b
1537,15627843,35643,9375745197,34999,644,138,0,0x55296f69f40Ea6d20E478533C15A6B08B654E758,0xD30790c91Ee0C9C44F6d843D38E8D5Fb20c26743
1538,15627843,35643,9375745197,34999,644,138,8,0x55296f69f40Ea6d20E478533C15A6B08B654E758,0x30552D556d5685DeB2c6867F2D3330B63574451B
1539,15627843,35643,9375745197,34999,644,138,0,0x55296f69f40Ea6d20E478533C15A6B08B654E758,0x29E80f28ecF0F3b1Cf7eaCa82f638ba77039d5D6
1540,15627843,46109,9375745197,45501,608,138,0,0xdAC17F958D2ee523a2206206994597C13D831ec7,0xB4506A974668ad8B65dDF65Ae42142AfEaC89703
1541,15627843,35655,9375745197,34999,656,138,0,0x55296f69f40Ea6d20E478533C15A6B08B654E758,0xf8C44349D6D3aFc146608EcDab8E329454e2fBeC
1542,15627843,46097,9375745197,45501,596,138,14925,0xdAC17F958D2ee523a2206206994597C13D831ec7,0x02d24cAB4f2c3Bf6e6EB07ea07e45F96baccFfE7
1543,15627843,35643,9375745197,34999,644,138,10,0x55296f69f40Ea6d20E478533C15A6B08B654E758,0x8E398b89F8a699c244Bf13F986ade01028Ec22E9
1544,15627843,35631,9375745197,34999,632,138,2,0x55296f69f40Ea6d20E478533C15A6B08B654E758,0xB5935867a49c93346189C86420ff7202abd7dCb8
1545,15627843,35643,9375745197,34999,644,138,6,0x55296f69f40Ea6d20E478533C15A6B08B654E758,0x90b26b0AcD4C5972591143aA726417Df13dd60Ce
1546,15627843,46109,9375745197,45501,608,138,5,0xdAC17F958D2ee523a2206206994597C13D831ec7,0x1b0e946C691854dB511E907e73D397eD8D073146
1547,15627843,35643,9375745197,34999,644,138,0,0x55296f69f40Ea6d20E478533C15A6B08B654E758,0x11d1941Fdc9B49d5436C7010568d0A7c586a4411
1548,15627843,46109,9375745197,45501,608,138,0,0xdAC17F958D2ee523a2206206994597C13D831ec7,0x8A2D9C6df6Eb07b8706E240e45dFE635Cd8EFf04
1549,15627843,35643,9375745197,34999,644,138,0,0x55296f69f40Ea6d20E478533C15A6B08B654E758,0xEe32B2B04242eaa6b87e3df1d76Ed0956793230b
1550,15627843,35655,9375745197,34999,656,138,0,0x55296f69f40Ea6d20E478533C15A6B08B654E758,0x2Fe0fA2b69e27e02Cf7FE547a07ACadf83D60FFF
1551,15627843,35655,9375745197,34999,656,138,0,0x55296f69f40Ea6d20E478533C15A6B08B654E758,0x614553391Aa2aa879420B9C0AB832fD9B63f3bea
1552,15627843,51158,9375745197,50526,632,138,295686,0x83249c6794BCa5a77Eb8c0AF9F1A86E055459cea,0x3aB28eCeDEa6cdb6feeD398E93Ae8c7b316B1182
1553,15627843,740000,9375745197,729004,10996,2506,83288,0x4d839a486EC0B1C9b0D9e9D397993Ba5B150cB34,0xcC29be4Ca92D4Ecc43C8451fBA94C200B83991f6
1554,15627843,185268,9375745197,181700,3568,1162,193,0x68b3465833fb72A70ecDF485E0e4C7bD8665Fc45,0x68E8d2E2423176bbEC676B50745541906d18E01D
1555,15627843,21000,9375745197,21000,0,2,10,0xa19b1a876F3761f6F39A18e71656E37E7ed5E2bA,0x0664A503b2ABe79a28277b64f00183F9E49487F8
1556,15627843,200000,9375745197,199572,428,138,815,0xb47e3cd837dDF8e4c57F05d70Ab865de6e193BBB,0xb4Bb4156e5e6Ca5D81041f616c27dfFB253B7845
1557,15627843,39630,9375745197,39354,276,74,264,0xC02aaA39b223FE8D0A0e5C4F27eAD9083C756Cc2,0x062082F5b88D7dC0be8260dAb7Dad82A2Ae621De
1558,15627843,21000,9375745197,21000,0,2,3150,0x62Ef8b356751612Ad33863c454825BF94998AF2E,0x68698221819F044803313B5520022953c7D9172A
1559,15627843,21000,9375745197,21000,0,2,1123,0x62Ef8b356751612Ad33863c454825BF94998AF2E,0xfdf9f7Ef7b12c01Cd1162862167a30B80b1324f0
1560,15627843,21000,9375745197,21000,0,2,1100,0x62Ef8b356751612Ad33863c454825BF94998AF2E,0x888a6008b6312E5723c1eD412Be26ae95D4198D4
1561,15627843,21000,9375745197,21000,0,2,1102,0x62Ef8b356751612Ad33863c454825BF94998AF2E,0x515FF4c330Fa5C9CCDE500bDE5A16Ba0b6FA9BfC
1562,15627843,21000,9375745197,21000,0,2,1126,0x62Ef8b356751612Ad33863c454825BF94998AF2E,0x52C478BE6b58a45a9F1A0aC3C384f3B9a247D366
1563,15627843,21000,9375745197,21000,0,2,3667,0x62Ef8b356751612Ad33863c454825BF94998AF2E,0x55f3bFB6a8AeE55EA567328e5560CC92eFDD9CCC
1564,15627843,21000,9375745197,21000,0,2,1102,0x62Ef8b356751612Ad33863c454825BF94998AF2E,0x51AFE21eE4684b1Cba449Efd86090d8Dd957F926
1565,15627843,21000,9375745197,21000,0,2,2404,0x62Ef8b356751612Ad33863c454825BF94998AF2E,0x612093AC1A182533B0998c8636d6405b61693531
1566,15627843,21000,9375745197,21000,0,2,2614,0x62Ef8b356751612Ad33863c454825BF94998AF2E,0x6c3Dc2aea8E0724963889bce04296917532EE7f9
1567,15627843,21000,9375745197,21000,0,2,1092,0x62Ef8b356751612Ad33863c454825BF94998AF2E,0xB19c331F84D371c4fD054032C7A2c2E65555Cb10
1568,15627843,21000,9375745197,21000,0,2,2256,0x62Ef8b356751612Ad33863c454825BF94998AF2E,0xB746364F3BAdCFD12FAc38E82684c6e7EC69e6c9
1569,15627843,21000,9375745197,21000,0,2,2235,0x62Ef8b356751612Ad33863c454825BF94998AF2E,0x2d96122bA2364AF5CECbA41771CE94ceE2981013
1570,15627843,21000,9375745197,21000,0,2,1090,0x62Ef8b356751612Ad33863c454825BF94998AF2E,0x7F1A76F1bBd18aCeE5E01d83ad84bbF1e7a3BBDd
1571,15627843,21000,9375745197,21000,0,2,2324,0x62Ef8b356751612Ad33863c454825BF94998AF2E,0x5cb9683BCa05AA566D38044dA17ff0C539545AbD
1572,15627843,21000,9375745197,21000,0,2,1123,0x62Ef8b356751612Ad33863c454825BF94998AF2E,0x69564E2553Aa7D7D0Fd24080cf4636F157730fD2
1573,15627843,21000,9375745197,21000,0,2,1094,0x62Ef8b356751612Ad33863c454825BF94998AF2E,0xa93Ab3f16cD394d3b65307C50236Fa8ae2c81BF5
1574,15627843,21000,9375745197,21000,0,2,1105,0x62Ef8b356751612Ad33863c454825BF94998AF2E,0x7e97A55526D859d390ecB42fB0669e0923E6fC0c
1575,15627843,21000,9375745197,21000,0,2,1091,0x62Ef8b356751612Ad33863c454825BF94998AF2E,0xDfA2541C7Aad239bDC550EC1Ed543bD340F42743
1576,15627843,21000,9375745197,21000,0,2,1116,0x62Ef8b356751612Ad33863c454825BF94998AF2E,0x8Ed757EDFD96a7921C96094b67997F53a59C7216
1577,15627843,21000,9375745197,21000,0,2,1219,0x62Ef8b356751612Ad33863c454825BF94998AF2E,0x91096B40fc4F7523835e5eCb133ab023188270f7
1578,15627843,21000,9375745197,21000,0,2,1112,0x62Ef8b356751612Ad33863c454825BF94998AF2E,0xA6ec3D2Cb86E5eC083f3E978F5B66Ef13DFE3A8D
1579,15627843,21000,9375745197,21000,0,2,1113,0x62Ef8b356751612Ad33863c454825BF94998AF2E,0x771c4364973093a00F910fd179aCc3BDa901F25F
1580,15627843,21000,9375745197,21000,0,2,1098,0x62Ef8b356751612Ad33863c454825BF94998AF2E,0xAB01EAe171832020283C96Bd7aea2AEcf270fb89
1581,15627843,21000,9375745197,21000,0,2,4126,0x62Ef8b356751612Ad33863c454825BF94998AF2E,0xb82df4A8F53673447B8Df37B6375711212Be3899
1582,15627843,21000,9375745197,21000,0,2,2250,0x62Ef8b356751612Ad33863c454825BF94998AF2E,0x3ebceB1D81705B238FED9AD02F8fAE69EA1199c5
1583,15627843,21000,9375745197,21000,0,2,3637,0x62Ef8b356751612Ad33863c454825BF94998AF2E,0x6104f6684F4F966E4B81CDf9a6B4836052CDa456
1584,15627843,285326,9375745197,282530,2796,842,368,0x68b3465833fb72A70ecDF485E0e4C7bD8665Fc45,0x94e3047aE5bbce0039B19b264120Ee9A350c7875
1585,15627843,21000,9375745197,21000,0,2,135,0x6ACBAC46ebcDcc47712c7163811186FC847775f6,0xF5D0570A5F3B8F5a624012F2C7832dB521F49850
1586,15627843,21000,9375745197,21000,0,2,2264,0x62Ef8b356751612Ad33863c454825BF94998AF2E,0xd63A869444F5460eAAf1d91eB96F3410161f3885
1587,15627843,21000,9375745197,21000,0,2,2303,0x62Ef8b356751612Ad33863c454825BF94998AF2E,0x17554e17297402BCf04DC2a2B99e4c3822847565
1588,15627843,21000,9375745197,21000,0,2,1103,0x62Ef8b356751612Ad33863c454825BF94998AF2E,0x59177a0A5EcCFBaaFa5d4d19078451480aaBEFae
1589,15627843,21000,9375745197,21000,0,2,2266,0x62Ef8b356751612Ad33863c454825BF94998AF2E,0x08c00e3e5757B393968493E0e44054bf72075117
1590,15627843,21000,9375745197,21000,0,2,1102,0x62Ef8b356751612Ad33863c454825BF94998AF2E,0x1c671035e3A4BF299ec811f0FbdbCaC522C5d78F
1591,15627843,231442,9375745197,231110,332,138,72,0x94235659cF8b805B2c658f9ea2D6d6DDbb17C8d7,0xfCDc25ba0D9D9C16A40506802a50C6c0870d5BC6
1592,15627843,21000,9375745197,21000,0,2,2311,0x62Ef8b356751612Ad33863c454825BF94998AF2E,0x56a4C947538066F8D45122d5D48914529D4f8C54
1593,15627843,21000,9375745197,21000,0,2,1106,0x62Ef8b356751612Ad33863c454825BF94998AF2E,0x04Af15455D6cE209F0c52651463CB7f4426A40c0
1594,15627843,21000,9375745197,21000,0,2,2231,0x62Ef8b356751612Ad33863c454825BF94998AF2E,0xBA5626A31C4844AC03DDc5e93aa7fA3045D43BC5
1595,15627843,21000,9375745197,21000,0,2,1104,0x62Ef8b356751612Ad33863c454825BF94998AF2E,0xDeC9B6564209DB8A58382CCd3868540d1Ef700EF
1596,15627843,212356,9375745197,208788,3568,1162,368,0x68b3465833fb72A70ecDF485E0e4C7bD8665Fc45,0xc4331008949DEe0eb51B3fb8262a8d842FA6a372
1597,15627843,410319,9375745197,404851,5468,1482,2252,0x68b3465833fb72A70ecDF485E0e4C7bD8665Fc45,0x06Fd390060Ab47e6962eFD54aa51819FaE164878
1598,15627843,21000,9375745197,21000,0,2,33,0x8D438Fc9C0C4c0f01F32943810b6955bb39B9AE0,0x4C30A441E5Ae890474EbaA841F782A76AF6E3979
1599,15627843,245648,9375745197,240904,4744,1420,179,0x881D40237659C251811CEC9c364ef91dC08D300C,0x76525783B4AFB360A22499D3D994DF564F63CD69
1600,15627843,60000,9295755060,59432,568,202,34113,0x41c69c8ffb4049fc393ed68Ec0Ce66c37f8CF7a0,0xe8463A6d371581d3E40315daD7dbAB85f1492da8
1601,15627843,21000,9260000000,21000,0,2,8,0xf4472D8760dD37C27530CADF3E1ff7f4C6D6C7eA,0xd2C0Ba05A22E24737EeB4700E8ea1c1cE24C59bd
1602,15627843,21000,9125538652,21000,0,2,171,0xA37862c06E2266f01262b86ABD2f23ed8D83E5D4,0x799B9d960ACE20F5724Ac9023DA91F95Fb854908
1603,15627843,68780,9051893909,68184,596,138,6,0xA0b86991c6218b36c1d19D4a2e9Eb0cE3606eB48,0x7B328840bd7bc6043F75AC3283a2141541376bd1
1604,15627843,21000,9025745197,21000,0,2,66,0x6B82ee7171B8eF20dAe8A51aa928b8B782C6E2e2,0x6B82ee7171B8eF20dAe8A51aa928b8B782C6E2e2
1605,15627843,103028,9000000000,100680,2348,522,254,0x4976fb03C32e5B8cfe2b6cCB31c09Ba78EBaBa41,0x320125E4Ba4a346066d468310411511dbcab75Eb
1606,15627843,222156,9000000000,218528,3628,1162,2043,0x68b3465833fb72A70ecDF485E0e4C7bD8665Fc45,0x218497ad97886Ad4C0Bc8af4CC484508245dD8f2
1607,15627843,125266,8885745197,125266,0,2,119,0xE4b3fB63000066292F3e7911a55A0000bbBB0000,0x146c6432a5cf6c3126501deF6C8cD0C3172497d7
1608,15627843,3415604,8875745197,3352836,62768,8094,0,,0x7D35286C7d6864Cf6A61b4EC90F3d2FB6F8C7935
1609,15627843,149346,8875745197,142694,6652,1810,192,0x00000000006c3852cbEf3e08E8dF289169EdE581,0x243068AeB086dB5287ac8787F2Fe295dD6cdD20f
1610,15627843,287269,8875745197,284945,2324,522,225,0x283Af0B28c62C092C9727F1Ee09c02CA627EB7F5,0x57679F905F9618d50a638cc1fe272003A831cec1
1611,15627843,240722,8875745197,234814,5908,1738,771,0x68b3465833fb72A70ecDF485E0e4C7bD8665Fc45,0xd97Bfa595FEC38455aF2739A730045B91C249142
1612,15627843,132398,8875745197,126290,6108,1682,75,0x00000000006c3852cbEf3e08E8dF289169EdE581,0xd47eA9310429F7e255CE39d464BfaB9ffCF002eF
1613,15627843,21000,8875745197,21000,0,2,75,0x43E3434E0aBD5651997089a6f70f9Bd9730e7aF6,0x65518A5f3da6E9A89C66cE4c46484aCA2Da2d034
1614,15627843,46547,8875745197,46059,488,138,32,0xaE351b8Ae55B69A5007618E598dDe89d0a092c37,0xB195515b4A54885b7311c84c9b5640Aa0f5d3F22
1615,15627843,46187,8875745197,45615,572,138,1,0x6661c87764AdF7FffA3c7922FA6EDFa2fd62cCfC,0xeD203F0a36D4e9A8fcABa5EC6100b577FB59F8Db
1616,15627843,56730,8875745197,55786,944,138,268,0x64Df3aAB3b21cC275bB76c4A581Cf8B726478ee0,0xfE598c8DBEA6d78Dd06AE537B8171695d075106E
1617,15627843,21000,8875745197,21000,0,2,5,0x56A4c6e9937f466D8ee6Dd4a01279CaDCd6c5b9C,0xd6118c1a49d843ebb7A4678DDdc43127AEa474d7
1618,15627843,27938,8875745197,27874,64,10,825,0xC02aaA39b223FE8D0A0e5C4F27eAD9083C756Cc2,0xcF806faA913b3Ac7bCB7b57b1199411a76D96646
1619,15627843,211449,8875745197,199437,12012,3794,113,0x00000000006c3852cbEf3e08E8dF289169EdE581,0xa4b4467BeB88cfaA40F43C684Cd33aCbc5B0beD0
1620,15627843,77878,8875745197,77186,692,138,2,0x95aD61b0a150d79219dCF64E1E6Cc01f0B64C4cE,0x7A0DD67577D580d15271970E2C909c6f14294837
1621,15627843,141971,8875745197,135451,6520,1810,108,0x00000000006c3852cbEf3e08E8dF289169EdE581,0x2Fb99221fb673D1bed25204C069879206b481715
1622,15627843,716952,8875745197,711076,5876,1482,160,0x76f4eeD9fE41262669D0250b2A97db79712aD855,0x3C325DfeafaC6F08DB973E7dfD6E25490aE00Af1
1623,15627843,21000,8875745197,21000,0,2,14,0xC4cf683277525eE54D2c0b6E0c3B9f10F3e769E7,0x99fbecDdd9432741d4Bf04EaA331FE85105164f1
1624,15627843,21000,8875745197,21000,0,2,5,0x502922a5A1e39A4164893ec58A8C98A4d4a5C434,0xcc4404A161fEe8acD7EB088Cc0989C4ad272224a
1625,15627843,500000,8875745197,497276,2724,650,8820,0x2e973758d5f319ED4768570182cA601e970ff549,0x0Ac650F878Cc45a23727fA13B67d019B37B379BA
1626,15627843,117333,8875745197,116849,484,202,147,0x01cF6B5684C7D9d0BbBd57a385e5F2B06D42771f,0xCcE7daE7e8798AeF3f7cb1Fe639D3951Efa5DbBf
1627,15627843,500000,8875745197,499784,216,74,801,0xD94C7060808f3c876824E57e685702f3834D2e13,0x45C7811C459a43d0C17EF18F33A2C8921aC4ECf8
1628,15627843,143000,8875745197,136424,6576,1802,6,0x00000000006c3852cbEf3e08E8dF289169EdE581,0xb5B7F1efd4D1344f7f6ea331EF34B93a6dde1F00
1629,15627843,112403,8875745197,108327,4076,1290,35,0x0000000000c2d145a2526bD8C716263bFeBe1A72,0xe3895596586b430d64a4B685c0E49585Cb6bc7fB
1630,15627843,21000,8875745197,21000,0,2,648,0x7992Ae3F68887a46c76832a0ddBdF1E15BdC1Cf6,0x1118d298be3188973092ab92CAeeE0161A3AC22A
1631,15627843,46492,8875745197,45548,944,138,463,0x04906695D6D12CF5459975d7C3C03356E4Ccd460,0x293994b0Bc3eED688A4697871381d43fc4AA6FD5
1632,15627843,513963,8875745197,510371,3592,1162,61,0x68b3465833fb72A70ecDF485E0e4C7bD8665Fc45,0x7A5eA59C9F41a94a8956063256d41A2b98E066F2
1633,15627843,45399,8875745197,44447,952,202,397,0xC86664e7d2608f881f796ee8E24FA9d4d7598406,0x7D3E5dD617EAF4A3d42EA550C41097086605c4aF
1634,15627843,99226,8875745197,98630,596,138,8,0xA0b86991c6218b36c1d19D4a2e9Eb0cE3606eB48,0x3583d5bF1b06EB6c950B680F94503827B85E15d9
1635,15627843,600000,8875745197,591368,8632,1354,19,0x0fd829C3365A225FB9226e75c97c3A114bD3199e,0x9C4c2553a37b40024E1Ee8046c01Cd7b0Fd309ab
1636,15627843,21000,8875745197,21000,0,2,15,0x71359b4F61aCC559C3530E6b25Ec4d536f260eaD,0xf74a726e15177be51e7c6f5DEC8B7979aE4D3aC3
1637,15627843,285326,8875745197,282530,2796,842,42,0x68b3465833fb72A70ecDF485E0e4C7bD8665Fc45,0xc9E9768cC2b993a5D3707c5Dc569C5A92157F115
1638,15627843,21000,8875745197,21000,0,2,3,0xE271D1cA928F0B40bF0561cde64DE0c7f96DEe8d,0xE7E515947d04596800f14b9A1165E54968349eeB
1639,15627843,312459,8875745197,298731,13728,4298,200,0xb4E7B8946fA2b35912Cc0581772cCCd69A33000c,0xf2EB70e0c90CB9C8720CB374a8690cdC63E1680a
1640,15627843,94463,8875745197,94031,432,74,0,0xA0c68C638235ee32657e8f720a23ceC1bFc77C77,0xE5CAC56e1f702104f8138A0b384abD54f4BcadF5
1641,15627843,46859,8875745197,46371,488,138,5,0x197492CCB4B1acaAAcd43432657A17832E36AB49,0xb63dAfBBc589C2B5BB6De89629F890FcCef16763
1642,15627843,179002,8875745197,172426,6576,1802,69,0x00000000006c3852cbEf3e08E8dF289169EdE581,0x2a0C7667A873D09Dd059b88E7311C3AE2C33AC2F
1643,15627843,99226,8875745197,98630,596,138,476,0xA0b86991c6218b36c1d19D4a2e9Eb0cE3606eB48,0x85BC03678220009E82206ddCCbf713228750F759
1644,15627843,46267,8875745197,45691,576,74,5663,0x283Af0B28c62C092C9727F1Ee09c02CA627EB7F5,0x484eC62385e780f2460fEaC34864A77bA5A18134
1645,15627843,21000,8875745197,21000,0,2,46,0x79E03885bAd42449d957370FE4B8f94a9d11E5c0,0x0d34eB140a2d3138c225fb893E29fce033000F47
1646,15627843,148656,8875745197,142004,6652,1810,56,0x00000000006c3852cbEf3e08E8dF289169EdE581,0x0ACA580f1Fe36FE49e9E359C64C5A5e71c64e643
1647,15627843,225258,8875745197,222006,3252,1034,238,0x68b3465833fb72A70ecDF485E0e4C7bD8665Fc45,0x5c66Fa36978803eB832eDd8E7d06EFbD703ba70E
1648,15627843,31582,8875745197,31582,0,2,25,0xFc377A505DFE0eC8d7fB34c52FC68C74D48A8c5f,0x3317a5241c9deAA134660369C54C54A3709d1A2a
1649,15627843,21000,8875745197,21000,0,2,6,0x236A1bdD6c66c0e8d199a82AC79efe9d170E33a4,0xfFFF560B35e06a08c171ca458B74512E593CE910
1650,15627843,73188,8875745197,72580,608,138,7,0xA0b86991c6218b36c1d19D4a2e9Eb0cE3606eB48,0x8018AD748E095662Ff30454055877a524D7E0872
1651,15627843,99244,8875745197,98636,608,138,459,0xA0b86991c6218b36c1d19D4a2e9Eb0cE3606eB48,0xC2b374f6884943a2a1C3D723FAE133Fe0eA876FC
1652,15627843,146717,8875745197,140117,6600,1802,73,0x00000000006c3852cbEf3e08E8dF289169EdE581,0x85E6cC88F3055b589eb1d4030863be2CFcc0763E
1653,15627843,117738,8875745197,117534,204,74,27,0x7F9306FC1978938d5C1C57Bf6044dc67E07eeB8a,0x9a153C18A5489E97c51f76aF07f07FcB08471A2a
1654,15627843,133896,8875745197,112116,21780,7250,75,0x00000000006c3852cbEf3e08E8dF289169EdE581,0x9Fc923e741a7a8258CbFEa60050348adE2B07a49
1655,15627843,36015,8875745197,35751,264,74,63,0xC02aaA39b223FE8D0A0e5C4F27eAD9083C756Cc2,0x3A73A38e7b01CaA1251c9779113026A0e448F98b
1656,15627843,21000,8875745197,21000,0,2,3,0x6Aa83284D7C5B62fbF30aC83AfF887135eB5688E,0xa17c8D882005d7C8eB79E38f3792814DDDfaCb10
1657,15627843,299359,8875745197,296159,3200,906,226,0x68b3465833fb72A70ecDF485E0e4C7bD8665Fc45,0xa7C1d32B4bB7155Ad5e9e53F472b9CE61BB37ddc
1658,15627843,209833,8875745197,207461,2372,522,1842,0x283Af0B28c62C092C9727F1Ee09c02CA627EB7F5,0xA9aa6E7bC4257D7DB05aEf0AAcD3DB14A7fdca2E
1659,15627843,90177,8875745197,88905,1272,458,44,0xd6eFcD22f0E3A4A9c35a8Aabff52350DfB0C2621,0xB3E97282b8Be84B8744173cbaCCd4dE226Ee4A32
1660,15627843,298210,8875745197,295426,2784,842,84,0x68b3465833fb72A70ecDF485E0e4C7bD8665Fc45,0x5B3E4b5E3C06C7B2024657494C546A5b6609147b
1661,15627843,46185,8875745197,45697,488,138,2473,0xb8fCAb85c037D85Cb67ECd5C66Bb649d14f03168,0xA17138c0675173B8Ea506Fb1b96FA754BC316cc2
1662,15627843,199606,8875745197,196378,3228,1034,11612,0x68b3465833fb72A70ecDF485E0e4C7bD8665Fc45,0xF165D353abDDb7Cb00052d610254249FCc12a8C7
1663,15627843,55951,8875745197,55007,944,138,1969,0x04B9788559Db3869eB48C76acaC7Af17c0165B00,0x947c8b3deb1014774850Aa8864f8Fc568CcdB3af
1664,15627843,149772,8875745197,149568,204,74,358,0x7F9306FC1978938d5C1C57Bf6044dc67E07eeB8a,0x1Ab5d274F499C602E2281dEcaa717AD29bcBB4E5
1665,15627843,21000,8875745197,21000,0,2,0,0x3fcb73fB2b7Aeed628f37dAB031E1516Bb7e0053,0x8D7689a39a94F561361822d99f6168E759e6971d
1666,15627843,117604,8875745197,113528,4076,1290,3,0x0000000000c2d145a2526bD8C716263bFeBe1A72,0x03f14D5930fB58107CDb2fe9DE6E7d4B2a1b2E5F
1667,15627843,21000,8700000000,21000,0,2,705865,0xe3C2Cd625F79c981f65B10C29c810dD18fb8621b,0x6dfc34609a05bC22319fA4Cce1d1E2929548c0D7
1668,15627843,21000,9690000000,21000,0,2,705866,0xDb4B60a61E81dA3B3fE6B061603E98D1e622d57d,0x6dfc34609a05bC22319fA4Cce1d1E2929548c0D7
1669,15627843,21000,9690000000,21000,0,2,705867,0x0Eae2c51d95a2C7b9a08bab3614cD3fDc39c58a7,0x6dfc34609a05bC22319fA4Cce1d1E2929548c0D7
1670,15627843,100000,9700000000,99024,976,202,705868,0xdAC17F958D2ee523a2206206994597C13D831ec7,0x6dfc34609a05bC22319fA4Cce1d1E2929548c0D7
1671,15627843,474582,8685745197,472630,1952,522,7991,0x7a250d5630B4cF539739dF2C5dAcb4c659F2488D,0x11191bcfe30c6aE7bBEF74c6De97c8D52FF957F9
1672,15627843,195635,8675745197,194259,1376,402,88,0x1111111254fb6c44bAC0beD2854e76F90643097d,0xe45419390B38f2A90645a8930cE4039D99F116f7
1673,15627843,264071,8594293404,262683,1388,402,4280,0x1111111254fb6c44bAC0beD2854e76F90643097d,0x404F5A67F72787a6DBDbF73E5cfEBD17216e9D32
1674,15627843,276620,8594293404,274748,1872,458,3391,0x7a250d5630B4cF539739dF2C5dAcb4c659F2488D,0x2f2648328497A95aB21fB3E3ce5039F271686F36
1675,15627843,56667,8575745197,55723,944,138,3320,0xB97Ad583dacB8Bd46F75b3593c6eF2ec598Ef37e,0x9B228B4F71B3Bc7e4b478251f218060D7B70Dc25
1676,15627843,120000,8518745197,119392,608,138,2,0xdAC17F958D2ee523a2206206994597C13D831ec7,0xdf2400a22FeB4CF6601E12938911FA214E715f0d
1677,15627843,21000,8518745197,21000,0,2,10378,0x8e136f33163008aD6CCcd23271e8f0573E557fA0,0xE21D837cd1437305632ac1660A94c64b1ECd3151
1678,15627843,21000,8518745197,21000,0,2,57299,0xB00F0759DbeeF5E543Cc3E3B07A6442F5f3928a2,0xCfC0F98f30742B6d880f90155d4EbB885e55aB33
1679,15627843,46234,8436309006,45746,488,138,21,0x51a683ADDca1ec65ca1dcB329539717592dd55cE,0x826455f19DE03f3cA5D757fB5e1352975F3297D9
1680,15627843,43768,8375745197,43564,204,74,3,0xB97Ad583dacB8Bd46F75b3593c6eF2ec598Ef37e,0x01CB0dd9Fa036eB4999b9F277c2ac367C0E74666
1681,15627843,55897,8375745197,54953,944,138,260,0x6c5A9466A8a5ED51584f6B4ad652e21AB5E7ee0E,0x6F6d381EAA241A96dfA3816fCE8AAcB67D21Ba95
1682,15627843,181476,8375745197,179912,1564,394,447,0x1Fa8559e873f698292766790AeCf8080A66433F6,0x57D1222669CE384C41d761e424Cae1bfd44Cbe72
1683,15627843,594005,8375745197,592497,1508,330,2,0x5B6f8486511B0F2BBe977d17547364Ef2D3807C9,0xB4b764AF7b9cc9Fa56a38211606C21f585DE9276
1684,15627843,21000,8375745197,21000,0,2,5,0xd27a1906Bb99c5A38c33d3db67871053825A02b0,0xf2A1860ED9d30F05919574b825492c28117c7ba1
1685,15627843,30000,8375745197,29796,204,74,19,0x23C38ADb5Cf6640F4Fa4D9753268c5C6426b9720,0xD4ec3B1b45dcE9C8bBCCaD19c8389fE9F37B287D
1686,15627843,21000,8375745197,21000,0,2,52374,0x736714e9C2a015E97DFb20cBc0588D1258B457ae,0x7c195D981AbFdC3DDecd2ca0Fed0958430488e34
1687,15627843,2000000,8375745197,1990344,9656,2250,171034,0xA9D1e08C7793af67e9d92fe308d5697FB81d3E43,0x7830c87C02e56AFf27FA8Ab1241711331FA86F43
1688,15627843,21000,8375745197,21000,0,2,7100794,0x1d1B1Bf8F38CB2397797B156CD964916D09E6Fc7,0xddfAbCdc4D8FfC6d5beaf154f18B778f892A0740
1689,15627843,213558,8375745197,209978,3580,1162,173,0x68b3465833fb72A70ecDF485E0e4C7bD8665Fc45,0x06f0e4207Ac4e8b1c798113f4cc977d0331d1A1B
1690,15627843,21000,8375745197,21000,0,2,346917,0x5d8136d87AFfeDd8Fb5deAaB49E01100fC437643,0x77696bb39917C91A0c3908D577d5e322095425cA
1691,15627843,2000000,8375745197,1989352,10648,2314,171035,0xA9D1e08C7793af67e9d92fe308d5697FB81d3E43,0x7830c87C02e56AFf27FA8Ab1241711331FA86F43
1692,15627843,175110,8375745197,173546,1564,394,309,0x1Fa8559e873f698292766790AeCf8080A66433F6,0x3433adDd9C997Fd5F1A062abc92a90E1970AB64f
1693,15627843,350000,8375745197,348908,1092,266,33022,0x00000000ad3FB067501751e1176c9105d6a47CEc,0x1Afa018d9Be65B0Eac856340d919c4526C168FF8
1694,15627843,21000,8116855726,21000,0,2,1,0xa961cd79a66939332d71527006eC1Edb4F8F5Fb8,0x6eF314FE7C08Cb78D58Df1995dE6CdF2060435F9
1695,15627843,180000,8000000000,179404,596,138,444358,0xdAC17F958D2ee523a2206206994597C13D831ec7,0x48c04ed5691981C42154C6167398f95e8f38a7fF
1696,15627843,180000,9000000000,179380,620,138,444359,0x2b591e99afE9f32eAA6214f7B7629768c40Eeb39,0x48c04ed5691981C42154C6167398f95e8f38a7fF
1697,15627843,143796,8000000000,143592,204,74,18,0x7F9306FC1978938d5C1C57Bf6044dc67E07eeB8a,0x6D8Ff1424b78FD953F8D3E4ceE543F930eD3422C
1698,15627843,176545,8000000000,176341,204,74,1399,0xa5e384253faa3c52079F008A39eccCED09865029,0x225D7280ecdB9F1F993bfF2F887228974c72093A
1699,15627843,99245,7992659853,98637,608,138,36,0xA0b86991c6218b36c1d19D4a2e9Eb0cE3606eB48,0x3788E4eD5a7c772B671F181CD9291bb3D7BED2f3
1700,15627843,21000,7910036665,21000,0,2,28,0xc830d6bF563C63Abc0073B3F2Ca7dc28f7c2409b,0x3A3b10F3Bb092FA2A11d936B469853159FcF7DFD
1701,15627843,182547,7910036665,181159,1388,402,9,0x1111111254fb6c44bAC0beD2854e76F90643097d,0x40fC24Da69AA37268c87F6c076F0b0a3917B6304
1702,15627843,69904,7910036665,68960,944,138,0,0x6fC13EACE26590B80cCCAB1ba5d51890577D83B2,0xfb2A3e7aEdC2297A8E00A23Ed0f0c09b71E648e8
1703,15627843,405274,7883541316,401646,3628,1162,48,0x68b3465833fb72A70ecDF485E0e4C7bD8665Fc45,0x5fE50e298Ab5e216a5F473424EdE56Ae48790a0B
1704,15627843,21000,7883541316,21000,0,2,4458,0x7266c37415a2c864b2EDFF30343bA143CEb77874,0x6306A2D99FdeeBF725e7d60D73e0Eb4A8ff39584
1705,15627843,21000,7883541316,21000,0,2,590,0xdfaD1422AfaB5C1f6Ae15BeA85c4D036Eed92C7f,0x4f702E509D41D388694B96cf3F9a2d2bF3cF8F77
1706,15627843,21000,7883541316,21000,0,2,59,0xc5F0dEaEe2674f391363db3980AB4271c0f78b92,0x811d77b93746E93d06b774B0B1FF2De1d7b2c229
1707,15627843,329014,7857731690,324682,4332,1034,20,0x197492CCB4B1acaAAcd43432657A17832E36AB49,0x0d2cAD56e15aEd87a2bBc56ef17Db89793a75A85
1708,15627843,34881,7850154522,34321,560,138,23,0xf5b1Fd29d23e98Db2D9EBb8435E1082e3B38FB65,0x62B3B1BDf247a5624bC7e4B2Ecd4E16Ad926Ce50
1709,15627843,600000,7746462550,599344,656,138,138558,0x7D1AfA7B718fb893dB30A3aBc0Cfc608AaCfeBB0,0x974CaA59e49682CdA0AD2bbe82983419A2ECC400
1710,15627843,105000,7746462550,105000,0,2,138559,0xA903F4e43BCAE409a551C0CF9cB47562906885D0,0x974CaA59e49682CdA0AD2bbe82983419A2ECC400
1711,15627843,105000,7746462550,105000,0,2,138560,0x6183dDDdf53E906ff52B64847c554C6A3c01228E,0x974CaA59e49682CdA0AD2bbe82983419A2ECC400
1712,15627843,197382,7563214152,196442,940,202,7788,0x60E4d786628Fea6478F785A6d7e704777c86a7c6,0x8aE57A027c63fcA8070D1Bf38622321dE8004c67
1713,15627843,71410,7563214152,70458,952,202,103,0xF59B70D31Dd2a7ce2FdFB0a9326988dF6cc58ec9,0x7fAeF9b8a8798c8EdaD02a3bbC9e627e5CD68AF8
1714,15627843,71410,8313089972,70458,952,202,104,0xF59B70D31Dd2a7ce2FdFB0a9326988dF6cc58ec9,0x7fAeF9b8a8798c8EdaD02a3bbC9e627e5CD68AF8
1715,15627843,71410,8375745197,70458,952,202,105,0xF59B70D31Dd2a7ce2FdFB0a9326988dF6cc58ec9,0x7fAeF9b8a8798c8EdaD02a3bbC9e627e5CD68AF8
1716,15627843,71410,8375745197,70458,952,202,106,0xF59B70D31Dd2a7ce2FdFB0a9326988dF6cc58ec9,0x7fAeF9b8a8798c8EdaD02a3bbC9e627e5CD68AF8
1717,15627843,71410,8375745197,70458,952,202,107,0xF59B70D31Dd2a7ce2FdFB0a9326988dF6cc58ec9,0x7fAeF9b8a8798c8EdaD02a3bbC9e627e5CD68AF8
1718,15627843,30000,7375745197,30000,0,2,638,0x388C818CA8B9251b393131C08a736A67ccB19297,0xf573d99385C05c23B24ed33De616ad16a43a0919
1719,15627844,69974,37956728589,69030,944,138,108,0xd4cB651749953988647eEE9b51DDB8DB5aeb3410,0xA7201CDA5d825ffc74360E8CBe8Ee04D52a0f6F6
1720,15627844,21000,37746462550,21000,0,2,30143,0x0e451436025B652dbD396873F25e7756d16f933e,0x463E5b673d1029989c9B059d36393c539beF9094
1721,15627844,700000,17049666469,698128,1872,458,578,0x7a250d5630B4cF539739dF2C5dAcb4c659F2488D,0x4FF34D243b0c5e473989c54F565B6f05D421826b
1722,15627844,700000,16086420919,698128,1872,458,15,0x7a250d5630B4cF539739dF2C5dAcb4c659F2488D,0x5053f790cb9cFa016268eDaBdefAFc498b6d59Ce
1723,15627844,700000,21625480743,698128,1872,458,16,0x7a250d5630B4cF539739dF2C5dAcb4c659F2488D,0x5053f790cb9cFa016268eDaBdefAFc498b6d59Ce
1724,15627844,250000,15126428304,249024,976,202,62,0xdAC17F958D2ee523a2206206994597C13D831ec7,0xe1E9c80D8141e4B81f8254e5110aeCE359B32446
1725,15627844,21000,14065730358,21000,0,2,0,0x44AfFdf87ABfb1DBa08e444141bD21B4380FA35F,0x2cDc85729c6986c940e49A4d3D654CDb96DD574C
1726,15627844,21000,14000000000,21000,0,2,53,0x052B52deB866d3878943484F778303e494F3D260,0x507515e2330F439DA0112C60b0E037a446269140
1727,15627844,496203,13930000000,490539,5664,1418,375,0x76f4eeD9fE41262669D0250b2A97db79712aD855,0xabC67a49D7d75bD04fA1DAE22cD4b8c4F796540a
1728,15627844,800000,13011419589,799936,64,10,1861,0xD4A0E3EC2A937E7CCa4A192756a8439A8BF4bA91,0x1b988A9BF09a452BF60c139a116580CbcB84bdfB
1729,15627844,638424,12956728589,634832,3592,1162,164,0x68b3465833fb72A70ecDF485E0e4C7bD8665Fc45,0x0bAc86B90BdB587edB4aa4033B56341F9C12A643
1730,15627844,70824,12956728589,69880,944,138,245,0x9431DE2DFE10BDB30995bd3791dE03a6c9570054,0x7F9E6ED093a6c34726F9250320bfC50AdBC9fa82
1731,15627844,222222,12000000000,220658,1564,394,525,0x1Fa8559e873f698292766790AeCf8080A66433F6,0x97ff850c2Be5cD73BFE6Fc2566c55d2967fc6B2C
1732,15627844,100000,11619693825,99392,608,138,181429,0x473037de59cf9484632f4A27B509CFE8d4a31404,0x6238872A0Bd9F0E19073695532a7Ed77ce93C69E
1733,15627844,100000,11619693825,99392,608,138,181430,0x473037de59cf9484632f4A27B509CFE8d4a31404,0x6238872A0Bd9F0E19073695532a7Ed77ce93C69E
1734,15627844,21000,11360980331,21000,0,2,11,0xCBD6832Ebc203e49E2B771897067fce3c58575ac,0xAD02ceEE196Fe8434758C3746f6A11A9DDd9A24E
1735,15627844,21000,11278625753,21000,0,2,44,0xCBD6832Ebc203e49E2B771897067fce3c58575ac,0x36B31513e0aF0e4EbA9Dd983C117164462374aef
1736,15627844,500000,10956728589,495780,4220,1098,60924,0x585C3d4Da9b533C7e3dF8AC7356C882859298cEe,0xd5cf0Cb9a8DF9B46f077f561d8b76c34A69bD82F
1737,15627844,134783,10638908036,132447,2336,594,1321,0xDef1C0ded9bec7F1a1670819833240f027b25EfF,0x5E46884a77E0aC5F3126e30720Bd5218814dc5E2
1738,15627844,84777,10456728589,84713,64,10,858,0xD495cC8C7c29c7fA3E027a5759561Ab68C363609,0xD9186E34aE6197236E6cB9290b1D2F60aD7a9102
1739,15627844,329040,10456728589,324708,4332,1034,666,0x197492CCB4B1acaAAcd43432657A17832E36AB49,0x4306584e0B233AE9c1E6C154A9Ff230FC2E06AA3
1740,15627844,55951,10356728589,55007,944,138,319,0xeE3FC268418f54cFEb7817cc52C642489A5DF098,0x096bF23C777c4DD6a20D6dE0bBF5C89C111A8Ef2
1741,15627844,100366,9956728589,99686,680,138,2738,0x4Fabb145d64652a948d72533023f6E7A623C7C53,0x1777281a2b6610D40FF726C3e03BbdC3b93D31aD
1742,15627844,382064,9956728589,379268,2796,842,45,0x68b3465833fb72A70ecDF485E0e4C7bD8665Fc45,0x6623DBa7899Ef0Ed50D7c093FA40D2631de5d911
1743,15627844,298210,9956728589,295426,2784,842,177,0x68b3465833fb72A70ecDF485E0e4C7bD8665Fc45,0x200256825A76c089069014Cef039B81d26e3142d
1744,15627844,42000,9956728589,42000,0,2,329515,0x53b67EE272E2Fb1Ff9ED418461fA2e032Fb9A29A,0x9430801EBAf509Ad49202aaBC5F5Bc6fd8A3dAf8
1745,15627844,21000,9956728589,21000,0,2,968,0x04d2DBc40cBd749decB6f9093E160f6931AEf2D9,0x01A59E630Dc2C5ac30BeE0E23d7024AD57aE67BF
1746,15627844,210000,9832178397,209320,680,138,96,0xd4cB651749953988647eEE9b51DDB8DB5aeb3410,0xa72775d7359422BB9292C9FC3FC8758eC0D28940
1747,15627844,210000,9832178397,209320,680,138,97,0xd4cB651749953988647eEE9b51DDB8DB5aeb3410,0x56157B796BEf83dA422860Dde69cd0921A3CA95d
1748,15627844,210000,9832178397,209320,680,138,100,0xd4cB651749953988647eEE9b51DDB8DB5aeb3410,0x3B5e05c1470B6907aF37Ec8C86E0fD86dbED6Ce2
1749,15627844,210000,9832178397,209332,668,138,96,0xd4cB651749953988647eEE9b51DDB8DB5aeb3410,0x24B97B003D4BffFd8d05B907582DA2E283a84389
1750,15627844,210000,9832178397,209320,680,138,99,0xd4cB651749953988647eEE9b51DDB8DB5aeb3410,0x0151D1D77Fb539C8c9E19B87e6008Cf1E0f5F66a
1751,15627844,21000,9690000000,21000,0,2,0,0x6dfc34609a05bC22319fA4Cce1d1E2929548c0D7,0x6364b4525fcaE53ed5BFE84cD76A917C9631c3d5
1752,15627844,21000,9456728589,21000,0,2,198,0xD9Ca7dBAB4F1aa1E52f7e7013b8588596C380799,0x5bAB06Aab8aEcD0E60c8287391233F2285ad7071
1753,15627844,55636,9456728589,54692,944,138,109,0xC02aaA39b223FE8D0A0e5C4F27eAD9083C756Cc2,0xFA6D73E0108C3Ab2b3F12e769c141e3a8Ee0601E
1754,15627844,288174,9456728589,285838,2336,522,43,0x283Af0B28c62C092C9727F1Ee09c02CA627EB7F5,0x80626F32C252EB332C1963F21836969f6c03629E
1755,15627844,279813,9456728589,276449,3364,778,8,0x22c541F4938dC6C27b5e9D332DbE3D6fCE5538ee,0xCA3A20c41Facd8E3C8467Db39100e8e9f1172A08
1756,15627844,1210688,9456728589,1184828,25860,3338,256,0x000000000000509081d6FCD3ee63e791aD1db763,0xB14E9Fab06b03AFd4cAE786bb92480392140E54b
1757,15627844,75393,9456728589,74453,940,202,272,0xA4F6105B612f913e468F6B27FCbb48c3569ACbE7,0x5d32D63D159a206f12A1F7E378b6fEf324766cEd
1758,15627844,151363,9456728589,144775,6588,1802,10,0x00000000006c3852cbEf3e08E8dF289169EdE581,0xa67bfEe448855F34d2a3fC5d9CAa1C87C9240BaF
1759,15627844,56840,9456728589,55376,1464,458,184,0x0BD4D37E0907C9F564aaa0a7528837B81B25c605,0x8B40C197D5349c5511769f6b237147008fe85B1b
1760,15627844,249982,9456728589,247538,2444,522,345,0x283Af0B28c62C092C9727F1Ee09c02CA627EB7F5,0xd3AfEA7C924cBbFe8C3B514cefb6dbd505788Fa3
1761,15627844,46154,9456728589,45582,572,138,573,0x008F603F0f9Aaa2C05db0F4De44cdE91fcFF430a,0x6346465302feAF753aFc29680A0299faa53e33af
1762,15627844,288346,9456728589,285998,2348,522,201,0x283Af0B28c62C092C9727F1Ee09c02CA627EB7F5,0x79B3b99476f44B2bC0288c4396B260f6DFC79597
1763,15627844,161144,9456728589,158336,2808,842,17,0x68b3465833fb72A70ecDF485E0e4C7bD8665Fc45,0x090c5f3894b9f30733FDD3DB58515E5f9F540b64
1764,15627844,174610,9456728589,167970,6640,1810,942,0x00000000006c3852cbEf3e08E8dF289169EdE581,0xE0B93aaA75212EF2839738E6Fc139C36bdfEF33E
1765,15627844,304329,9456728589,301077,3252,1034,202,0x68b3465833fb72A70ecDF485E0e4C7bD8665Fc45,0x5f614de434C90435e7DEE65bb7E6D958F180912D
1766,15627844,56667,9456728589,55723,944,138,2,0xc667a0e7711de7C5916038B6FB709C93DBb7B67f,0xf984500D009834046c618AeB16AfA77A6F08E29E
1767,15627844,21000,9456728589,21000,0,2,0,0x46c3E1bcd369A5Eeb2f9f6a679A4ea9b0BAB5eb3,0x46c3E1bcd369A5Eeb2f9f6a679A4ea9b0BAB5eb3
1768,15627844,134926,9456728589,128298,6628,1810,69,0x00000000006c3852cbEf3e08E8dF289169EdE581,0x90FEdB809d30520C46977b55be9D1ef87C611EAB
1769,15627844,159328,9456728589,157492,1836,458,17,0xd9e1cE17f2641f24aE83637ab66a2cca9C378B9F,0xc1B9d10E012FDa488cDFb336AC0a54d1DC403C03
1770,15627844,405106,9456728589,401526,3580,1162,12,0x68b3465833fb72A70ecDF485E0e4C7bD8665Fc45,0x2556b534cb6F36F14C965229aC86320054Ad0b02
1771,15627844,49259,9456728589,48687,572,138,944,0x7f738Ad7072187909384B2ffBaEEdC3C1DA1b686,0xa81D9Ae27cBe04a761d375Df8252f7AbB8F925Fe
1772,15627844,142782,9456728589,136454,6328,1738,108,0x00000000006c3852cbEf3e08E8dF289169EdE581,0xCc1dD65746D5910362bE6201D598BE868C83dF32
1773,15627844,178806,9456728589,171590,7216,1930,5,0x00000000006c3852cbEf3e08E8dF289169EdE581,0xFCE2c79fD35f653d92eEC7954F2A4fa0f979ab1b
1774,15627844,21000,9456728589,21000,0,2,97,0xc2C9E8ffA0ab83E26115D9346BeFAe09Bf860BA9,0x75A6085Bbc25665B6891EA94475E6120897BA90b
1775,15627844,46083,9456728589,45595,488,138,42,0x59FB0E02D402E81400358B645D6122287A412f2f,0x0943f00da86e8C38eA929fbF652d1e720fFd0865
1776,15627844,60751,9456728589,53271,7480,2506,65,0x00000000006c3852cbEf3e08E8dF289169EdE581,0xC78E80F0E6233F8071848F05F2C7ab37B585D25b
1777,15627844,62516,9456728589,60788,1728,266,120,0xcCbCa4F9651Ef122D58d7EC5acCa27D806840209,0x1a083628b6Acfec6f80d623cc71f48E7045c2a2D
1778,15627844,94737,9456728589,94305,432,74,245,0xae7ab96520DE3A18E5e111B5EaAb095312D7fE84,0x09a4E26d69821EDEffa5Eb29f134D0d8cad8EfC4
1779,15627844,21000,9456728589,21000,0,2,199,0x1034B8C85e2b5da2ecf64E20100a46Cc33E1DD97,0x5bAB06Aab8aEcD0E60c8287391233F2285ad7071
1780,15627844,52321,9456728589,51653,668,138,13,0x4a220E6096B25EADb88358cb44068A3248254675,0xD1e896880EAc1721Da20D537713d4512e6075C7B
1781,15627844,21000,9456728589,21000,0,2,82,0xdE84a8C9Edf394b8FA2186c7b33BD39a8345e631,0x2DFAA32A750a1ADc6f8D9C4De370040798787B9A
1782,15627844,131122,9456728589,125114,6008,1674,136,0x00000000006c3852cbEf3e08E8dF289169EdE581,0x85b007D5aC3873fEB9528A1e7cbDf8b959340C21
1783,15627844,231232,9456728589,212208,19024,4618,341,0x00000000006c3852cbEf3e08E8dF289169EdE581,0x4ae1CA9bD2Cc1bE18d37110A1D2cfF4C58BE70E8
1784,15627844,56659,9456728589,55715,944,138,349,0x9431DE2DFE10BDB30995bd3791dE03a6c9570054,0x2f978993Ca781B6904Cd4f30d137bA821FfF8Dc1
1785,15627844,55923,9456728589,54979,944,138,76,0xD309A8d0498Cc73f53481e46094DC0d3aaB0d9dd,0x82EEe77F98B8748D365dD2F18738f723Bb5cF309
1786,15627844,21000,9456728589,21000,0,2,539,0xcf3B9dFB29EaE12b6389EB6ccd19a03DE02318D9,0x949297c9675770f765d2796D99249Ee78Fb7A200
1787,15627844,109934,9456728589,109262,672,266,460,0x283Af0B28c62C092C9727F1Ee09c02CA627EB7F5,0xbF51d8DB5a1bf6e1874aE85ff1c8ecEb4341A00A
1788,15627844,206717,9456728589,187241,19476,4682,643,0x00000000006c3852cbEf3e08E8dF289169EdE581,0x103246339988c3A3eC32086A179d6D6b8dE34c4F
1789,15627844,21000,9456728589,21000,0,2,148,0xc623483a440A6Fb5C0D41f8E30a9F3dF49a237Ad,0x677da4eD1AA5888A64016cc132E9d6aAdCF5237D
1790,15627844,46171,9456728589,45683,488,138,1062,0xc6ec80029CD2aa4B0021cEb11248C07b25D2DE34,0x050C1C3D2E802dD6208Acee28806CC65f35F9327
1791,15627844,60000,9295755060,59432,568,202,37654,0x902F09715B6303d4173037652FA7377e5b98089E,0x339d413CCEfD986b1B3647A9cfa9CBbE70A30749
1792,15627844,50733,9224948151,50113,620,138,12,0xdAC17F958D2ee523a2206206994597C13D831ec7,0x3881ACE83ceDE0DD139505480e1879367705400e
1793,15627844,172056,9000000000,170788,1268,330,297,0xA0c68C638235ee32657e8f720a23ceC1bFc77C77,0x2DeECa909787B9553DBa4ade8F78F67dBe22D5b9
1794,15627844,56902,8956728589,56838,64,10,12,0xB092Ec81F41c619EEa434357477ea8A4b1455755,0xea7e049c3dB1BFEAFE8D801334ce770F8426c0E8
1795,15627844,250000,8956728589,250000,0,2,45337042,0x6c5B228D0b7eD221582396365A05eb290B1C482d,0xEA674fdDe714fd979de3EdF0F56AA9716B898ec8
1796,15627844,250000,8956728589,250000,0,2,45337043,0xC663Ba182D884ec69807f80b6462C900f1c40b42,0xEA674fdDe714fd979de3EdF0F56AA9716B898ec8
1797,15627844,250000,8956728589,250000,0,2,45337044,0x940718d94f55429D4f53393c3B1307C7cc17ff4C,0xEA674fdDe714fd979de3EdF0F56AA9716B898ec8
1798,15627844,250000,8956728589,250000,0,2,45337045,0x51A69f18551E6037f934039cC3787621A7070056,0xEA674fdDe714fd979de3EdF0F56AA9716B898ec8
1799,15627844,250000,8956728589,250000,0,2,45337046,0x34F65E4B99a14D0549a048A80fC9F8C7399e5421,0xEA674fdDe714fd979de3EdF0F56AA9716B898ec8
1800,15627844,250000,8956728589,250000,0,2,45337047,0x9C65Ccb04A3CeAD6b880902A35595f3618f59142,0xEA674fdDe714fd979de3EdF0F56AA9716B898ec8
1801,15627844,250000,8956728589,250000,0,2,45337048,0x0cEa7A286FBb17d21DC462007826D89Ad54232ae,0xEA674fdDe714fd979de3EdF0F56AA9716B898ec8
1802,15627844,250000,8956728589,250000,0,2,45337049,0x864f10a7A8FB4A216C43F3b93d9b18E64cBc75b7,0xEA674fdDe714fd979de3EdF0F56AA9716B898ec8
1803,15627844,250000,8956728589,250000,0,2,45337050,0x55384186e57f0812555Bed7cf0e3C5A36424a497,0xEA674fdDe714fd979de3EdF0F56AA9716B898ec8
1804,15627844,250000,8956728589,250000,0,2,45337051,0x981f1953884453571448301f55bfa61Ed7275071,0xEA674fdDe714fd979de3EdF0F56AA9716B898ec8
1805,15627844,70854,8956728589,70246,608,138,38,0x66d28cb58487a7609877550E1a34691810A6b9FC,0xd638E38Bc48300Ef03A65dd0c71d0201F4A8eAfc
1806,15627844,94795,8956728589,94199,596,138,9,0xdAC17F958D2ee523a2206206994597C13D831ec7,0xa23a264Be8a7E6D13792c5bdb7Ae6dadb913894d
1807,15627844,181458,8956728589,179906,1552,394,1397,0x1Fa8559e873f698292766790AeCf8080A66433F6,0x6e19cE8aF8c4Eb668840680a38C12FD7390Cdc42
1808,15627844,71410,8894073364,70458,952,202,108,0xF59B70D31Dd2a7ce2FdFB0a9326988dF6cc58ec9,0x7fAeF9b8a8798c8EdaD02a3bbC9e627e5CD68AF8
1809,15627844,21000,8563214152,21000,0,2,139,0x03476A65eFD691bD32CDa69EA320a5BadDeAD777,0xd713d03775600d1d1e5f3299848c37AA3854e4ed
1810,15627844,275018,8491323536,264654,10364,3018,4357,0x9008D19f58AAbD9eD0D60971565AA8510560ab41,0x731a0A8ab2C6FcaD841e82D06668Af7f18e34970
1811,15627844,21000,8491020057,21000,0,2,6,0xB0e69cDf0C7eF4eD3c31F4F75969F68dC0Ce0CCa,0x915373bd02dCEeC540c83Aec1D058af3dAcA3E63
1812,15627844,21000,8000000000,21000,0,2,29,0x1ED566bef24e06D4741d6329B2BD190236b05dF5,0x5bc65B4DDe96889B762DdA902d493a17f88dcec8
1813,15627844,211393,8000000000,210621,772,202,31,0xcDA72070E455bb31C7690a170224Ce43623d0B6f,0x4d08Ed1d821e89c3DD47f5C16F352C6860B4EAd4
1814,15627845,173257,342791380496,171909,1348,190,5328,0x9507c04B10486547584C37bCBd931B2a4FeE9A41,0x474a6FaF2178982bE06028f0e1256af98910d9BE
1815,15627845,125335,7576950619,124687,648,86,5182,0x00000000A991C429eE2Ec6df19d40fe0c80088B8,0x77ad3a15b78101883AF36aD4A875e17c86AC65d1
1816,15627845,182322,9076950619,179514,2808,842,1136,0x68b3465833fb72A70ecDF485E0e4C7bD8665Fc45,0x6d01af8711133DEE2B2edfC54DC6Ce38223f8396
1817,15627845,92908,133816007300,91940,968,126,5183,0x00000000A991C429eE2Ec6df19d40fe0c80088B8,0x77ad3a15b78101883AF36aD4A875e17c86AC65d1
1818,15627845,888888,40576950619,886888,2000,522,257,0x7a250d5630B4cF539739dF2C5dAcb4c659F2488D,0x63aaC08e966f7Cc16e89102b7e882a867492A69f
1819,15627845,243862,7576950619,241726,2136,650,43188,0x5050e08626c499411B5D0E0b5AF0E83d3fD82EDF,0xBf2D5d8eBF05947245B3D7f38b2776A6a49710DD
1820,15627845,324794,21108610205,324794,0,2,116838,0x6046945C5B5eF5933b8E73a98A6AD7bF3e031df7,0x6046945C5B5eF5933b8E73a98A6AD7bF3e031df7
1821,15627845,21000,20000000000,21000,0,2,206,0xf4754fCdd8cc2ACdE3D856d69Bbe8F25E5f03244,0xa0E753CCa2Cb589c3F82E7a67a75DadB37Eb762a
1822,15627845,5049496,17000000000,5042372,7124,1098,277,0x0a39DA505DfB5E0BBc6bd84428281A8ba1bC7753,0x495E889d1A6cEB447a57dcc1C68410299392380c
1823,15627845,198556,7576950619,197924,632,90,103236,0x01FF6318440f7D5553a82294D78262D5f5084EFF,0x5AA17fC7F2950ECa85376C3A8CB1509e8e4B39dF
1824,15627845,223452,9076950619,220680,2772,842,507,0x68b3465833fb72A70ecDF485E0e4C7bD8665Fc45,0x918403Accc9F319c724E9e57d016dbA8CA6c7aae
1825,15627845,171597,26001698966,170645,952,130,103237,0x01FF6318440f7D5553a82294D78262D5f5084EFF,0x5AA17fC7F2950ECa85376C3A8CB1509e8e4B39dF
1826,15627845,105000,13144197544,104404,596,138,5440,0xdAC17F958D2ee523a2206206994597C13D831ec7,0x97b9D2102A9a65A26E1EE82D59e42d1B73B68689
1827,15627845,191041,13000000000,190165,876,266,1386,0xd588b586D61C826A0e87919b3D1a239206d58bf2,0xC22d03e13B888Dabb33A1575e4F6542f0e996622
1828,15627845,268839,12576950619,267015,1824,458,27,0x7a250d5630B4cF539739dF2C5dAcb4c659F2488D,0x34b8404Bc449bFe7891C1Bd648d9559057Cc59F8
1829,15627845,242781,12576950619,240957,1824,458,246,0x7a250d5630B4cF539739dF2C5dAcb4c659F2488D,0x7F9E6ED093a6c34726F9250320bfC50AdBC9fa82
1830,15627845,268839,12576950619,267015,1824,458,222,0x7a250d5630B4cF539739dF2C5dAcb4c659F2488D,0x2cF962479895De592aE1f1d338caED65949c99E1
1831,15627845,222222,12000000000,220658,1564,394,540,0x1Fa8559e873f698292766790AeCf8080A66433F6,0x91Bd6FABB9A4fB4f4531e85Df96Baa64A1EAfbD0
1832,15627845,21040,12000000000,21040,0,2,33,0xc9f5296Eb3ac266c94568D790b6e91ebA7D76a11,0xDD93Fcb78B2A074451160CC182A69195bFC9d5d8
1833,15627845,300014,11576950619,298486,1528,394,224454,0x98C3d3183C4b8A650614ad179A1a98be0a8d6B8E,0x91aaE0aAfd9D2d730111b395c6871f248d7Bd728
1834,15627845,63000,11297831059,63000,0,2,2710045,0xD73e0DEf01246b650D8a367A4b209bE59C8bE8aB,0xC098B2a3Aa256D2140208C3de6543aAEf5cd3A94
1835,15627845,63000,11297831059,63000,0,2,2710046,0x911Cf22D6928B995857dD6552B91583E0e84A3AF,0xC098B2a3Aa256D2140208C3de6543aAEf5cd3A94
1836,15627845,63000,11292372071,63000,0,2,2710047,0x85B8bEac4A0b4E375f8A79463B983126e655bAdb,0xC098B2a3Aa256D2140208C3de6543aAEf5cd3A94
1837,15627845,193502,11017957024,193438,64,10,121,0x6140605Fa8CdeBe0e23a1e0F8ce041dD7d841627,0xb259d4e38789FBBD1482942BA2e7959Ef313ee30
1838,15627845,21000,10644197544,21000,0,2,0,0x4945cE2d1B5BD904CAc839b7FDAbAfd19Cab982b,0x4F5d78CC41dC380fE7A862cb8DD4faC1Edd1cA22
1839,15627845,21000,10644197544,21000,0,2,0,0x4945cE2d1B5BD904CAc839b7FDAbAfd19Cab982b,0x153Fd869b39CE543488B1bb9E5e5737b72a33bBb
1840,15627845,21000,10644197544,21000,0,2,0,0x4945cE2d1B5BD904CAc839b7FDAbAfd19Cab982b,0x750bD63F8AD284A35970853F748A6798e57E27C1
1841,15627845,21000,10644197544,21000,0,2,1,0x4945cE2d1B5BD904CAc839b7FDAbAfd19Cab982b,0x09b61a61cA3F1d24715Df6D1959021E9A3412dAB
1842,15627845,21000,10644197544,21000,0,2,0,0x4945cE2d1B5BD904CAc839b7FDAbAfd19Cab982b,0x3eEAa930183407cdB05c3Cb470E4eA050fed1845
1843,15627845,21000,10644197544,21000,0,2,0,0x4945cE2d1B5BD904CAc839b7FDAbAfd19Cab982b,0x697595acA3674D4c714e2970a2c9FFAFAdD6Cb9B
1844,15627845,106000,10576950619,106000,0,2,109,0xCac0F1A06D3f02397Cfb6D7077321d73b504916e,0xA7201CDA5d825ffc74360E8CBe8Ee04D52a0f6F6
1845,15627845,21000,10246462550,21000,0,2,1,0x4945cE2d1B5BD904CAc839b7FDAbAfd19Cab982b,0x6185758CE3D460df6F97ed3E27185792B2cF0EF4
1846,15627845,21000,10246462550,21000,0,2,0,0x4945cE2d1B5BD904CAc839b7FDAbAfd19Cab982b,0x1ed513572F6494942b7bF1A809Be29d702B0a7Bc
1847,15627845,21000,10246462550,21000,0,2,0,0x4945cE2d1B5BD904CAc839b7FDAbAfd19Cab982b,0xa4AB5E0a6b55aA3f8c5E2c97a295549bCD497CE5
1848,15627845,143796,10076950619,143592,204,74,98,0x7F9306FC1978938d5C1C57Bf6044dc67E07eeB8a,0x1271F40Cf3d7229a874433331D11f0134b95c6C1
1849,15627845,330490,10076950619,327794,2696,714,40,0x86ca49D37015a8541642B1B5A90Af0115eC61994,0xbC44a5f0B5849f423e0cAB308472610159654E4B
1850,15627845,150756,10076950619,150692,64,10,5,0x65c2e54a4c75ff6da7b6B32369c1677250075fb2,0xAe38aE433Ad2C8276587ef704D5470B824956539
1851,15627845,155748,10076950619,155544,204,74,36,0x7F9306FC1978938d5C1C57Bf6044dc67E07eeB8a,0x0980C672196660DFC77959a6A99ddbD857274F2a
1852,15627845,144631,10076950619,144427,204,74,93,0x7F9306FC1978938d5C1C57Bf6044dc67E07eeB8a,0x539aEe394EDbe2aE6E537651dB0989a7aDaaA5fB
1853,15627845,21000,10030060799,21000,0,2,12,0xc93ABCE5639a9B874955D539618be63782a14703,0x12ecF171EEc3892a8A09a8DF55509704B296f670
1854,15627845,21000,10000000000,21000,0,2,31056,0xB9ce0eaA0a324a8945F799649e1172Af50d5965d,0x777d4627E31863b2a49e2985AF46525F21a9846C
1855,15627845,21000,10000000000,21000,0,2,2918,0x566e7C9Bf07E450021874846137e744E5970e3CA,0x35053Cc78A63C45715ec4BA3cc05be5EB62abCCb
1856,15627845,21000,9807713346,21000,0,2,458,0x37F92f5301645E4e5cD415148E9eA34069f587C3,0xd5e5d602aDb31A00D90FEa6d6CcA4d085C9252dc
1857,15627845,50000,9577950619,50000,0,2,57682,0x37dcD5687a82D57d963e84A1f2d7674d0900c2f2,0xe6f79f8B46b30f293cfBDe50eF787d2Fe0610782
1858,15627845,69913,9576950619,68969,944,138,2,0xa47c8bf37f92aBed4A126BDA807A7b7498661acD,0x34EDaC1B7556b1cB415a88bd02487e4F655Ed0DF
1859,15627845,21000,9576950619,21000,0,2,136,0x5B0B1DFD29c5e2304649726602DbEC55d55D169f,0xF5D0570A5F3B8F5a624012F2C7832dB521F49850
1860,15627845,21000,10185374423,21000,0,2,137,0xF8DDaFB7E6a398d2f050E36C98Ee2B549Eb90597,0xF5D0570A5F3B8F5a624012F2C7832dB521F49850
1861,15627845,56042,9576950619,55098,944,138,14134,0x1494CA1F11D487c2bBe4543E90080AeBa4BA3C2b,0xD54e4f8A55247487dd7C8c59f14EE5c0c2889477
1862,15627845,465396,9576950619,460724,4672,1162,24,0xe66B31678d6C16E9ebf358268a790B763C133750,0xB21a5Df68A5862AFA709f230F559BBA78734499f
1863,15627845,317070,9576950619,312338,4732,1162,3,0xe66B31678d6C16E9ebf358268a790B763C133750,0x34EDaC1B7556b1cB415a88bd02487e4F655Ed0DF
1864,15627845,464948,9576950619,458668,6280,1612,660,0x881D40237659C251811CEC9c364ef91dC08D300C,0x37B009b21260e07fe73AD2E5BEe98acb1C6B8B2a
1865,15627845,207128,9576950619,206532,596,138,4708688,0xA0b86991c6218b36c1d19D4a2e9Eb0cE3606eB48,0x28C6c06298d514Db089934071355E5743bf21d60
1866,15627845,207128,9576950619,207128,0,2,1679521,0xc8EB7334ee4FD57eeBE5E55d9B9211880bf92c80,0x4976A4A02f38326660D17bf34b431dC6e2eb2327
1867,15627845,207128,9576950619,207128,0,2,4232322,0x962c841CEE8a06054C4024Ca7EEB8d415611bc16,0xDFd5293D8e347dFe59E90eFd55b2956a1343963d
1868,15627845,207128,9576950619,207128,0,2,4468934,0xA39B0EC4860C67505Af0bD627a92Ab9eD0651112,0x21a31Ee1afC51d94C2eFcCAa2092aD1028285549
1869,15627845,207128,9576950619,207128,0,2,3199168,0xaF39ad2a9976a774e6cCcA333202Ee2B84aAf69C,0x9696f59E4d72E237BE84fFD425DCaD154Bf96976
1870,15627845,207128,9576950619,207128,0,2,3492268,0x9F11F164d598e59DA3d73F949e898177d278540B,0x56Eddb7aa87536c09CCc2793473599fD21A8b17F
1871,15627845,207128,9576950619,207128,0,2,4708689,0x6EB7C7B8A4953F9ac495ee6d338019da1E1aa16a,0x28C6c06298d514Db089934071355E5743bf21d60
1872,15627845,169772,9576950619,169568,204,74,26,0x7F9306FC1978938d5C1C57Bf6044dc67E07eeB8a,0x56B9845aC2D821DD9D750D35461e25f80D3E9340
1873,15627845,72292,9576950619,71648,644,138,13,0xCd7492db29E2ab436e819b249452EE1bbDf52214,0x8106c51C57Cb806bCB720E9BF0AE8345813155Ad
1874,15627845,169772,9576950619,169568,204,74,5,0x7F9306FC1978938d5C1C57Bf6044dc67E07eeB8a,0x6De5C9a743CB0B0b359b43951e454B257b0AC689
1875,15627845,169772,9576950619,169568,204,74,27,0x7F9306FC1978938d5C1C57Bf6044dc67E07eeB8a,0xC9c5e854deB950063070fa319a4836964EDb863b
1876,15627845,84711,9576950619,84271,440,138,73,0x94235659cF8b805B2c658f9ea2D6d6DDbb17C8d7,0xfCDc25ba0D9D9C16A40506802a50C6c0870d5BC6
1877,15627845,356939,9576950619,346863,10076,3282,64,0x1111111254fb6c44bAC0beD2854e76F90643097d,0xc8E063FF9881781156D550b304c79C3A4867CB7d
1878,15627845,100000,9576950619,99036,964,202,88933,0xdAC17F958D2ee523a2206206994597C13D831ec7,0x3018018c44338B9728d02be12d632C6691E020d1
1879,15627845,169772,9576950619,169568,204,74,5,0x7F9306FC1978938d5C1C57Bf6044dc67E07eeB8a,0xe165A89069605f01Ef51F75Cc6C7BeDceBcB7b16
1880,15627845,169772,9576950619,169568,204,74,5,0x7F9306FC1978938d5C1C57Bf6044dc67E07eeB8a,0xB8a1e64faE3F1E5dD74b108Fb8Cd36257519A872
1881,15627845,169772,9576950619,169568,204,74,26,0x7F9306FC1978938d5C1C57Bf6044dc67E07eeB8a,0xB94D904958af759dca801769f0B7b1C679f0d9aE
1882,15627845,21000,9576950619,21000,0,2,34052,0x40995fd172C745559432b1ed5E753Dcaaee9a94f,0x126ACCDe9fA7cDc6Cc8dcaAe1f5071baAE8a732a
1883,15627845,21000,9576950619,21000,0,2,34053,0x4fAb5B0771F12013Ab8D54E1822Fea8F48240f02,0x126ACCDe9fA7cDc6Cc8dcaAe1f5071baAE8a732a
1884,15627845,21000,9576950619,21000,0,2,34054,0x9140B03C504Ec92BD62f619f226daE8C17D61cc4,0x126ACCDe9fA7cDc6Cc8dcaAe1f5071baAE8a732a
1885,15627845,21000,9576950619,21000,0,2,34055,0x86dFDb7Aa4c560AFFBd686fF939b5C60425FbE28,0x126ACCDe9fA7cDc6Cc8dcaAe1f5071baAE8a732a
1886,15627845,21000,9576950619,21000,0,2,34056,0xf3Ac9Be9e56a9f0DCfe5C10D10D502E81Eb4fa80,0x126ACCDe9fA7cDc6Cc8dcaAe1f5071baAE8a732a
1887,15627845,21000,9576950619,21000,0,2,34057,0xe3792A9c235D434B702023b33F03C48C41631090,0x126ACCDe9fA7cDc6Cc8dcaAe1f5071baAE8a732a
1888,15627845,21000,9576950619,21000,0,2,34058,0xa5bbEb2bCE3B3035Df4Aa1DEF996532CA29179af,0x126ACCDe9fA7cDc6Cc8dcaAe1f5071baAE8a732a
1889,15627845,21000,9576950619,21000,0,2,34059,0xFe177011Cd1C75AD5467aaE5F10Ff260E67B3Bdc,0x126ACCDe9fA7cDc6Cc8dcaAe1f5071baAE8a732a
1890,15627845,42000,9576950619,42000,0,2,329516,0x81281C405F0CCFf718383C45B2068d46B0400d15,0x9430801EBAf509Ad49202aaBC5F5Bc6fd8A3dAf8
1891,15627845,117738,9576950619,117534,204,74,2285,0x7F9306FC1978938d5C1C57Bf6044dc67E07eeB8a,0xED04d3792C439b8Af827B3e46EE626827De53Db5
1892,15627845,235564,9576950619,231960,3604,1162,185,0x68b3465833fb72A70ecDF485E0e4C7bD8665Fc45,0xb1e294784c75477333EA54C04D7DAb611fF76Dc9
1893,15627845,21000,9576950619,21000,0,2,2759936,0xAe31c0489D1b32F7d62435A6a93677d54d9B6bb8,0x267be1C1D684F78cb4F6a176C4911b741E4Ffdc0
1894,15627845,21000,9568296336,21000,0,2,146,0x6238872A0Bd9F0E19073695532a7Ed77ce93C69E,0x7e666c2F303B58796cAb1Ba0dd52120Eb8aFd17A
1895,15627845,275883,9568296336,273503,2380,586,45,0x53e0e51b5Ed9202110D7Ecd637A4581db8b9879F,0x0d9B3FEf8a3cd77Ba3d9d57ad9D15B76cdAe7cf2
1896,15627845,21000,9460000000,21000,0,2,0,0x6dfc34609a05bC22319fA4Cce1d1E2929548c0D7,0x7aBf7a4A6a59ac79104a2848BC3C80231bCe5226
1897,15627845,270754,9395252120,268534,2220,650,117896,0xA69babEF1cA67A37Ffaf7a485DfFF3382056e78C,0x26bce6eCb5b10138e4bf14aC0ffcc8727FEF3B2e
1898,15627845,560531,9256950619,548723,11808,3914,289,0xDEF171Fe48CF0115B1d80b88dc8eAB59176FEe57,0x17D065070486Ca0fC8b4B382b946BE79Fb4fF10D
1899,15627845,324898,9228450619,324898,0,2,122588,0x1c8F6A5F009E051CaB9C3851ca2DA2c936b2775A,0x1c8F6A5F009E051CaB9C3851ca2DA2c936b2775A
1900,15627845,324794,9228450619,324794,0,2,119827,0xeCa2e2D894D19778939bD4DfC34D2a3C45E96456,0xeCa2e2D894D19778939bD4DfC34D2a3C45E96456
1901,15627845,600000,9136454746,598744,1256,330,42,0x89B5919bCD78363B15A9C4CC25E90eE49c9caCbE,0x56bC281227E6B2A1C4F000286d25108006A577F3
1902,15627845,55706,9126950619,54762,944,138,60,0xaaAEBE6Fe48E54f431b0C390CfaF0b017d09D42d,0x51Dd6D50C0C46564a792028FDDf10E61573c0630
1903,15627845,284737,9076950619,279921,4816,1546,184,0x68b3465833fb72A70ecDF485E0e4C7bD8665Fc45,0x6BfE59e8fEaDDfBdBb97F7Da8c6B4550a8bD4ffd
1904,15627845,148046,9076950619,141446,6600,1802,104,0x00000000006c3852cbEf3e08E8dF289169EdE581,0x3b6915847D3c961de0f8BF994BeBb84A0e2f4929
1905,15627845,21000,9076950619,21000,0,2,863,0x215D54D0B98840017dC4103bABECE6E79d924cCA,0xA9E37368004605E856991a0A21ac766703429BD5
1906,15627845,46083,9076950619,45595,488,138,2474,0x8A5Aa86f426919Bf5146C23Aed4e4Eb0CE742eFd,0xA17138c0675173B8Ea506Fb1b96FA754BC316cc2
1907,15627845,21000,9076950619,21000,0,2,200,0x4205b76aed697f30b07b815C87d8AEC7997f93b7,0x5bAB06Aab8aEcD0E60c8287391233F2285ad7071
1908,15627845,46145,9076950619,45573,572,138,2316,0x3a70B2C9d86Df638EcaC4053607C4c67b9cccE41,0x87CEF391361A4168148333332fBd5D2C621D3252
1909,15627845,123368,9076950619,122796,572,138,96,0x3819f64f282bf135d62168C1e513280dAF905e06,0x6103922E0AEb8a574e09aB549191e5997DC12207
1910,15627845,170689,9076950619,170485,204,74,23,0x7F9306FC1978938d5C1C57Bf6044dc67E07eeB8a,0xaC7bfAF518dF5Ed84d352691820fA223fd0853E0
1911,15627845,964350,9076950619,874794,89556,31058,126,0x00000000006c3852cbEf3e08E8dF289169EdE581,0x8e9575faA5Afb0c55CbE3056636e4fE733953C13
1912,15627845,546511,9076950619,542895,3616,1162,606,0x68b3465833fb72A70ecDF485E0e4C7bD8665Fc45,0x0254b349c49D1c3375453140Be3674C028C81251
1913,15627845,111881,9076950619,111053,828,266,1186,0x283Af0B28c62C092C9727F1Ee09c02CA627EB7F5,0xcCc78D2a72FA509F6e6834599f01Be5864351157
1914,15627845,56667,9076950619,55723,944,138,501,0xB97Ad583dacB8Bd46F75b3593c6eF2ec598Ef37e,0x2b20bE9b4f67101D23EA30C15071E4bC41F03898
1915,15627845,48897,9076950619,47953,944,138,1330,0xdAC17F958D2ee523a2206206994597C13D831ec7,0x9a25d79AB755718e0b12BD3C927A010A543C2b31
1916,15627845,132505,9076950619,125921,6584,1698,311,0x00000000006c3852cbEf3e08E8dF289169EdE581,0x1bE7340d3067850824F54860aee9cb22ED78629e
1917,15627845,768644,9076950619,750980,17664,5642,28,0x0000000000c2d145a2526bD8C716263bFeBe1A72,0x9D606D13846861008e921A3C161395FE1AE5a155
1918,15627845,215918,9076950619,212266,3652,1162,696,0x68b3465833fb72A70ecDF485E0e4C7bD8665Fc45,0xf925AAc0A1ED544cfE4De58879ab2ffD4c72A009
1919,15627845,21000,9076950619,21000,0,2,69,0xEE4C722Da0aD1e2c4A2fe961E98dBc036Ff3197a,0xe3B703Ac71385C5Fee2244a49fd6D766BD233062
1920,15627845,118268,9076950619,116012,2256,650,27,0xC45f3c76FeeEa53aAE5AFA9b51F166E025145400,0xd67D5ed3a58b10fb6d468DB4718d4E9e8dF17419
1921,15627845,46160,9076950619,45672,488,138,634,0x8aE20BB9E02Bb7dB0669ba2232319A24D5856073,0x41df7Be8ff245E4fEE872C29bF8DBC1BA61E095e
1922,15627845,269640,9076950619,269340,300,74,75,0xc5DA1d9f361B5B9cd312ccF18C5c8F8eBe98eE61,0x5E96591aA52BDcD1C0d2ba2566e2d9490055dAcF
1923,15627845,351296,9076950619,347124,4172,1290,135,0x68b3465833fb72A70ecDF485E0e4C7bD8665Fc45,0x94F20436da7863b61f49f9E6a62b0033c2b2F7F3
1924,15627845,472000,9076950619,470728,1272,224,767,0x57C1e0C2ADf6EECDb135BcF9ec5F23b319be2c94,0xaF9Df30242b311F6C4C8F34A33adA2E783E74ADE
1925,15627845,429489,9076950619,429261,228,74,69,0x6c3810649c140d2f43Ec4D88B2f733e1375E4C74,0x06926D6F3812E34890f37ABDcE0A10a80af46f39
1926,15627845,55978,9076950619,55034,944,138,80,0xd4cB651749953988647eEE9b51DDB8DB5aeb3410,0x6db44a1B913B1Fb787Ee53Da3970CE7Fa0A8B7a4
1927,15627845,184335,9076950619,181131,3204,1034,5,0x68b3465833fb72A70ecDF485E0e4C7bD8665Fc45,0x26d91281e860E36bCEE5B86B29626219E7437821
1928,15627845,50000,9076950619,49308,692,138,191,0x1165Ce434377D9E0CafF79F9562B6cFC1C3d8Ea3,0x598E813106c2B87d7985Ad3bb83d4e14c1BF02AD
1929,15627845,183106,9076950619,180370,2736,650,29,0xfF20817765cB7f73d4bde2e66e067E58D11095C2,0xd90822d1D0668019Ece98e23e01c221886c21612
1930,15627845,46103,9076950619,45615,488,138,56,0x34Bc797F40Df0445c8429d485232874B15561728,0xB415541f923905B36B174A7ABf03Ad00539508A1
1931,15627845,61896,9076950619,60808,1088,138,7,0x5FDCCA53617f4d2b9134B29090C87D01058e27e9,0x702E9f185d6cDfD6b076d9Db3D10fBC27F75883c
1932,15627845,53945,9076950619,52993,952,202,1401,0x34913A375683474F0f3022655a07aa59cC848848,0x9d44C131E702AC25CEAD57943cEac7ecb35b7817
1933,15627845,21000,9076950619,21000,0,2,5,0x5A8A849A12242D804621Ef4d7e62F2d08104aA48,0xFE4E1E81081d7A351C3617626476cE571d10764E
1934,15627845,288189,9076950619,285841,2348,522,109,0x283Af0B28c62C092C9727F1Ee09c02CA627EB7F5,0x4D631b7130f4d6c46C5469d17D4B4aa9dE905378
1935,15627845,21000,9076950619,21000,0,2,291,0x424c0d0b13b9CEd6A5F0D8EEE1C1e0171857E98A,0x16612F2301A2a55c4D37C8ea295Ba7cB4071CD19
1936,15627845,245958,9076950619,242294,3664,1162,1146,0x68b3465833fb72A70ecDF485E0e4C7bD8665Fc45,0x1eaF03aF983d1e20B1BAb73964906c281e141D4f
1937,15627845,21000,9076950619,21000,0,2,219,0x5668F9a2E966E7A0d539dBd97be2DafBF53Cc6Ac,0x6432BD4d8C58526Ca2829b29736eA6ec76b71F27
1938,15627845,46194,9076950619,45706,488,138,797,0xbcE6D2aa86934AF4317AB8615F89E3F9430914Cb,0x28a0fb32Ae1190110800b4861eEe11Bf54FBBFF4
1939,15627845,60760,9076950619,59816,944,138,400,0xA0b86991c6218b36c1d19D4a2e9Eb0cE3606eB48,0x1CeD4e3900c73A54eD775ef2740a4e38aC5b54e2
1940,15627845,228160,9076950619,226924,1236,266,28,0xC36442b4a4522E871399CD717aBDD847Ab11FE88,0xc01f46f418B9D9BACDCaf9453E8F0f1ca818C925
1941,15627845,87117,9076950619,86437,680,138,79,0xdA1E53E088023Fe4D1DC5a418581748f52CBd1b8,0x519264BDCe23319C3eBFeC6723492B9fb96DF76b
1942,15627845,202247,9076950619,196175,6072,1682,0,0x00000000006c3852cbEf3e08E8dF289169EdE581,0x6760c5069bA8B597092f0304fAA50A3230A96dEF
1943,15627845,150756,9076950619,150692,64,10,7,0x65c2e54a4c75ff6da7b6B32369c1677250075fb2,0x11198068ff34a9E8ed4ABF8AE6Dc09Ce4F4DE841
1944,15627845,740000,9076950619,729040,10960,2506,43766,0x5E3c7bdf06C35f88c6c0De739ed1c04767e330F9,0xB5b90F596341127dE460465dEA9b28b8a6Bd1984
1945,15627845,123784,9076950619,122816,968,330,637,0x4e32004D8b81847A670b4a1778ACe4dCF2bBA01E,0x0bd3292Ab67D05187f0087C2e0Ae010518D4E830
1946,15627845,212475,9076950619,208811,3664,1162,8019,0x68b3465833fb72A70ecDF485E0e4C7bD8665Fc45,0x8E0D1481Fa42e85b5C4ADA8b170Cc9E498FBc947
1947,15627845,46149,9076950619,45661,488,138,520,0x4287BD7cC2B4aa8650e2887055A4674759C216E2,0xe96DEcB942b8B5C6bd57f08F146fcA12772cb1ef
1948,15627845,44845,9076950619,43957,888,266,3,0xFF1F2B4ADb9dF6FC8eAFecDcbF96A2B351680455,0x323383EE38c1F9eA332b3a52ba3D2Ad683ee2b1c
1949,15627845,232609,9076950619,228981,3628,1162,13,0x68b3465833fb72A70ecDF485E0e4C7bD8665Fc45,0x236A1bdD6c66c0e8d199a82AC79efe9d170E33a4
1950,15627845,169480,9076950619,168008,1472,522,15,0xdd2a7Be69600F7237A09DA6785Fb4fc30437316C,0x0d179E97531C2ee1b289C047D398Ecd50E4a60f8
1951,15627845,1337110,9076950619,1330118,6992,2058,63,0x000000000000509081d6FCD3ee63e791aD1db763,0xb90Af6078C786462aeFC440B0fD7F80B9e2C7786
1952,15627845,689810,9076950619,686146,3664,1162,269,0x68b3465833fb72A70ecDF485E0e4C7bD8665Fc45,0xfE598c8DBEA6d78Dd06AE537B8171695d075106E
1953,15627845,229521,9076950619,225869,3652,1162,64,0x68b3465833fb72A70ecDF485E0e4C7bD8665Fc45,0x30379F151e4FE4C50a3Fa15F797A34Db6374b10B
1954,15627845,312430,9041055943,306590,5840,1548,37,0x881D40237659C251811CEC9c364ef91dC08D300C,0x1f10F11365C571a921096Ade4b740593158BDFd0
1955,15627845,2000000,8958617298,1997952,2048,522,409,0x7a250d5630B4cF539739dF2C5dAcb4c659F2488D,0xC598DE2944734AF41EeB92dFD24Aac8803aDca0E
1956,15627845,21000,8915500000,21000,0,2,2,0x562680a4dC50ed2f14d75BF31f494cfE0b8D10a1,0xdf962dd1a32aEBbd7F8c2DFA12aE4364621638d3
1957,15627845,70000,8822164612,69392,608,138,520,0xdAC17F958D2ee523a2206206994597C13D831ec7,0xf5491f793D47A6Ea22f5e0B9AD3990CF66c4b40B
1958,15627845,50000,8699000000,49332,668,138,0,0xdAC17F958D2ee523a2206206994597C13D831ec7,0xe3C2Cd625F79c981f65B10C29c810dD18fb8621b
1959,15627845,120000,8576950619,119392,608,138,0,0xdAC17F958D2ee523a2206206994597C13D831ec7,0x6520341A757310371085e3D8004C50ad1f3FFeFc
1960,15627845,21000,8576950619,21000,0,2,8344,0x4938df248CFd0F259c561Fa5c1d95Af32275DD8e,0x770E66bf008C0204a8231F4ea5C3Af12e5f580e4
1961,15627845,84000,8576950619,83392,608,138,24277,0xA0b86991c6218b36c1d19D4a2e9Eb0cE3606eB48,0xeA3d9B4743e20CE41777149A16e4eC97185d1487
1962,15627845,36027,8576950619,35751,276,74,15,0xC02aaA39b223FE8D0A0e5C4F27eAD9083C756Cc2,0xd463632A0E8618995fe4c2809856E97d0E52C028
1963,15627845,21000,8576950619,21000,0,2,102634,0x56Aa3fe61A40d8D8d476253C47E488a26b507B36,0x2Db1D8CdF1Abe8C70b531a790CDf2FF38aecF652
1964,15627845,21000,8576950619,21000,0,2,15,0xAe31Ce872C5923e6229e5CdBf6f2c1a05e39ABEB,0x5DdbA4A2586Dc6Eb4393fdd30f6AD530a97685Ca
1965,15627845,113310,8576950619,113106,204,74,331,0x5D004ddB5D92938dAF8448b9eac1CaA593cd26Ca,0x26DC5D39Bd7A8bc2d792dcAAAC55FE6DCef25593
1966,15627845,396843,8576950619,393239,3604,1162,261,0x68b3465833fb72A70ecDF485E0e4C7bD8665Fc45,0x6F6d381EAA241A96dfA3816fCE8AAcB67D21Ba95
1967,15627845,113310,8576950619,113106,204,74,332,0x5D004ddB5D92938dAF8448b9eac1CaA593cd26Ca,0x26DC5D39Bd7A8bc2d792dcAAAC55FE6DCef25593
1968,15627845,56659,8576950619,55715,944,138,55,0xAD13C2a8d418d01F3236F4d8b9d724575a4e9d24,0xB5e47aF6038a24A54964b8D9411E2AbC66bd0222
1969,15627845,62507,8480000000,61863,644,138,31,0x514910771AF9Ca656af840dff83E8264EcF986CA,0xAFF9493Ac4A08480f2A6f600Fe8dD3B797b57e08
1970,15627845,147661,8375745197,147445,216,74,168,0x03893669C978033544a160718E3d1a3226845de6,0xCEF557e276AE24293904BA0F2bbbD1FBa8Ef3338
1971,15627845,662836,8312226570,655672,7164,1652,6570,0x0000000000007F150Bd6f54c40A34d7C3d5e9f56,0xA30622a0061513B1B6971307b66E8ba4c4F52f3c
1972,15627845,21000,8144197544,21000,0,2,13,0x974CaA59e49682CdA0AD2bbe82983419A2ECC400,0x00A4D0c83365E7b5fa1deAF5E27191E48249b41f
1973,15627845,150000,8101718836,149748,252,74,638774,0xA0b86991c6218b36c1d19D4a2e9Eb0cE3606eB48,0x55FE002aefF02F77364de339a1292923A15844B8
1974,15627845,258822,8058937112,255582,3240,1034,130,0x68b3465833fb72A70ecDF485E0e4C7bD8665Fc45,0x9AF085059D7C9e4B129F41DaCe749d15201fF504
1975,15627845,46157,8058937112,45669,488,138,71,0x79Aa05963c92A2a10d96bD840Eb5e73a1E675E92,0xD4C8811025d20C7E7219d0C4704AACbbd8bA9F4F
1976,15627845,244000,8058937112,243048,952,202,109,0xF59B70D31Dd2a7ce2FdFB0a9326988dF6cc58ec9,0x7fAeF9b8a8798c8EdaD02a3bbC9e627e5CD68AF8
1977,15627845,298225,8058937112,295429,2796,842,49,0x68b3465833fb72A70ecDF485E0e4C7bD8665Fc45,0x5fE50e298Ab5e216a5F473424EdE56Ae48790a0B
1978,15627845,88728,8058937112,88048,680,138,73,0xeD35af169aF46a02eE13b9d79Eb57d6D68C1749e,0xDCde4Ec1A00cceAB37237D06Fec20c2Dd5e84FC6
1979,15627845,180000,8000000000,179392,608,138,444360,0xaD22f63404f7305e4713CcBd4F296f34770513f4,0x48c04ed5691981C42154C6167398f95e8f38a7fF
1980,15627845,1583754,7771282210,1583410,344,138,19,0xF403C135812408BFbE8713b5A23a04b3D48AAE31,0xab646C11a604E61B60C573e7B340bAAC93bE61fC
1981,15627845,324411,7764419574,159539,164872,20800,183241,0x5E4e65926BA27467555EB562121fac00D24E9dD2,0x6887246668a3b87F54DeB3b94Ba47a6f63F32985
1982,15627845,70000,7746462550,69056,944,138,8,0xdAC17F958D2ee523a2206206994597C13D831ec7,0xBc2eF17D0243b9ddeeaB5C5C5E06E71c40f36313
1983,15627845,25106,7746462550,23282,1824,458,218,0xEfF92A263d31888d860bD50809A8D171709b7b1c,0xC3685D3B1e380677AbbD7d62EF32eaCa851C902C
1984,15627845,48518,7746462550,47530,988,202,890778,0xdAC17F958D2ee523a2206206994597C13D831ec7,0x340d693ED55d7bA167D184ea76Ea2Fd092a35BDc
1985,15627845,191077,7746462550,190177,900,266,869,0xd588b586D61C826A0e87919b3D1a239206d58bf2,0x9FC319E0259DE9D57AAb2249e1792AB97Db3A901
1986,15627845,34881,7746462550,34321,560,138,24,0xf5b1Fd29d23e98Db2D9EBb8435E1082e3B38FB65,0x62B3B1BDf247a5624bC7e4B2Ecd4E16Ad926Ce50
1987,15627845,26000,7576950619,26000,0,2,12020,0xeBec795c9c8bBD61FFc14A6662944748F299cAcf,0xDAFEA492D9c6733ae3d56b7Ed1ADB60692c98Bc5
1988,15627846,634739,27819633000,618391,16348,4618,65,0x617Dee16B86534a5d792A4d7A62FB491B544111E,0x096Ff5Adf4176747017f20Ab4EAaB22f60A38E99
1989,15627846,55923,27000000000,54979,944,138,656,0xD309A8d0498Cc73f53481e46094DC0d3aaB0d9dd,0x00B81C48d7820d1AC0668eFc77a336811516463c
1990,15627846,276966,26533443312,274662,2304,650,96397,0xA69babEF1cA67A37Ffaf7a485DfFF3382056e78C,0xBbAD96336943A36E3e292D973B3382dd0bA4D1EF
1991,15627846,276942,26437389481,274638,2304,650,111040,0xA69babEF1cA67A37Ffaf7a485DfFF3382056e78C,0x36a454aEF52938c8637CD4689B2980C1Cfd43389
1992,15627846,21014,26420451186,21014,0,2,134153,0x8e8f818d3371F797A2Db7eDB32803607c8b3c6A9,0x8e8f818d3371F797A2Db7eDB32803607c8b3c6A9
1993,15627846,257602,21909688882,256322,1280,264,12411,0xBEEFBaBEeA323F07c59926295205d3b7a17E8638,0xF92DC08D81900626aC56edf96E2f3802615605F1
1994,15627846,146694,15000000000,140222,6472,1738,247,0x00000000006c3852cbEf3e08E8dF289169EdE581,0x92e2316186d5406ba37193c054e0752de7b74a33
1995,15627846,70824,12788323105,69880,944,138,28,0x9431DE2DFE10BDB30995bd3791dE03a6c9570054,0x34b8404Bc449bFe7891C1Bd648d9559057Cc59F8
1996,15627846,70824,12788323105,69880,944,138,223,0x9431DE2DFE10BDB30995bd3791dE03a6c9570054,0x2cF962479895De592aE1f1d338caED65949c99E1
1997,15627846,21000,12288219300,21000,0,2,1,0x2FAF487A4414Fe77e2327F0bf4AE2a264a776AD2,0xc7590D96E20E91C20a84113F4A9370eae31dE93e
1998,15627846,21000,12288219300,21000,0,2,2,0x2FAF487A4414Fe77e2327F0bf4AE2a264a776AD2,0x11576f229D3d3aD1b6372271FC1298646aB30204
1999,15627846,21000,12254967484,21000,0,2,0,0xC098B2a3Aa256D2140208C3de6543aAEf5cd3A94,0x16315c15d23545b1267510a6363958E83369b9F5
2000,15627846,76564,11503744557,75944,620,138,4709903,0xA0b86991c6218b36c1d19D4a2e9Eb0cE3606eB48,0x2FAF487A4414Fe77e2327F0bf4AE2a264a776AD2
2001,15627846,62930,11511159534,61906,1024,202,4709904,0x6B175474E89094C44Da98b954EedeAC495271d0F,0x2FAF487A4414Fe77e2327F0bf4AE2a264a776AD2
2002,15627846,21000,11000000000,21000,0,2,508308,0x118630295d65715d69CbB2adC99cf94c642E1d77,0x39F6a6C85d39d5ABAd8A398310c52E7c374F2bA3
2003,15627846,850000,10788323105,848072,1928,522,97,0x7a250d5630B4cF539739dF2C5dAcb4c659F2488D,0x555c9F6e96A9D05938AC6ab0D095112321a0aD5a
2004,15627846,21000,10644197544,21000,0,2,0,0x4945cE2d1B5BD904CAc839b7FDAbAfd19Cab982b,0x7Dcc6EAab8831f30188D40c460C6F80F7C0FF479
2005,15627846,21000,10644197544,21000,0,2,0,0x4945cE2d1B5BD904CAc839b7FDAbAfd19Cab982b,0x526d0504dC4cC4eB42115a34Ab0672842Bcc6207
2006,15627846,21000,10644197544,21000,0,2,0,0x4945cE2d1B5BD904CAc839b7FDAbAfd19Cab982b,0x7C83248eaD6C6ED63a2675C2EEa7DD7Df2674bbF
2007,15627846,21000,10644197544,21000,0,2,1,0x4945cE2d1B5BD904CAc839b7FDAbAfd19Cab982b,0x99766A17ecd40f4300373f985Ef9eA668fc7d161
2008,15627846,21000,10644197544,21000,0,2,1,0x4945cE2d1B5BD904CAc839b7FDAbAfd19Cab982b,0x1c9238cE25670101e56993210F34b65cab9585cE
2009,15627846,21000,10644197544,21000,0,2,0,0x4945cE2d1B5BD904CAc839b7FDAbAfd19Cab982b,0xc426a404474119Dca3b7c189430C238e9cEa9857
2010,15627846,21000,10644197544,21000,0,2,0,0x4945cE2d1B5BD904CAc839b7FDAbAfd19Cab982b,0xc8924f82d80567ebEDF405E13D4368bfb2DED09d
2011,15627846,21000,10644197544,21000,0,2,1,0x4945cE2d1B5BD904CAc839b7FDAbAfd19Cab982b,0xb891614BaE4C3D4cC51519625936F626aA12448f
2012,15627846,21000,10580000000,21000,0,2,270,0x51300b2DC9438480802e1249B1822a17ccFAdB00,0x2Bb1EB5140A4154B240b85EB07A469238a3a956b
2013,15627846,143796,10288323105,143592,204,74,183,0x7F9306FC1978938d5C1C57Bf6044dc67E07eeB8a,0xDB25A9245fc21D98bD79bF1b1e529a96EF78EaaA
2014,15627846,146784,10288323105,146580,204,74,386,0x7F9306FC1978938d5C1C57Bf6044dc67E07eeB8a,0xfCB0637C8011F1fd55DE40FaFDB7C26c40533083
2015,15627846,90000,10229329510,90000,0,2,784404,0x0A9c4BDEe89a9318881441f6a99105fbdda0A025,0xcaD621da75a66c7A8f4FF86D30A2bF981Bfc8FdD
2016,15627846,90000,10229329510,90000,0,2,784405,0xd35A3dc146d9238B12E9868280448B1019BA0522,0xcaD621da75a66c7A8f4FF86D30A2bF981Bfc8FdD
2017,15627846,100000,10229329510,99356,644,138,1050380,0x3845badAde8e6dFF049820680d1F14bD3903a5d0,0xf16E9B0D03470827A95CDfd0Cb8a8A3b46969B91
2018,15627846,90000,10229329510,90000,0,2,784406,0xFde166416b94C92A98966833c71c3AD3E209f8Bf,0xcaD621da75a66c7A8f4FF86D30A2bF981Bfc8FdD
2019,15627846,158844,10200000000,152984,5860,1930,14398,0xEDe26cCC85ae521D06B5eF2604952a421c9124b6,0xb790b51A8229a3E0cD566De2FDdDB498a318D9e9
2020,15627846,21000,10190000000,21000,0,2,4,0x6dfc34609a05bC22319fA4Cce1d1E2929548c0D7,0x3A688518e7f61bAcE9b757C41C05231d36Be84e1
2021,15627846,69000,10188323105,68512,488,138,301,0xbef7Dcc0335Ec876e2DC530b883F34c8807d61fc,0xACafB137AD8139f338ba476131e8dBc5D98FaD9A
2022,15627846,153322,9842407676,153258,64,10,4,0xC7757805B983eE1b6272c1840c18e66837dE858E,0x0eC70AcdcDB05C1F512A1c9237708663BBAe7172
2023,15627846,384648,9788323105,381032,3616,970,447,0x68b3465833fb72A70ecDF485E0e4C7bD8665Fc45,0x263835b05ad8972731083fa2751aCd438e6B768e
2024,15627846,46267,9788323105,45691,576,74,88,0x283Af0B28c62C092C9727F1Ee09c02CA627EB7F5,0x41Ad5F539133Dc08b22D55098a855a0b95de85cF
2025,15627846,21000,9788323105,21000,0,2,34060,0x49710476eeF14761f3ceDACaC944ec8693f993E8,0x126ACCDe9fA7cDc6Cc8dcaAe1f5071baAE8a732a
2026,15627846,21000,9788323105,21000,0,2,34061,0x2e3d21e2FD06853aE29c24ec981abD59234a0b9b,0x126ACCDe9fA7cDc6Cc8dcaAe1f5071baAE8a732a
2027,15627846,21000,9788323105,21000,0,2,34062,0x59055575603638EE7cBDbac792AC93B4966B89A2,0x126ACCDe9fA7cDc6Cc8dcaAe1f5071baAE8a732a
2028,15627846,200927,9788323105,189971,10956,2570,766,0x0000000000c2d145a2526bD8C716263bFeBe1A72,0xB34D2BA72621D1aC89Edc2cCCcbcAa36869c9d5f
2029,15627846,42000,9788323105,42000,0,2,329517,0x14cc958b85f4B9f8C0fEa964fEF641283886758b,0x9430801EBAf509Ad49202aaBC5F5Bc6fd8A3dAf8
2030,15627846,21000,9788323105,21000,0,2,2,0x81b3eB90e343b1C1939a061A028F932eF4336A06,0x9b0aA97cA99C28CA63a818AE49668d7Ef460409F
2031,15627846,21000,9788323105,21000,0,2,72340,0x113478641A02913Cf123bfF4f9C99Df6CEA4d267,0xab97925eB84fe0260779F58B7cb08d77dcB1ee2B
2032,15627846,21000,9788323105,21000,0,2,72341,0xB55982bEa848240314C8F2968b32FF3BF21aBb57,0xab97925eB84fe0260779F58B7cb08d77dcB1ee2B
2033,15627846,123884,9398323105,121584,2300,594,1480,0xDef1C0ded9bec7F1a1670819833240f027b25EfF,0x96d5F564D347496f3217c2649599Bef3a1AD59Bc
2034,15627846,21000,9338323105,21000,0,2,76,0x9afEf63384A707f8ba9AC4F09638267C6135091F,0xa7de08C1fF5Bf1ff3475f8bCF70Ff1D2352463e9
2035,15627846,21000,9288323105,21000,0,2,54,0xacdaEEb57ff6886fC8e203B9Dd4C2b241DF89b7a,0x58d057a9F7b5825f3aCeEFB3af79e6E1baCdF4e9
2036,15627846,146986,9288323105,140386,6600,1802,695,0x00000000006c3852cbEf3e08E8dF289169EdE581,0xFEdcA2b03932262C0c969593e7B65F7162Bf6a53
2037,15627846,150147,9288323105,143571,6576,1802,57,0x00000000006c3852cbEf3e08E8dF289169EdE581,0x79C34401Ce9D13bF51b4374Be074f645f73223eD
2038,15627846,60005,9288323105,58005,2000,450,1,0x4D9079Bb4165aeb4084c526a32695dCfd2F77381,0x293D3b85d7d151B64135CCd1470A4440e9247e72
2039,15627846,68852,9288323105,68528,324,74,14,0xB4a81261b16b92af0B9F7C4a83f1E885132D81e4,0x27Cda06B00a0ecCF4225371792DdE8f1a5eA97EB
2040,15627846,54484,9288323105,53892,592,202,79,0x084b1c3C81545d370f3634392De611CaaBFf8148,0x7dA4dD4Fd00E58222e55553f8D8196dd3379f44F
2041,15627846,806590,9288323105,803426,3164,906,1454,0x68b3465833fb72A70ecDF485E0e4C7bD8665Fc45,0x43C1Bf1a33506d2d3f023a1F354e608e7784aC46
2042,15627846,99262,9288323105,98642,620,138,5,0xA0b86991c6218b36c1d19D4a2e9Eb0cE3606eB48,0xA5D2ECB35D5AFb78580955a2f3f9c57610063d3f
2043,15627846,410023,9288323105,406443,3580,1162,854,0x68b3465833fb72A70ecDF485E0e4C7bD8665Fc45,0xb6047B161F5fC557e28376dD9BCb2cF01647b159
2044,15627846,328423,9288323105,325223,3200,906,227,0x68b3465833fb72A70ecDF485E0e4C7bD8665Fc45,0xa7C1d32B4bB7155Ad5e9e53F472b9CE61BB37ddc
2045,15627846,288948,9288323105,286516,2432,522,581,0x283Af0B28c62C092C9727F1Ee09c02CA627EB7F5,0x62764715edAC8396C76E8704Ae86509b23b523A2
2046,15627846,99774,9288323105,97906,1868,330,488,0x000000000000509081d6FCD3ee63e791aD1db763,0x2BE70B7789C51979E98112B32A554b93A213dbe4
2047,15627846,177465,9288323105,174717,2748,842,745,0x68b3465833fb72A70ecDF485E0e4C7bD8665Fc45,0x8EEA1d4C3C6d29C2E2B312FB0e7d4c81aF87DfdE
2048,15627846,46619,9288323105,46131,488,138,2475,0x62365089075e3FC959952134c283e0375b49F648,0xA17138c0675173B8Ea506Fb1b96FA754BC316cc2
2049,15627846,46547,9288323105,46059,488,138,95,0xaE351b8Ae55B69A5007618E598dDe89d0a092c37,0x9F7384Eb8705DAb8bd769Df6499644854DcB32bA
2050,15627846,215174,9288323105,212402,2772,842,4209,0x68b3465833fb72A70ecDF485E0e4C7bD8665Fc45,0x4Ed952edDB2DF5EcB924Cab763cC926f10F3F070
2051,15627846,216772,9288323105,213144,3628,1162,191,0x68b3465833fb72A70ecDF485E0e4C7bD8665Fc45,0x6c2031D375C72EC038a09Ca0eBefE8822A1C235f
2052,15627846,236380,9288323105,233584,2796,842,476,0x68b3465833fb72A70ecDF485E0e4C7bD8665Fc45,0x4bBDEc9fBbaEFc56b3b12d60605766552a8B35eF
2053,15627846,49267,9288323105,48779,488,138,538,0x7DF64F69544c5bf71171dc5ab69b8602C2FF1E27,0x233FE1301D54b9bD68E87a367142E8292a0A444d
2054,15627846,298225,9288323105,295429,2796,842,77,0x68b3465833fb72A70ecDF485E0e4C7bD8665Fc45,0x5207C8D3C61b6eC0e17b58444b520834B868261F
2055,15627846,55861,9288323105,54917,944,138,490,0xC5a9BC46A7dbe1c6dE493E84A18f02E70E2c5A32,0xB047680e18b6dAD110883A08C9A73D655De9B8A8
2056,15627846,150000,9288323105,149116,884,330,890,0x556697Ca91476B811f37A851dD2e53ae4c6024dB,0x207b8aF4f163e40400aC8e4a172CEE888D043B99
2057,15627846,55978,9288323105,55034,944,138,85,0xd4cB651749953988647eEE9b51DDB8DB5aeb3410,0x5B3E4b5E3C06C7B2024657494C546A5b6609147b
2058,15627846,21000,9288323105,21000,0,2,151,0x9476aed77Db00a375dd75cD3b5D6031E4EB3070A,0x20acb94B726d8B2E7b83D11F15ceE344eDB00270
2059,15627846,131101,9288323105,125161,5940,1610,499,0x00000000006c3852cbEf3e08E8dF289169EdE581,0x003EF9575e9535636651c0C15ea376266DAA09F8
2060,15627846,46267,9288323105,45691,576,74,339,0x283Af0B28c62C092C9727F1Ee09c02CA627EB7F5,0x0e05FC263cB57dB89aa9f32cc3f4743244520c45
2061,15627846,21000,9288323105,21000,0,2,7,0xe2E73ea2714a85b51ec189d2219CeFa72e9FF448,0xbb0550F809Dc7Fb17A271E3C6f2aa9873fb15Bd5
2062,15627846,250547,9288323105,230879,19668,7178,209,0x00000000006c3852cbEf3e08E8dF289169EdE581,0x56B283376f770713D1B77BcF9481bE26812950aA
2063,15627846,69145,9288323105,68549,596,138,48,0xdAC17F958D2ee523a2206206994597C13D831ec7,0x37C4F5C7bc4B621fc33765C44293f8B852469eC2
2064,15627846,303983,9288323105,289375,14608,5386,1754,0x83C8F28c26bF6aaca652Df1DbBE0e1b56F8baBa2,0x58CD21074A9Db3fd87366e0D3eB9FB300dFEd120
2065,15627846,49175,9288323105,48687,488,138,557,0xeF3739eE528B8D74D0C2a906Aa469C67233c6B44,0x6b1Fd5D876771b764D0131746dF48C1054e37f73
2066,15627846,78556,9288323105,77900,656,138,199,0x12b6893cE26Ea6341919FE289212ef77e51688c8,0xf9F5B8431c3868D4adf09F159480d3224896Af2E
2067,15627846,285326,9288323105,282530,2796,842,665,0x68b3465833fb72A70ecDF485E0e4C7bD8665Fc45,0xCaBA18AE3eD72886b64BFc24e79CD7A98137e536
2068,15627846,198586,9006871312,196970,1616,402,95,0x1111111254fb6c44bAC0beD2854e76F90643097d,0xB49f3Da1F3A7F9E541A66dCaaEc00EdF3d224455
2069,15627846,66163,9000000000,65555,608,138,1,0xA0b86991c6218b36c1d19D4a2e9Eb0cE3606eB48,0xeDF3263990ba71Db45cD9Dfb6774abE5cB57AFC6
2070,15627846,242472,8889323105,242472,0,2,100935,0x431B5A84aCC1297Eda88259f300262F1bc3A74f3,0x431B5A84aCC1297Eda88259f300262F1bc3A74f3
2071,15627846,252790,8889323105,250546,2244,650,131294,0xA69babEF1cA67A37Ffaf7a485DfFF3382056e78C,0x60b86AF869f23aEb552fB7F3CaBD11B829f6Ab2F
2072,15627846,113310,8788323105,113106,204,74,333,0x5D004ddB5D92938dAF8448b9eac1CaA593cd26Ca,0x26DC5D39Bd7A8bc2d792dcAAAC55FE6DCef25593
2073,15627846,43110,8788323105,42846,264,74,4,0x4556561740B7B5F858967A6a4E54e506609704Bd,0x90080f967bfF98761cB1A6cb26EDdcd247aBc574
2074,15627846,166196,8788323105,159608,6588,1802,1477,0x00000000006c3852cbEf3e08E8dF289169EdE581,0xD710c25b900C6827352001c98aDFf4E702533eFC
2075,15627846,113310,8788323105,113106,204,74,334,0x5D004ddB5D92938dAF8448b9eac1CaA593cd26Ca,0x26DC5D39Bd7A8bc2d792dcAAAC55FE6DCef25593
2076,15627846,175110,8788323105,173546,1564,394,521,0x1Fa8559e873f698292766790AeCf8080A66433F6,0x13c7EE16Ebd8a2f34dF4D24af490Cb35c2E726f8
2077,15627846,113310,8788323105,113106,204,74,335,0x5D004ddB5D92938dAF8448b9eac1CaA593cd26Ca,0x26DC5D39Bd7A8bc2d792dcAAAC55FE6DCef25593
2078,15627846,261146,8270309598,257458,3688,1162,87,0x68b3465833fb72A70ecDF485E0e4C7bD8665Fc45,0xB74b76E1694D0830A40867212Ab7b057f1FE59bF
2079,15627846,66836,8144197544,65892,944,138,137,0xA0b86991c6218b36c1d19D4a2e9Eb0cE3606eB48,0xa043720AA3e49F6898E1223d760b12ECAD5242D9
2080,15627846,152989,8000000000,150229,2760,842,23,0x68b3465833fb72A70ecDF485E0e4C7bD8665Fc45,0x778940B1035e8B1C9Df255B05fe687e33197D50f
2081,15627846,288858,7956728589,285178,3680,906,0,0x197492CCB4B1acaAAcd43432657A17832E36AB49,0x31aBd5958b1C6fB0f85A5F700B5d4fc50cC9c6af
2082,15627847,350000,64856779007,348740,1260,266,33023,0x00000000ad3FB067501751e1176c9105d6a47CEc,0x1Afa018d9Be65B0Eac856340d919c4526C168FF8
2083,15627847,250000,53000000000,250000,0,2,18570,0x01c86E27fEdf5C233Eb035a274B80AdBd7c801D6,0x41b309236C87b1bc6FA8Eb865833E44158Fa991a
2084,15627847,120000,31427285394,119392,608,138,126774,0xdAC17F958D2ee523a2206206994597C13D831ec7,0x87cbc48075d7aa1760Ac71C41e8Bc289b6A31F56
2085,15627847,48780,20000000000,48184,596,138,28,0xA0b86991c6218b36c1d19D4a2e9Eb0cE3606eB48,0x99F8503325677D39fD410B1F82cc10Bc69368221
2086,15627847,5049304,17000000000,5042216,7088,1098,278,0x0a39DA505DfB5E0BBc6bd84428281A8ba1bC7753,0x495E889d1A6cEB447a57dcc1C68410299392380c
2087,15627847,153855,15000000000,152815,1040,330,1092,0x6D7c44773C52D396F43c2D511B81aa168E9a7a42,0x052B52deB866d3878943484F778303e494F3D260
2088,15627847,21000,12288219300,21000,0,2,3,0x2FAF487A4414Fe77e2327F0bf4AE2a264a776AD2,0x174dCAe5d9b64369cdD846B99cEDF13e156a4539
2089,15627847,21000,12288219300,21000,0,2,1,0x2FAF487A4414Fe77e2327F0bf4AE2a264a776AD2,0x43CB0fD33B4B472217BCf10CE3471ac3b9F36a8a
2090,15627847,21000,11137545708,21000,0,2,134,0xCBD6832Ebc203e49E2B771897067fce3c58575ac,0xB3cFe697c31c76D0C61eF7a25E14f4B8A1279796
2091,15627847,21000,11137545708,21000,0,2,43,0xCBD6832Ebc203e49E2B771897067fce3c58575ac,0xfDA65B9412b1a4c9eEc57F19769B26E5C338F94b
2092,15627847,68682,11076987002,67670,1012,202,4709905,0x9AB7bb7FdC60f4357ECFef43986818A2A3569c62,0x2FAF487A4414Fe77e2327F0bf4AE2a264a776AD2
2093,15627847,76676,11076987002,75732,944,138,2,0xdAC17F958D2ee523a2206206994597C13D831ec7,0x7a490EaFbC3E0b0250D1dC2b6264A917343bCA38
2094,15627847,73749,11076987002,72805,944,138,0,0x6B175474E89094C44Da98b954EedeAC495271d0F,0xbbbe43473Da815357f7EC7234e4f1340861A5D93
2095,15627847,21000,10644197544,21000,0,2,0,0x4945cE2d1B5BD904CAc839b7FDAbAfd19Cab982b,0xCd16820Dcfa7Af454bd4850304AB39a226123760
2096,15627847,21000,10644197544,21000,0,2,0,0x4945cE2d1B5BD904CAc839b7FDAbAfd19Cab982b,0x22EEadA974cD5682A6e6670D130EFF790Daf70Ec
2097,15627847,21000,10644197544,21000,0,2,0,0x4945cE2d1B5BD904CAc839b7FDAbAfd19Cab982b,0x8Bd8829B5C6d8be9bcB4F719d326952781BA46dE
2098,15627847,21000,10644197544,21000,0,2,0,0x4945cE2d1B5BD904CAc839b7FDAbAfd19Cab982b,0xc0A7bE690369B1156f2FDe37EcAfa4A7b310422e
2099,15627847,21000,10644197544,21000,0,2,0,0x4945cE2d1B5BD904CAc839b7FDAbAfd19Cab982b,0x1243Dd50E809dcd2ca5d1766f8e38b59c7D7686b
2100,15627847,21000,10644197544,21000,0,2,0,0x4945cE2d1B5BD904CAc839b7FDAbAfd19Cab982b,0x06121F13Ef26a29345c84570F461651B3104cB85
2101,15627847,225849,10000000000,223789,2060,522,829,0xEfF92A263d31888d860bD50809A8D171709b7b1c,0x86F74E95b546984B9a197BE4902a06Eef483d168
2102,15627847,143796,9854150573,143592,204,74,17,0x7F9306FC1978938d5C1C57Bf6044dc67E07eeB8a,0x75646014293177849f306221e48654bA22C2c554
2103,15627847,143796,9854150573,143592,204,74,9,0x7F9306FC1978938d5C1C57Bf6044dc67E07eeB8a,0xd22a1537c53370EbA008333E56A33c91A6f8bc79
2104,15627847,21000,9574327235,21000,0,2,3,0x24bF872EB0E85263B528Afdf8a310D30005ADd36,0xB8175C038BF1b8D5Ce69679532C1d4b3b90C3837
2105,15627847,142249,9354150573,135673,6576,1802,199,0x00000000006c3852cbEf3e08E8dF289169EdE581,0xDB11249D40E05c050348ecA59cF90Fdd6b161aCb
2106,15627847,141959,9354150573,136051,5908,1738,58,0xDef1C0ded9bec7F1a1670819833240f027b25EfF,0xcc8992DcA072330ACC2E0DCC13d67edf27ddCf32
2107,15627847,250000,9354150573,247952,2048,522,247583,0x7a250d5630B4cF539739dF2C5dAcb4c659F2488D,0xBf5Ae133b9A0fc1A07952A7df2aFa21F7F69EF58
2108,15627847,245443,9354150573,240139,5304,1484,175,0x881D40237659C251811CEC9c364ef91dC08D300C,0xA9FE7dCdb35B7921BeDA5BE139eB7b6c218B7E96
2109,15627847,49542,9354150573,49478,64,10,0,0xC02aaA39b223FE8D0A0e5C4F27eAD9083C756Cc2,0x06F2b82b571F2a0f932763cAF8a21f3B7D6c8F80
2110,15627847,33600,9354150573,33600,0,2,15,0x1c5C6c0645f6BD274e61f43cC9808ff62265Ae71,0x8943C2Ec132A65E6b78d7B84222A620f9510cCC9
2111,15627847,740000,9238405376,729220,10780,2506,49054,0xA27CfD69345a6e121284a3C0ae07BB64b707cDD2,0x5a6fCc02D8c50eA58a22115A7c4608b723030016
2112,15627847,81532,9000000000,80876,656,138,0,0x3506424F91fD33084466F402d5D97f05F8e3b4AF,0xf0dF1d20DD33c82904ABEd7F2a141447d922338e
2113,15627847,90000,9000000000,90000,0,2,449975,0x1839Ec5a53E3501B3F87154eA96e786089c00a99,0x077D360f11D220E4d5D831430c81C26c9be7C4A4
2114,15627847,189062,8904150573,185506,3556,1162,61,0x68b3465833fb72A70ecDF485E0e4C7bD8665Fc45,0x51Dd6D50C0C46564a792028FDDf10E61573c0630
2115,15627847,21000,8854150573,21000,0,2,50,0x3FaA52835BcfD90BBC441DED3a380C780913eFf2,0x4Aa4C101E5a0B105648bc8996891Cc9D2aFbb9E8
2116,15627847,377066,8854150573,373474,3592,1162,3,0x68b3465833fb72A70ecDF485E0e4C7bD8665Fc45,0xf984500D009834046c618AeB16AfA77A6F08E29E
2117,15627847,123784,8854150573,122816,968,330,95,0x4e32004D8b81847A670b4a1778ACe4dCF2bBA01E,0x066DC123977849dF818ed709B375E73123E45179
2118,15627847,146974,8854150573,140374,6600,1802,79,0x00000000006c3852cbEf3e08E8dF289169EdE581,0xCBcA1F85F05fAD8F199dAD9b4fef1F2867ce2E2e
2119,15627847,213777,8854150573,211017,2760,842,62,0x68b3465833fb72A70ecDF485E0e4C7bD8665Fc45,0x7A5eA59C9F41a94a8956063256d41A2b98E066F2
2120,15627847,598166,8854150573,594278,3888,1226,49,0xC36442b4a4522E871399CD717aBDD847Ab11FE88,0x67d23b6f5E652F637c2f168a85BA6327BA529A70
2121,15627847,259644,8854150573,256824,2820,842,9,0x68b3465833fb72A70ecDF485E0e4C7bD8665Fc45,0x2383281b534d3Ca72D46F5A0570c7D4B68f12E01
2122,15627847,43986,8854150573,43558,428,138,12,0xcDA72070E455bb31C7690a170224Ce43623d0B6f,0x16BA96fEAC14743CAFe73Ec74f1F2536E23d8f01
2123,15627847,214674,8854150573,212242,2432,522,41,0x283Af0B28c62C092C9727F1Ee09c02CA627EB7F5,0x466a9935322BC74bF2A332D4aA736D46B5fa45fE
2124,15627847,56659,8854150573,55715,944,138,3,0xAD13C2a8d418d01F3236F4d8b9d724575a4e9d24,0xB4d60E7EbCaA8B0b8859e75Ad68E6F41f1824D99
2125,15627847,87230,8854150573,85982,1248,458,972,0x4e32004D8b81847A670b4a1778ACe4dCF2bBA01E,0x9D2FD63C49509E82C7ABE56D864dEABF41Ff4a1E
2126,15627847,46128,8854150573,45640,488,138,2476,0x2A3203DF40F9AAee7C5cb587f2f2846653e3828e,0xA17138c0675173B8Ea506Fb1b96FA754BC316cc2
2127,15627847,204934,8854150573,198162,6772,1738,798,0x00000000006c3852cbEf3e08E8dF289169EdE581,0x28a0fb32Ae1190110800b4861eEe11Bf54FBBFF4
2128,15627847,60691,8854150573,53271,7420,2506,51,0x00000000006c3852cbEf3e08E8dF289169EdE581,0x1D0181db657Aa58CB837593096Dd2d2f6D2B59B4
2129,15627847,53923,8854150573,53351,572,138,215,0x39ee2c7b3cb80254225884ca001F57118C8f21B6,0x7DBa349F416B24e67af85F96BfAd69CE6e060a79
2130,15627847,535273,8854150573,526401,8872,2698,22,0x3b3ae790Df4F312e745D270119c6052904FB6790,0x9034B7e63b53Cd2ecF68D21b0c5Ecc097bE36b15
2131,15627847,329032,8354150573,324688,4344,1034,12,0x197492CCB4B1acaAAcd43432657A17832E36AB49,0x54b40ea4c18103f4279Be110575d336bBa61f154
2132,15627847,172433,8354150573,172193,240,74,278,0xf11ED77fD65840b64602526DDC38311E9923c81B,0x39327ba65A22701d8563D9F3a7d001bd83f147D1
2133,15627847,113310,8354150573,113106,204,74,336,0x5D004ddB5D92938dAF8448b9eac1CaA593cd26Ca,0x26DC5D39Bd7A8bc2d792dcAAAC55FE6DCef25593
2134,15627847,160888,7836137066,158056,2832,842,30,0x68b3465833fb72A70ecDF485E0e4C7bD8665Fc45,0x91064c47CA663f2CFAB8Bb9D7c2D9b8228a64758
2135,15627847,350000,7836137066,348896,1104,266,33024,0x00000000ad3FB067501751e1176c9105d6a47CEc,0x1Afa018d9Be65B0Eac856340d919c4526C168FF8
2136,15627847,48506,7563214152,47530,976,202,890779,0xdAC17F958D2ee523a2206206994597C13D831ec7,0x340d693ED55d7bA167D184ea76Ea2Fd092a35BDc
2137,15627847,48518,7563214152,47530,988,202,890780,0xdAC17F958D2ee523a2206206994597C13D831ec7,0x340d693ED55d7bA167D184ea76Ea2Fd092a35BDc
2138,15627847,57262,13406267174,56286,976,202,890781,0xA0b86991c6218b36c1d19D4a2e9Eb0cE3606eB48,0x340d693ED55d7bA167D184ea76Ea2Fd092a35BDc
2139,15627847,57262,11852489475,56286,976,202,890782,0xA0b86991c6218b36c1d19D4a2e9Eb0cE3606eB48,0x340d693ED55d7bA167D184ea76Ea2Fd092a35BDc
2140,15627847,57262,10539810913,56286,976,202,890783,0xA0b86991c6218b36c1d19D4a2e9Eb0cE3606eB48,0x340d693ED55d7bA167D184ea76Ea2Fd092a35BDc
2141,15627847,21000,9216623953,21000,0,2,890784,0xE68d26776c20c968e3693903A477B2B7187322f1,0x340d693ED55d7bA167D184ea76Ea2Fd092a35BDc
2142,15627847,48494,10821799216,47530,964,202,890785,0xdAC17F958D2ee523a2206206994597C13D831ec7,0x340d693ED55d7bA167D184ea76Ea2Fd092a35BDc
2143,15627847,57274,12392392965,56286,988,202,890786,0xA0b86991c6218b36c1d19D4a2e9Eb0cE3606eB48,0x340d693ED55d7bA167D184ea76Ea2Fd092a35BDc
2144,15627847,42511,14623852133,41451,1060,202,890787,0x95aD61b0a150d79219dCF64E1E6Cc01f0B64C4cE,0x340d693ED55d7bA167D184ea76Ea2Fd092a35BDc
2145,15627847,57274,15000000000,56286,988,202,890788,0xA0b86991c6218b36c1d19D4a2e9Eb0cE3606eB48,0x340d693ED55d7bA167D184ea76Ea2Fd092a35BDc
2146,15627847,48518,12401808949,47530,988,202,890789,0xdAC17F958D2ee523a2206206994597C13D831ec7,0x340d693ED55d7bA167D184ea76Ea2Fd092a35BDc
2147,15627847,21000,12401808949,21000,0,2,890790,0x38ed6753f67C29305F32FD7938c40E1CC1DdF7B5,0x340d693ED55d7bA167D184ea76Ea2Fd092a35BDc
2148,15627847,48506,13158346685,47530,976,202,890791,0xdAC17F958D2ee523a2206206994597C13D831ec7,0x340d693ED55d7bA167D184ea76Ea2Fd092a35BDc
2149,15627847,105000,7563214152,105000,0,2,138561,0x42Cc5f171151aA67CdcB16c9fCF3809C4293f956,0x974CaA59e49682CdA0AD2bbe82983419A2ECC400
2150,15627847,105000,7563214152,105000,0,2,138562,0x417948a68e8DD4de500DCF54F0E864B41F64d6C7,0x974CaA59e49682CdA0AD2bbe82983419A2ECC400
2151,15627847,105000,7764419574,105000,0,2,138563,0x83E322dE4dEe262DC42af790886583ea5D9E7c72,0x974CaA59e49682CdA0AD2bbe82983419A2ECC400
2152,15627847,191077,7563214152,190177,900,266,70,0xd588b586D61C826A0e87919b3D1a239206d58bf2,0x2270Fe65e8bcaAfB4F595F6D2c4eC34acCACfbC3
2153,15627847,103704,7541619528,103048,656,138,326,0x0D8775F648430679A709E98d2b0Cb6250d2887EF,0xb13398C68e0dC169F8170f46Bf8a9B060B0Ab406
2154,15627847,21000,7541619528,21000,0,2,49,0x227D2f1F7A018dC24767A6eA512937A202DdF672,0xCD8F79C321807C14827e2f1D6F86Ff08c82c5fA0
2155,15627848,206439,125000000000,203715,2724,842,129,0x68b3465833fb72A70ecDF485E0e4C7bD8665Fc45,0xF73CC8098A381018823662aA7929d6Da2687804D
2156,15627848,850000,58294034013,848072,1928,522,98,0x7a250d5630B4cF539739dF2C5dAcb4c659F2488D,0x555c9F6e96A9D05938AC6ab0D095112321a0aD5a
2157,15627848,2000001,6794034013,1998257,1744,346,4926,0x00000000008C4FB1c916E0C88fd4cc402D935e7D,0xEea07eDef8FC5b4A42BeffAc4808Eac543b62B28
2158,15627848,291859,7276020506,288583,3276,1034,2109,0x68b3465833fb72A70ecDF485E0e4C7bD8665Fc45,0x14439dbe3eACf79d66d11D866A38ffF52fe67FaC
2159,15627848,2000001,6794034013,1997925,2076,386,4927,0x00000000008C4FB1c916E0C88fd4cc402D935e7D,0xEea07eDef8FC5b4A42BeffAc4808Eac543b62B28
2160,15627848,21000,45000000000,21000,0,2,34,0x069Acf904f610Cbf8ef1540349092852e46b4E95,0xcA6e70e17813160859F5A5Ad6392709AE4791CFe
2161,15627848,21000,45000000000,21000,0,2,45,0xb438a56a21fB0486190D12eC114A02cFA9C141F6,0xC84ff70d73b822AEAa3987Fb8C1E07c56EFf99a1
2162,15627848,69163,45000000000,68555,608,138,6,0xdAC17F958D2ee523a2206206994597C13D831ec7,0xBe35f3bCea9D58ee63c04199161b834f32922aE7
2163,15627848,200000,30250000000,199404,596,138,1205077,0xdAC17F958D2ee523a2206206994597C13D831ec7,0xFfec0067F5a79CFf07527f63D83dD5462cCf8BA4
2164,15627848,21000,30000000000,21000,0,2,0,0xA7EFAe728D2936e78BDA97dc267687568dD593f3,0x2d373F56071D486BbBB654a1B031eFe0Cb1DAc00
2165,15627848,21000,30000000000,21000,0,2,5,0xA7EFAe728D2936e78BDA97dc267687568dD593f3,0xE3F4711e6f4820628664157089Eaf52b266cAd80
2166,15627848,21000,30000000000,21000,0,2,44500,0xA7EFAe728D2936e78BDA97dc267687568dD593f3,0x3c5883C650d600bd543A9B5c8D9A3a6f5d16b8f4
2167,15627848,21000,30000000000,21000,0,2,0,0xA7EFAe728D2936e78BDA97dc267687568dD593f3,0xc25D2866f4a6355FAa15dAc9D0b0E9A59F6A26C4
2168,15627848,21000,30000000000,21000,0,2,3,0xA7EFAe728D2936e78BDA97dc267687568dD593f3,0xd811aEEAce6CdF6dF980e015627375Fa516b0BC1
2169,15627848,100000,30000000000,99392,608,138,9,0xdAC17F958D2ee523a2206206994597C13D831ec7,0x91B6B63780C9Dcc739d222148aD57fcC6db9E740
2170,15627848,100000,30000000000,99392,608,138,2,0xA0b86991c6218b36c1d19D4a2e9Eb0cE3606eB48,0x7b415635B2513C523919595837d87F7179C3B72d
2171,15627848,100000,30000000000,99392,608,138,0,0xdAC17F958D2ee523a2206206994597C13D831ec7,0xc176e33d396d853e960A82f22dE15599680Ae14d
2172,15627848,100000,30000000000,99392,608,138,20,0xdAC17F958D2ee523a2206206994597C13D831ec7,0xBc1b0D29179c8E3a287D6638702Ce746dCb96DF8
2173,15627848,100000,30000000000,99392,608,138,9,0xdAC17F958D2ee523a2206206994597C13D831ec7,0xE65F0e519A072f5C76FEF01E2a8a589A9cdF2C9b
2174,15627848,100000,30000000000,99392,608,138,67,0xdAC17F958D2ee523a2206206994597C13D831ec7,0xDbaE50F673359ddcE7E1F5f8c4638efF40102083
2175,15627848,100000,30000000000,99392,608,138,44,0xdAC17F958D2ee523a2206206994597C13D831ec7,0x763C16C29A58ec6438920C3c0B6ACb12eCF86923
2176,15627848,100000,30000000000,99380,620,138,145,0xdAC17F958D2ee523a2206206994597C13D831ec7,0x575bAEd7F78C330b22F44f8E58dc11493D17c869
2177,15627848,100000,30000000000,99404,596,138,16,0xdAC17F958D2ee523a2206206994597C13D831ec7,0xa40119c241859F87dcAD2F50a3123F7184a61D46
2178,15627848,100000,30000000000,99392,608,138,5,0xdAC17F958D2ee523a2206206994597C13D831ec7,0x05f7BF9d22EE4Ee5D9a0b4d29E11078E2578CD11
2179,15627848,100000,30000000000,99392,608,138,2,0xdAC17F958D2ee523a2206206994597C13D831ec7,0xDA057A79113460e5Fe6E97df7cbe27D72E3CfB9A
2180,15627848,100000,30000000000,99392,608,138,0,0xdAC17F958D2ee523a2206206994597C13D831ec7,0x3B0E7695F480b2841404C10cebAcC4217Dad6c2E
2181,15627848,100000,30000000000,99392,608,138,3,0xdAC17F958D2ee523a2206206994597C13D831ec7,0x6e4BD01Cacec2fb90cA0001e6858A38271694836
2182,15627848,100000,30000000000,99392,608,138,7,0xdAC17F958D2ee523a2206206994597C13D831ec7,0x9c3e10eBC45E050F0AaBF5B27B59624a5ffC33CE
2183,15627848,21000,30000000000,21000,0,2,1005594,0xE21bcD64ba35c601c15f56bbf4ceA7016cE970f7,0xc5a93444Cc4dA6EfB9e6FC6e5D3CB55A53b52396
2184,15627848,202459,18232014474,201111,1348,190,2382,0x9507c04B10486547584C37bCBd931B2a4FeE9A41,0x5B929C504E88eF422aa4aea93791c5c17c9F15fC
2185,15627848,56766,16794034013,55822,944,138,860,0xEc385033528A06592641b7e4Acd791F91Fc8a287,0x0a2eB196bFf5573F456D47A9fA26208a24BB5996
2186,15627848,161714,16039007522,160378,1336,190,5389,0x9507c04B10486547584C37bCBd931B2a4FeE9A41,0x934ed35e39f5D9B1D42041B3f6B74C0ce452F4Ac
2187,15627848,139719,6794034013,139087,632,90,103238,0x01FF6318440f7D5553a82294D78262D5f5084EFF,0x5AA17fC7F2950ECa85376C3A8CB1509e8e4B39dF
2188,15627848,292593,8794034013,286777,5816,1548,64,0x881D40237659C251811CEC9c364ef91dC08D300C,0x03cc3BAB53478bc6aA5FE6bFCAE5049a94102C18
2189,15627848,129934,41848402678,128970,964,130,103239,0x01FF6318440f7D5553a82294D78262D5f5084EFF,0x5AA17fC7F2950ECa85376C3A8CB1509e8e4B39dF
2190,15627848,50000,14291495348,50000,0,2,2188223,0xe9E72a28240D255697cBa14eD7dBed1BE641d80B,0x75e89d5979E4f6Fba9F97c104c2F0AFB3F1dcB88
2191,15627848,50000,14291495348,50000,0,2,2188224,0x166A46e344D0BB0fa2fDd5ED61AA8a9F5076f4F2,0x75e89d5979E4f6Fba9F97c104c2F0AFB3F1dcB88
2192,15627848,41187,13677559689,40175,1012,202,890792,0x6B175474E89094C44Da98b954EedeAC495271d0F,0x340d693ED55d7bA167D184ea76Ea2Fd092a35BDc
2193,15627848,21000,14546398286,21000,0,2,890793,0xeD522c3B01052703bCdbCFe56105d6569b217Fa0,0x340d693ED55d7bA167D184ea76Ea2Fd092a35BDc
2194,15627848,21000,14546398286,21000,0,2,890794,0x5658a08355887F0F43F357627cf4D96774D4617a,0x340d693ED55d7bA167D184ea76Ea2Fd092a35BDc
2195,15627848,57262,14367500314,56286,976,202,890795,0xA0b86991c6218b36c1d19D4a2e9Eb0cE3606eB48,0x340d693ED55d7bA167D184ea76Ea2Fd092a35BDc
2196,15627848,21000,14367500314,21000,0,2,890796,0x830ACD6955deb17A672721d56b900124B6dC4Fed,0x340d693ED55d7bA167D184ea76Ea2Fd092a35BDc
2197,15627848,21000,14367500314,21000,0,2,890797,0x8f6B710259688D27717AEc39D70F81313FC5F14F,0x340d693ED55d7bA167D184ea76Ea2Fd092a35BDc
2198,15627848,51712,14920508165,50724,988,202,890798,0xdAC17F958D2ee523a2206206994597C13D831ec7,0x340d693ED55d7bA167D184ea76Ea2Fd092a35BDc
2199,15627848,100000,13600000000,99056,944,138,161,0x056Fd409E1d7A124BD7017459dFEa2F387b6d5Cd,0x3C325DfeafaC6F08DB973E7dfD6E25490aE00Af1
2200,15627848,57250,13407796187,56286,964,202,890799,0xA0b86991c6218b36c1d19D4a2e9Eb0cE3606eB48,0x340d693ED55d7bA167D184ea76Ea2Fd092a35BDc
2201,15627848,21000,13189624018,21000,0,2,890800,0x674f2768b9C1a920BFD121181C0cff0e1689C756,0x340d693ED55d7bA167D184ea76Ea2Fd092a35BDc
2202,15627848,100000,12840000000,99056,944,138,376,0x5A98FcBEA516Cf06857215779Fd812CA3beF1B32,0xabC67a49D7d75bD04fA1DAE22cD4b8c4F796540a
2203,15627848,48506,12539302248,47530,976,202,890801,0xdAC17F958D2ee523a2206206994597C13D831ec7,0x340d693ED55d7bA167D184ea76Ea2Fd092a35BDc
2204,15627848,21000,14439216596,21000,0,2,890802,0x8A84d81326f584c3818bcFC08AB6daccd8ADcd54,0x340d693ED55d7bA167D184ea76Ea2Fd092a35BDc
2205,15627848,21000,13186126489,21000,0,2,890803,0x52E454866C33B56e7D085cfD3a9Efbb23d85e735,0x340d693ED55d7bA167D184ea76Ea2Fd092a35BDc
2206,15627848,21000,13640590882,21000,0,2,890804,0x8A84d81326f584c3818bcFC08AB6daccd8ADcd54,0x340d693ED55d7bA167D184ea76Ea2Fd092a35BDc
2207,15627848,262447,12100000000,260471,1976,522,406,0x7a250d5630B4cF539739dF2C5dAcb4c659F2488D,0xdFb56a3F1B910522C3366c04Db1D629f631FFAA0
2208,15627848,300000,6794034013,298616,1384,394,224455,0x98C3d3183C4b8A650614ad179A1a98be0a8d6B8E,0x91aaE0aAfd9D2d730111b395c6871f248d7Bd728
2209,15627848,222222,12000000000,220658,1564,394,347,0x1Fa8559e873f698292766790AeCf8080A66433F6,0xf6d3e1f38dF9B7C3EB8a6E4f50BE29DDB4dF12ca
2210,15627848,21000,11066793052,21000,0,2,28,0xCBD6832Ebc203e49E2B771897067fce3c58575ac,0xE5A864837455e2a60B48be6695Eb9A7Fe9599246
2211,15627848,170000,11000000000,169392,608,138,0,0xA0b86991c6218b36c1d19D4a2e9Eb0cE3606eB48,0x118630295d65715d69CbB2adC99cf94c642E1d77
2212,15627848,30000,11000000000,30000,0,2,3200,0x3e6722f32CBE5b3C7BD3dcA7017c7FfE1b9E5A2A,0x2240FFCB2330177D49578954B11445d7C7Db1e29
2213,15627848,21000,10872054752,21000,0,2,890805,0xf5Fd5A4d764EB9e9746fd9283525eC54Eb7eC5C5,0x340d693ED55d7bA167D184ea76Ea2Fd092a35BDc
2214,15627848,21000,10872054752,21000,0,2,890806,0x4EC193bC8b7aEb0f3267Efd5D42c1e41277877Bb,0x340d693ED55d7bA167D184ea76Ea2Fd092a35BDc
2215,15627848,21000,12508500406,21000,0,2,890807,0x3f450ade8483566326b5E379263392c450c9ac5A,0x340d693ED55d7bA167D184ea76Ea2Fd092a35BDc
2216,15627848,48518,12142506627,47530,988,202,890808,0xdAC17F958D2ee523a2206206994597C13D831ec7,0x340d693ED55d7bA167D184ea76Ea2Fd092a35BDc
2217,15627848,51712,12944907588,50724,988,202,890809,0xdAC17F958D2ee523a2206206994597C13D831ec7,0x340d693ED55d7bA167D184ea76Ea2Fd092a35BDc
2218,15627848,57274,12249872174,56286,988,202,890810,0xA0b86991c6218b36c1d19D4a2e9Eb0cE3606eB48,0x340d693ED55d7bA167D184ea76Ea2Fd092a35BDc
2219,15627848,21000,12249872174,21000,0,2,890811,0x3f450ade8483566326b5E379263392c450c9ac5A,0x340d693ED55d7bA167D184ea76Ea2Fd092a35BDc
2220,15627848,21000,13952133387,21000,0,2,890812,0x52E454866C33B56e7D085cfD3a9Efbb23d85e735,0x340d693ED55d7bA167D184ea76Ea2Fd092a35BDc
2221,15627848,21000,13877279029,21000,0,2,890813,0xEbBF3Ba0d297e8E08e75eDC8097FEAffC49a0167,0x340d693ED55d7bA167D184ea76Ea2Fd092a35BDc
2222,15627848,42764,14314798003,41788,976,202,890814,0x15D4c048F83bd7e37d49eA4C83a07267Ec4203dA,0x340d693ED55d7bA167D184ea76Ea2Fd092a35BDc
2223,15627848,21000,13577330765,21000,0,2,890815,0xb9d1522c1437d2e6628713a2b90cfd1a21f8AaDB,0x340d693ED55d7bA167D184ea76Ea2Fd092a35BDc
2224,15627848,63000,10516870442,63000,0,2,2710048,0x8F35f46d6912C91D5F1e8a25da1480df9A012606,0xC098B2a3Aa256D2140208C3de6543aAEf5cd3A94
2225,15627848,97381,10509455465,96785,596,138,355147,0xA0b86991c6218b36c1d19D4a2e9Eb0cE3606eB48,0x7abE0cE388281d2aCF297Cb089caef3819b13448
2226,15627848,207291,10500000000,206587,704,138,13,0x0B452278223D3954F4AC050949D7998e373e7E43,0xDCaD84F88963C9F4ec8ee02Ec60CE0441fB405F0
2227,15627848,21000,10475792060,21000,0,2,0,0x4945cE2d1B5BD904CAc839b7FDAbAfd19Cab982b,0x507C3db2c59591a03962Dd4594EDd92Ba019E2d8
2228,15627848,158897,10304335865,158033,864,134,13640,0x5C57Ac8dC5D8589DAB9d422993ED3DE8CC244151,0x4D521577f820525964C392352bB220482F1Aa63b
2229,15627848,42105,10000000000,42105,0,2,705869,0x2E97eb7faBA70D8C56D992c388d1189D2022aDEf,0x6dfc34609a05bC22319fA4Cce1d1E2929548c0D7
2230,15627848,346426,10000000000,342870,3556,970,6694,0x68b3465833fb72A70ecDF485E0e4C7bD8665Fc45,0xA574225Ffa9b40db38D387B041484c0C1a499098
2231,15627848,90000,10000000000,89392,608,138,606764,0xdAC17F958D2ee523a2206206994597C13D831ec7,0x9acbB72Cf67103A30333A32CD203459c6a9c3311
2232,15627848,191041,10000000000,190165,876,266,1387,0xd588b586D61C826A0e87919b3D1a239206d58bf2,0xC22d03e13B888Dabb33A1575e4F6542f0e996622
2233,15627848,21000,9970000000,21000,0,2,705870,0x4C30A441E5Ae890474EbaA841F782A76AF6E3979,0x6dfc34609a05bC22319fA4Cce1d1E2929548c0D7
2234,15627848,21000,9827974219,21000,0,2,8,0xC6F82C158F568A8580986Ef3CB3C47A253Af3465,0xdaB4B7788c30c7edf598Ef867056019114c8969f
2235,15627848,21000,9796034013,21000,0,2,251467,0xd74A2d6D6F57a93d9815cB38dD73f32361C86D81,0x151B381058f91cF871E7eA1eE83c45326F61e96D
2236,15627848,750000,9794034013,748120,1880,522,1283,0x7a250d5630B4cF539739dF2C5dAcb4c659F2488D,0x9f394569A5D2Af700A5e6eaEFA067373d1b12C3C
2237,15627848,188548,9794034013,184908,3640,1162,14135,0x68b3465833fb72A70ecDF485E0e4C7bD8665Fc45,0xD54e4f8A55247487dd7C8c59f14EE5c0c2889477
2238,15627848,453182,9603248740,450718,2464,334,35101,0x6aF1A16fdE7346e7729fA921ad2dDf6a462061e2,0x4dD36C49B200A6d52eBB365F01Bf0e4Db8b9f765
2239,15627848,57262,9575939856,56286,976,202,890816,0xA0b86991c6218b36c1d19D4a2e9Eb0cE3606eB48,0x340d693ED55d7bA167D184ea76Ea2Fd092a35BDc
2240,15627848,57262,12398673248,56286,976,202,890817,0xA0b86991c6218b36c1d19D4a2e9Eb0cE3606eB48,0x340d693ED55d7bA167D184ea76Ea2Fd092a35BDc
2241,15627848,57262,14942058885,56286,976,202,890818,0xA0b86991c6218b36c1d19D4a2e9Eb0cE3606eB48,0x340d693ED55d7bA167D184ea76Ea2Fd092a35BDc
2242,15627848,57262,14839020136,56286,976,202,890819,0xA0b86991c6218b36c1d19D4a2e9Eb0cE3606eB48,0x340d693ED55d7bA167D184ea76Ea2Fd092a35BDc
2243,15627848,57262,12811682213,56286,976,202,890820,0xA0b86991c6218b36c1d19D4a2e9Eb0cE3606eB48,0x340d693ED55d7bA167D184ea76Ea2Fd092a35BDc
2244,15627848,51688,10318411410,50724,964,202,890821,0xdAC17F958D2ee523a2206206994597C13D831ec7,0x340d693ED55d7bA167D184ea76Ea2Fd092a35BDc
2245,15627848,57262,14911355548,56286,976,202,890822,0xA0b86991c6218b36c1d19D4a2e9Eb0cE3606eB48,0x340d693ED55d7bA167D184ea76Ea2Fd092a35BDc
2246,15627848,21000,11766677483,21000,0,2,890823,0x0Bc14DE57b59C43F0B0FE9D8943836A537b74CF9,0x340d693ED55d7bA167D184ea76Ea2Fd092a35BDc
2247,15627848,57274,11366126354,56286,988,202,890824,0xA0b86991c6218b36c1d19D4a2e9Eb0cE3606eB48,0x340d693ED55d7bA167D184ea76Ea2Fd092a35BDc
2248,15627848,21000,9296034013,21000,0,2,196174,0x9C34aA07a1f8F4A8Ee9F2AE5f345CD12c53AA069,0xd108FD0E8c8E71552a167E7a44FF1d345D233BA6
2249,15627848,1984047,9294034013,1978755,5292,1994,1512,0xb16c1342E617A5B6E4b631EB114483FDB289c0A4,0x518201899E316bf98c957C73e1326b77672Fe52b
2250,15627848,21592,9294034013,21000,592,76,13469,0xaf65E45F4C0BD388F91EeB23cFCd52F4fCdd6Ee2,0xaf65E45F4C0BD388F91EeB23cFCd52F4fCdd6Ee2
2251,15627848,143796,9294034013,143592,204,74,18,0x7F9306FC1978938d5C1C57Bf6044dc67E07eeB8a,0x75646014293177849f306221e48654bA22C2c554
2252,15627848,117738,9294034013,117534,204,74,99,0x7F9306FC1978938d5C1C57Bf6044dc67E07eeB8a,0x1271F40Cf3d7229a874433331D11f0134b95c6C1
2253,15627848,107232,9294034013,107028,204,74,0,0x8cFC27c666a31638AD5Cce720c5d09373517F58b,0xF87B63f9690D393cFc53359E833364633fCa5ddb
2254,15627848,129691,9294034013,129487,204,74,186,0x7F9306FC1978938d5C1C57Bf6044dc67E07eeB8a,0x32d9E641035dF1129A37F6fA1d6962C62AF2e20d
2255,15627848,129691,9294034013,129487,204,74,187,0x7F9306FC1978938d5C1C57Bf6044dc67E07eeB8a,0x32d9E641035dF1129A37F6fA1d6962C62AF2e20d
2256,15627848,242472,9171344301,240156,2316,650,106622,0xA69babEF1cA67A37Ffaf7a485DfFF3382056e78C,0x9AAb3F81604c683a1a0D14019FBfe15bef7aA1ee
2257,15627848,90000,9000000000,89380,620,138,168676,0xdAC17F958D2ee523a2206206994597C13D831ec7,0x4E5B2e1dc63F6b91cb6Cd759936495434C7e972F
2258,15627848,280326,8844034013,276938,3388,970,10,0x68b3465833fb72A70ecDF485E0e4C7bD8665Fc45,0x2daA1FCF5b4553b8B50F82C1468b78282eb3F598
2259,15627848,338400,8794034014,336096,2304,650,122589,0xA69babEF1cA67A37Ffaf7a485DfFF3382056e78C,0x1c8F6A5F009E051CaB9C3851ca2DA2c936b2775A
2260,15627848,181476,8794034013,179912,1564,394,5299,0x1Fa8559e873f698292766790AeCf8080A66433F6,0xA01C0735C7cA5f8efc1e63efa5F2D1C4fc1a4714
2261,15627848,70000,8794034013,69392,608,138,521,0xdAC17F958D2ee523a2206206994597C13D831ec7,0xf5491f793D47A6Ea22f5e0B9AD3990CF66c4b40B
2262,15627848,39630,8794034013,39354,276,74,180,0xC02aaA39b223FE8D0A0e5C4F27eAD9083C756Cc2,0x5C73f4DF2dA3C258d490E91e1beceaaAB2742196
2263,15627848,155546,8794034013,153966,1580,330,131,0x84c2b16FA6877a8fF4F3271db7ea837233DFd6f0,0xe8787b5a359c30318D9b805651D18275f33Fa1Bd
2264,15627848,21000,8794034013,21000,0,2,4,0x8bf6DA3aeA14CB31a141F76D6Fc143613a900143,0x8BD737e1Ed1eF278e11BDB7933226629310af41F
2265,15627848,21000,8794034013,21000,0,2,0,0x4218c2698a6c8C05b577A794bcA3D8f60C67A937,0xAb430B0a232AaA0D07E349DE4e95E0F509bFF8Fe
2266,15627848,155748,8794034013,155544,204,74,840,0x7F9306FC1978938d5C1C57Bf6044dc67E07eeB8a,0x6B0a789e01eC7e7c2d02905d9DaBD3e879Ff7417
2267,15627848,42000,8794034013,42000,0,2,329518,0xD484D76a9f319Dd3AD2BaaCdA8d02ca207Eb9D4e,0x9430801EBAf509Ad49202aaBC5F5Bc6fd8A3dAf8
2268,15627848,131101,8794034013,125161,5940,1610,416,0x00000000006c3852cbEf3e08E8dF289169EdE581,0x6A03fd28637846fdaB46c72e656987e5b923C7aB
2269,15627848,241074,8794034013,235142,5932,1738,38,0x68b3465833fb72A70ecDF485E0e4C7bD8665Fc45,0x26d78fE89Fced02F8367Bd3eF28B6343873B4408
2270,15627848,55897,8794034013,54953,944,138,100,0xD42BE5dA474E9658C6969FdAe61b3F132AfC2e63,0x8EA6C6FD2A3e866C86A2E53e065B8156C2ac0101
2271,15627848,94813,8794034013,94205,608,138,99,0xdAC17F958D2ee523a2206206994597C13D831ec7,0x39F954C8674009e4bD03c4AFb36ccAf1732D3F7b
2272,15627848,56674,8794034013,55730,944,138,448,0xC69F21799c3bF37C5e8ba1030b24eC92c37E7CE6,0x263835b05ad8972731083fa2751aCd438e6B768e
2273,15627848,2000000,8794034013,1994924,5076,1226,171036,0xA9D1e08C7793af67e9d92fe308d5697FB81d3E43,0x7830c87C02e56AFf27FA8Ab1241711331FA86F43
2274,15627848,21000,8794034013,21000,0,2,1228775,0xdC72C41822fDB8e08273715AbB8aD1123aB6ab60,0x71660c4005BA85c37ccec55d0C4493E66Fe775d3
2275,15627848,21000,8794034013,21000,0,2,7100795,0x0DE0865de9f33C813D4Cf6E176a42eE549dc73f5,0xddfAbCdc4D8FfC6d5beaf154f18B778f892A0740
2276,15627848,21000,8794034013,21000,0,2,469156,0xe7C6f258AE50887F3F0C398C12A1B18e8AB2558F,0xb739D0895772DBB71A89A3754A160269068f0D45
2277,15627848,21000,8794034013,21000,0,2,7100796,0xA6C5247478eD473bBa80A627dEeba93324f6CCed,0xddfAbCdc4D8FfC6d5beaf154f18B778f892A0740
2278,15627848,2000000,8794034013,1990060,9940,2122,171037,0xA9D1e08C7793af67e9d92fe308d5697FB81d3E43,0x7830c87C02e56AFf27FA8Ab1241711331FA86F43
2279,15627848,21000,8794034013,21000,0,2,1783201,0xc7d020Deb72Eb3805d65f23c452F72eE27fC037E,0x503828976D22510aad0201ac7EC88293211D23Da
2280,15627848,21000,8794034013,21000,0,2,469157,0x6e2FeF567bfe19122ba15811635f26A16602DEdb,0xb739D0895772DBB71A89A3754A160269068f0D45
2281,15627848,21000,8794034013,21000,0,2,1211347,0x7Bd496a6e7e414200af7508FA4d47E12E438729E,0x95A9bd206aE52C4BA8EecFc93d18EACDd41C88CC
2282,15627848,405274,8794034013,401646,3628,1162,1360,0x68b3465833fb72A70ecDF485E0e4C7bD8665Fc45,0xc3FD9C40521394c1DbcF57d6912baBCf394F33C0
2283,15627848,21000,8794034013,21000,0,2,7100797,0xbeA574304A3e6180cA50A7b702C62BC5ee21817F,0xddfAbCdc4D8FfC6d5beaf154f18B778f892A0740
2284,15627848,21000,8794034013,21000,0,2,346918,0x86F1F3fC211f91c7bD2A9a20E27f74FBB3250947,0x77696bb39917C91A0c3908D577d5e322095425cA
2285,15627848,379415,8794034013,358923,20492,4746,506,0x1A90B3Dead0113740266b7F7Ea1136e8ED1b48C5,0x62Ef8b356751612Ad33863c454825BF94998AF2E
2286,15627848,21000,8794034013,21000,0,2,346919,0x491d51E987482cC2fc131585b5208A1C48850075,0x77696bb39917C91A0c3908D577d5e322095425cA
2287,15627848,21000,8794034013,21000,0,2,8265745,0x6BbDAb46d8e179fFD2265135D944Cc8eC835551B,0xb5d85CBf7cB3EE0D56b3bB207D5Fc4B82f43F511
2288,15627848,70000,8794034013,69404,596,138,12,0xA0b86991c6218b36c1d19D4a2e9Eb0cE3606eB48,0xa7b6DD34afF4340FccE98244fe7Cbcf0D5a77167
2289,15627848,21000,8794034013,21000,0,2,8804461,0xb082A4F1D6f9dB905B492569Ad8840AB959309c4,0x3cD751E6b0078Be393132286c442345e5DC49699
2290,15627848,21000,8794034013,21000,0,2,8,0x34Ef4BFDaF438Fae7eB59F0701b86F72D380571e,0xf70b7493FE0Cf5Bccf28730927B26005EeED33C2
2291,15627848,62319,8794034013,61699,620,138,41,0x4a220E6096B25EADb88358cb44068A3248254675,0x301Cc3Aff59D3EfAccf1E6dfDd1Ec3d11c7CA1C4
2292,15627848,56714,8794034013,55770,944,138,207,0x848592388097D2A3CA9E285F445e5B92B6af52Ad,0xD4854c4EdEC0a3e5b160b1e10b45192cE1E96e01
2293,15627848,2000000,8773371266,1997940,2060,522,322,0x7a250d5630B4cF539739dF2C5dAcb4c659F2488D,0x158318657de819928C935ae3436Ae2a796bcd681
2294,15627848,296089,8703286090,294309,1780,256,5121,0x507888e987257a8DdE6F8AFa46375CEfe2CbF504,0x678111a6cA5749f1744b5E080A855CEC8d631E20
2295,15627848,740000,8418288816,729028,10972,2506,59259,0xDEc0a100eaD1fAa37407f0Edc76033426CF90b82,0x2a4a7afA40a9D03B425752fb4cFd5f0FF5b3964C
2296,15627848,561352,8404034013,549628,11724,3914,290,0xDEF171Fe48CF0115B1d80b88dc8eAB59176FEe57,0x17D065070486Ca0fC8b4B382b946BE79Fb4fF10D
2297,15627848,600000,8385755621,598740,1260,458,59274,0xE544cF993C7d477C7ef8E91D28aCA250D135aa03,0x69f36eA1ebf4Ec9E53e3aaBF11CAF62b034ff3eE
2298,15627848,212446,8294034013,208806,3640,1162,8020,0x68b3465833fb72A70ecDF485E0e4C7bD8665Fc45,0x8E0D1481Fa42e85b5C4ADA8b170Cc9E498FBc947
2299,15627848,165398,8433250759,164218,1180,184,27894,0x0eae044f00B0aF300500F090eA00027097d03000,0x05429D641a61eB2C6093905784D2e8C9b5A193C8
2300,15627848,300000,8295781480,299368,632,138,7728,0x92e929d8B2c8430BcAF4cD87654789578BB2b786,0xf725304D19bbA30F0F975827c234B77327b1667B
2301,15627848,150756,8294034013,150692,64,10,8,0x65c2e54a4c75ff6da7b6B32369c1677250075fb2,0x9afEf63384A707f8ba9AC4F09638267C6135091F
2302,15627848,150756,8294034013,150692,64,10,9,0x65c2e54a4c75ff6da7b6B32369c1677250075fb2,0x9afEf63384A707f8ba9AC4F09638267C6135091F
2303,15627848,64448,8294034013,64384,64,10,496,0x5cd2FAc9702D68dde5a94B1af95962bCFb80fC7d,0x27D447C2CAc8050e3716AaE99CE8CA37442B589e
2304,15627848,261721,8294034013,261517,204,74,14,0x55f1C36Bb7aE0d7D6caE97902E30A2306686Ec73,0xD9Ca7dBAB4F1aa1E52f7e7013b8588596C380799
2305,15627848,59526,8294034013,58582,944,138,14,0xD2d8D78087D0E43BC4804B6F946674b2Ee406b80,0x630D329fEbE98a0ee24c1D9AC451a04476FeC43e
2306,15627848,65000,8294034013,64392,608,138,646166,0xdAC17F958D2ee523a2206206994597C13D831ec7,0x29D5527CaA78f1946a409FA6aCaf14A0a4A0274b
2307,15627848,79572,8294034013,79168,404,138,5157,0x2b591e99afE9f32eAA6214f7B7629768c40Eeb39,0x3b17e0beC7d1a0348410F7706c5E775b029Bd875
2308,15627848,342567,8294034013,339675,2892,650,4,0x7a250d5630B4cF539739dF2C5dAcb4c659F2488D,0x01CB0dd9Fa036eB4999b9F277c2ac367C0E74666
2309,15627848,189482,8294034013,178814,10668,3410,458,0x00000000006c3852cbEf3e08E8dF289169EdE581,0xd37D6c54CF9974e6E3A78167fDFE40EcEdF2be4d
2310,15627848,258484,8294034013,253708,4776,1418,285,0xa2398842F37465f89540430bDC00219fA9E4D28a,0xDe396bE7fd86162dab8c9fe9006d4085C42483a8
2311,15627848,176958,8294034013,170370,6588,1802,610,0x00000000006c3852cbEf3e08E8dF289169EdE581,0x449B66f552fad5eaDbAbABDD1fCaA94727CF7414
2312,15627848,27938,8294034013,27874,64,10,39,0xC02aaA39b223FE8D0A0e5C4F27eAD9083C756Cc2,0x4a0d922F5177F4518A19e4962629c0833C7C4a73
2313,15627848,108053,8294034013,107253,800,330,30,0x17D084106C2f1C716ce39fa015AB022757d30C9A,0x081CD37e86B53d4E2A933144ca9915714D788631
2314,15627848,206853,8294034013,187241,19612,4690,644,0x00000000006c3852cbEf3e08E8dF289169EdE581,0x103246339988c3A3eC32086A179d6D6b8dE34c4F
2315,15627848,49175,8294034013,48687,488,138,372,0xD27dcbcC8778a8AB33AAc529Df36a634567Be325,0xd9493D3f51C84Cedead582a2E55Fe4381f17DF0a
2316,15627848,46103,8294034013,45615,488,138,259,0x346378C67d0F71343F80299ed8C0407aC2Df05eB,0x5a3A549Aea8BE363D0CF797C53FB1d0932e2d17A
2317,15627848,46078,8294034013,45590,488,138,39,0x2F14F1b6c350C41801b2b7BA9445670D7E2FFc70,0x3106804Fc9E3A769aDD46c28712a1f1EA960D441
2318,15627848,535738,8294034013,532122,3616,1162,38,0x68b3465833fb72A70ecDF485E0e4C7bD8665Fc45,0xE81E0543E47a16cDdD4dD8504f54188724f59509
2319,15627848,52888,8294034013,52244,644,138,6,0x12b6893cE26Ea6341919FE289212ef77e51688c8,0x024Ec9Dfd17d9645dE9188d2bb594fd381f7a792
2320,15627848,21000,8294034013,21000,0,2,20,0x28B29A66B93bdB18B713d2ef6f0405f3c569ff15,0xb9e83009aa3E15Ac4a6fC255C3642D8f66B9725c
2321,15627848,168803,8294034013,162139,6664,1810,74,0x00000000006c3852cbEf3e08E8dF289169EdE581,0x58ED8e76752539f387a2a6e040384D285D3973bD
2322,15627848,198489,8294034013,195709,2780,714,233,0xF849de01B080aDC3A814FaBE1E2087475cF2E354,0xf78Bf349211877E3B186f284E05a3b54D1DAF764
2323,15627848,180756,8294034013,177116,3640,1162,4,0x68b3465833fb72A70ecDF485E0e4C7bD8665Fc45,0x8e801f9B56A08f1b152890B01fbb727A80Ca980D
2324,15627848,46678,8294034013,46190,488,138,2477,0x2Ad0ED1621EaaB92C71f53DdE4BABa88e5C0BC44,0xA17138c0675173B8Ea506Fb1b96FA754BC316cc2
2325,15627848,225654,8294034013,207114,18540,4562,521,0x00000000006c3852cbEf3e08E8dF289169EdE581,0xe96DEcB942b8B5C6bd57f08F146fcA12772cb1ef
2326,15627848,233030,8294034013,230638,2392,586,432,0xd9e1cE17f2641f24aE83637ab66a2cca9C378B9F,0x819b30644d3356dAC1D295b053ECA4F61aA7f15b
2327,15627848,45399,8294034013,44447,952,202,398,0xC86664e7d2608f881f796ee8E24FA9d4d7598406,0x7D3E5dD617EAF4A3d42EA550C41097086605c4aF
2328,15627848,330020,8294034013,327868,2152,586,586,0xFbdDaDD80fe7bda00B901FbAf73803F2238Ae655,0x44137Aa861C4ED350f4Da91C2D7c1A3Dce378601
2329,15627848,123784,8294034013,122816,968,330,96,0x4e32004D8b81847A670b4a1778ACe4dCF2bBA01E,0x066DC123977849dF818ed709B375E73123E45179
2330,15627848,69093,8294034013,66721,2372,714,1018,0x91C7b17839e4A12d665B7C5d12230C4Dd77B81e6,0x4e207C61D79ef29E77E64DBae3F21C0c0Ee2e68b
2331,15627848,46184,8294034013,45696,488,138,1063,0xE948D9d3b97606304A8DB0538bDD0b6465c9DFcB,0x050C1C3D2E802dD6208Acee28806CC65f35F9327
2332,15627848,117738,8294034013,117534,204,74,28,0x7F9306FC1978938d5C1C57Bf6044dc67E07eeB8a,0x9a153C18A5489E97c51f76aF07f07FcB08471A2a
2333,15627848,55923,8294034013,54979,944,138,508,0xD309A8d0498Cc73f53481e46094DC0d3aaB0d9dd,0x918403Accc9F319c724E9e57d016dbA8CA6c7aae
2334,15627848,289451,8294034013,287103,2348,522,1098,0x283Af0B28c62C092C9727F1Ee09c02CA627EB7F5,0x067D3E5459Fa588aA5a5001FC9608b314E7e4A01
2335,15627848,29877,8294034013,29313,564,74,12,0x0e559F7771d8fBD2DdA30a4EAE12C07179907D53,0x0D6006268fd8B3A1aa7160f067d6552410F60695
2336,15627848,150805,8294034013,144153,6652,1810,66,0x00000000006c3852cbEf3e08E8dF289169EdE581,0xacA2630e13FA29336D1833b53a030Eb685E237D3
2337,15627848,274043,8294034013,273031,1012,202,151,0x429CA183C5f4B43F09D70580C5365a6D21ccCd47,0x3682dBbEDFc5a3F91F6e679485939fBeFec6F91A
2338,15627848,60815,8294034013,53271,7544,2514,66,0x00000000006c3852cbEf3e08E8dF289169EdE581,0xC78E80F0E6233F8071848F05F2C7ab37B585D25b
2339,15627848,394961,8294034013,394721,240,74,367,0xf11ED77fD65840b64602526DDC38311E9923c81B,0xc142DC5CEB96f73635D66B62bfde2A0eEa4e4cE1
2340,15627848,235960,8294034013,233176,2784,842,29,0x68b3465833fb72A70ecDF485E0e4C7bD8665Fc45,0x0c2A2Ad71aCD5dCeB8880e33892C8E75D30FE588
2341,15627848,21000,8294034013,21000,0,2,68,0x776eF9896CA7984EE3f713219FA4dD92c160bCe1,0x38a404D2e859572fab457ad9AdF3cd2d4781d718
2342,15627848,79382,8294034013,78786,596,138,16,0xA0b86991c6218b36c1d19D4a2e9Eb0cE3606eB48,0x336157B1E82a8eD38fC2D404B77A7fa3e7ACB312
2343,15627848,21000,8294034013,21000,0,2,155,0x969083465BD287385502CA27f5Fe0359cF7e8d58,0x6fcc8d17b177C95DbbE74F2B00917C200A6A85c2
2344,15627848,46304,8294034013,45660,644,138,97,0x3819f64f282bf135d62168C1e513280dAF905e06,0x6103922E0AEb8a574e09aB549191e5997DC12207
2345,15627848,46859,8294034013,46371,488,138,11,0x197492CCB4B1acaAAcd43432657A17832E36AB49,0xf5B4Fbc8B5A4d193D7cFB3dC0022DBF201654a3c
2346,15627848,351523,8294034013,344959,6564,1802,331,0x00000000006c3852cbEf3e08E8dF289169EdE581,0x8b30675672A85Ca9B01A7397d55c49Dec3240D8c
2347,15627848,177517,8294034013,170601,6916,1810,100,0x00000000006c3852cbEf3e08E8dF289169EdE581,0x85E7377EBc3A15a8b80b8Ae982c0C3732c86D58A
2348,15627848,143335,8294034013,136711,6624,1802,5798,0x00000000006c3852cbEf3e08E8dF289169EdE581,0x2f3A54BF279d3CDc31DD363E380c69346EFd2d9d
2349,15627848,21000,8294034013,21000,0,2,17,0x698f250934CeFf18A8003e28866F18F0CB7F8572,0x36C161dD0a7965F65aEE0d77EAd6E5DDeb872Eb2
2350,15627848,5501353,8294034013,5491521,9832,4042,937,0xc2d38B8aD3FBd0b454b4C6365A3616f7354A15d9,0xDe30040413b26d7Aa2B6Fc4761D80eb35Dcf97aD
2351,15627848,46237,8294034013,45749,488,138,75,0xD33fb3Aa635448117455093E763928a5E93a51E8,0x9CAb85210e4F82f2128c0975429c256e31FdEfC5
2352,15627848,46547,8294034013,46059,488,138,1,0xaE351b8Ae55B69A5007618E598dDe89d0a092c37,0x4449714562F4b18d4c203db528cF50937F9dD8EF
2353,15627848,199952,8294034013,199052,900,266,1406,0xcDA72070E455bb31C7690a170224Ce43623d0B6f,0xeB10F919d15740e4D1a695FF2fF5A239850b351B
2354,15627848,55951,8294034013,55007,944,138,774,0x4764C1FdbfF66c62027Eb3f643c0BE27A1E84cd5,0x9476aed77Db00a375dd75cD3b5D6031E4EB3070A
2355,15627848,46157,8294034013,45669,488,138,2478,0xab28f24812dC22FfCD6FF280f94a3EF5CE1AbAf2,0xA17138c0675173B8Ea506Fb1b96FA754BC316cc2
2356,15627848,46111,8294034013,45623,488,138,285,0xb087EC2cf65fa9372cF61A20602BD37399837985,0xdF5218D0ed3F395e65D0A6e7Bb96C46737149028
2357,15627848,198933,8294034013,192461,6472,1738,503,0x00000000006c3852cbEf3e08E8dF289169EdE581,0x5711328D6Ad4C27D320E0BE0109e9C003Ef0548F
2358,15627848,427416,8294034013,427140,276,74,196,0x65Bf376c5aA79F4DDB911CE94c23DA608DbDFa0E,0x0FDFad2a5265c241e1fe07ffB2942049B6009949
2359,15627848,46077,8294034013,45589,488,138,9602,0x797a48c46Be32aafceDcFD3d8992493D8A1F256b,0xc4C6C27B2259794a1Dd35D438E703281C0e4A004
2360,15627848,21000,8294034013,21000,0,2,48,0xc623483a440A6Fb5C0D41f8E30a9F3dF49a237Ad,0xAC13f1b62D923722C96C08439fcd22c08eCCDDBE
2361,15627848,105000,8294034013,105000,0,2,4121130,0xC34066C7D48e0bBBaa49F5682DaE93682065B6F6,0x0D0707963952f2fBA59dD06f2b425ace40b492Fe
2362,15627848,21000,8294034013,21000,0,2,45,0x15AC5D20f329641d6734d8ee0b398BCb79A9b0A7,0x2771c8d33218038f208B0ab7da04c8413eeF9C69
2363,15627848,46109,8294034013,45621,488,138,11,0xF7b8aabC98D169020b9EE716FC55541cF3e8B55B,0xC277c3Abf7bAC5B8861D8BCF384A1840900a3E1f
2364,15627848,340605,8294034013,318149,22456,3082,537,0x23Ddd3e3692d1861Ed57EDE224608875809e127f,0xa57C927dF5b836D203560A5B568aF75831939Eed
2365,15627848,563335,8294034013,562967,368,138,65,0x386EB78f2eE79AddE8Bdb0a0e27292755ebFea58,0x30379F151e4FE4C50a3Fa15F797A34Db6374b10B
2366,15627848,362487,8257770182,356203,6284,1674,85,0x8e8bd01b5A9eb272CC3892a2E40E64A716aa2A40,0xb99511C730bDcEAF4363F03Db8E520c6CfDaC5F7
2367,15627848,21000,8144197544,21000,0,2,92738,0x4D1af72Eb5E2599c92B8Eec44A6169B982D7Bff3,0xF1300cc9c2Cf347f7902742fEC4dF9dbA952fD7b
2368,15627848,188170,8012582220,186554,1616,402,187,0x1111111254fb6c44bAC0beD2854e76F90643097d,0x20a97121343C7a2CED11f969588aa29d0Aa79007
2369,15627848,63589,7894035013,63325,264,74,970,0xC02aaA39b223FE8D0A0e5C4F27eAD9083C756Cc2,0xb32bD383A8565D8F8eD0DB0dFF4e9f1F7A6Dcd49
2370,15627848,21000,7844034013,21000,0,2,4,0xE8301e81918221219B3B65bEad3096a48AbdDcaE,0xD1B8941Fc6917dC1F287bD7992d6789e8BAE141f
2371,15627848,291844,7794034013,288580,3264,1034,515,0x68b3465833fb72A70ecDF485E0e4C7bD8665Fc45,0x39C05726175DDD0cD6Cf5f1B0B100B3AF0Dfd495
2372,15627848,181476,7794034013,179912,1564,394,2754,0x1Fa8559e873f698292766790AeCf8080A66433F6,0x584456aaB0110A0f1B177D8a1Cde7AFF6D09A292
2373,15627848,181476,7794034013,179912,1564,394,418,0x1Fa8559e873f698292766790AeCf8080A66433F6,0x8d5234D8b4Cd096cdcEF0f150c47b9911be784B8
2374,15627848,155748,7794034013,155544,204,74,906,0x7F9306FC1978938d5C1C57Bf6044dc67E07eeB8a,0x632DF214F78c98D6D627C60CcfcbA83Bc10029C1
2375,15627848,21000,7794034013,21000,0,2,60,0x3C7138eb9c2a3b5f5B293c063eF3Ad07fd1BdB2b,0x17489c27f9ac1C17D3aC7632BFb7A9683D885488
2376,15627848,113310,7794034013,113106,204,74,337,0x5D004ddB5D92938dAF8448b9eac1CaA593cd26Ca,0x26DC5D39Bd7A8bc2d792dcAAAC55FE6DCef25593
2377,15627848,95000,7794034013,94380,620,138,579942,0xdAC17F958D2ee523a2206206994597C13D831ec7,0x74dEc05E5b894b0EfEc69Cdf6316971802A2F9a1
2378,15627848,113310,7794034013,113106,204,74,338,0x5D004ddB5D92938dAF8448b9eac1CaA593cd26Ca,0x26DC5D39Bd7A8bc2d792dcAAAC55FE6DCef25593
2379,15627848,509133,7794034013,480433,28700,9162,32,0x56Dd5bbEDE9BFDB10a2845c4D70d4a2950163044,0x4f0B4c8f8e11CD9967f3d81773ECB14047612aa0
2380,15627848,181476,7794034013,179912,1564,394,3543,0x1Fa8559e873f698292766790AeCf8080A66433F6,0xe66e39343d48aF67fb1679697FCA58b08B638459
2381,15627848,113310,7794034013,113106,204,74,339,0x5D004ddB5D92938dAF8448b9eac1CaA593cd26Ca,0x26DC5D39Bd7A8bc2d792dcAAAC55FE6DCef25593
2382,15627848,21000,7764419574,21000,0,2,29,0x912fD21d7a69678227fE6d08C64222Db41477bA0,0x1b41f5A28Cf8eDB597983e77A237b8930252327D
2383,15627848,307458,7764419574,304834,2624,714,600,0x6fBF1b6A681307f86c2d212f0f6Ad72621309eF1,0xa51461722F5F53276afdF385908c7545D1D3E5cd
2384,15627848,293547,7394034013,283575,9972,3218,32980,0x1111111254fb6c44bAC0beD2854e76F90643097d,0xcefCcA169357a18Eb8c3F230F92b58562e48CAE5
2385,15627848,99262,7276020506,98642,620,138,30,0xA0b86991c6218b36c1d19D4a2e9Eb0cE3606eB48,0xf698E5cCB0dd30B237308aDe3EF1B03e2d4D0937
2386,15627848,21000,7276020506,21000,0,2,65,0x291DfF166cF1101D7781E438C41668A25F063924,0xA79cfE60b6c5B9FAFD14e72B787205EA76Ac6315
2387,15627848,203751,7276020506,202099,1652,402,1,0x1111111254fb6c44bAC0beD2854e76F90643097d,0xfb2A3e7aEdC2297A8E00A23Ed0f0c09b71E648e8
2388,15627848,217068,7276020506,214212,2856,842,2154,0x68b3465833fb72A70ecDF485E0e4C7bD8665Fc45,0x4EF0fA9c1F3E468E942f4ac48da9C5cd2F7be1Fb
2389,15627848,57274,7222373239,56286,988,202,890825,0xA0b86991c6218b36c1d19D4a2e9Eb0cE3606eB48,0x340d693ED55d7bA167D184ea76Ea2Fd092a35BDc
2390,15627848,57274,13717442214,56286,988,202,890826,0xA0b86991c6218b36c1d19D4a2e9Eb0cE3606eB48,0x340d693ED55d7bA167D184ea76Ea2Fd092a35BDc
2391,15627848,51073,7100000000,50465,608,138,0,0xA0b86991c6218b36c1d19D4a2e9Eb0cE3606eB48,0x7A652c36e23c522B5492Db102ED23DDb58720ea0
2392,15627848,21000,7045200645,21000,0,2,150320,0x12C6Fa5891E00601dB3b9Ab76F32f68720992459,0x1C727a55eA3c11B0ab7D3a361Fe0F3C47cE6de5d
2393,15627848,21000,7563214152,21000,0,2,150321,0xca930F1DB39555596Df9DbaF38f1B2897acf89A0,0x1C727a55eA3c11B0ab7D3a361Fe0F3C47cE6de5d
2394,15627848,601903,7045200645,601711,192,74,45,0x8CdD17f52d95551370075a59b27f37b49CFAaFa4,0x490f9d4eb6Bb1439146902c1eFfbE118880d4E8b
2395,15627848,89996,7000000000,89792,204,74,146,0xeb00E99089CEf9A946028BaB6149f73D17b59A08,0xD5c5489EE9109796cF108647937fDb9C5831Fa3E
2396,15627848,1890550,6981502968,309446,1581104,198666,7137,0x1c479675ad559DC151F6Ec7ed3FbF8ceE79582B6,0xa4b1E63Cb4901E327597bc35d36FE8a23e4C253f
2397,15627848,60565,6981502968,59601,964,202,607,0xBC1Cd0D2225a2431A13f9f8081106163B7985100,0xE64011F922E4FCdDDb579887Da1e7322e455C4Ce
2398,15627848,323076,6981502968,160208,162868,20578,183242,0x5E4e65926BA27467555EB562121fac00D24E9dD2,0x6887246668a3b87F54DeB3b94Ba47a6f63F32985
2399,15627848,191095,6958751165,190183,912,266,200,0xd588b586D61C826A0e87919b3D1a239206d58bf2,0x2E243DF4892e05E5C8AAcfB550DC172DDdF8b1A3
2400,15627848,191131,7746462550,190195,936,266,201,0xd588b586D61C826A0e87919b3D1a239206d58bf2,0x2E243DF4892e05E5C8AAcfB550DC172DDdF8b1A3
2401,15627848,21000,6958751165,21000,0,2,1568,0x5fd02BAfa0B840E18e309b8598e06080503A5c3a,0x8193c15Cec9c2F32B3fc1377bE086021247C55c8
2402,15627848,29120,6958751165,28560,560,138,4,0x3819f64f282bf135d62168C1e513280dAF905e06,0x2c0aAd76BF038bc11Cc8DBb0faA24EC0c6aBfEED
2403,15627848,45202,6926865179,44582,620,138,3579,0xdAC17F958D2ee523a2206206994597C13D831ec7,0x4938df248CFd0F259c561Fa5c1d95Af32275DD8e
2404,15627848,21000,6797525426,21000,0,2,0,0xB8001C3eC9AA1985f6c747E25c28324E4A361ec1,0x86D5cFd7b5eE2023CCAeDBF2dacB4161B9157d5D
2405,15627848,21000,6797525426,21000,0,2,0,0xB8001C3eC9AA1985f6c747E25c28324E4A361ec1,0x136b1CDe5aAdDED86ea3F9549A8f1C84453f4e53
2406,15627848,26000,6794034013,26000,0,2,12021,0x388C818CA8B9251b393131C08a736A67ccB19297,0xDAFEA492D9c6733ae3d56b7Ed1ADB60692c98Bc5
2407,15627849,181456,7629325279,180824,632,90,103240,0x01FF6318440f7D5553a82294D78262D5f5084EFF,0x5AA17fC7F2950ECa85376C3A8CB1509e8e4B39dF
2408,15627849,214451,9629325279,212415,2036,522,346,0x7a250d5630B4cF539739dF2C5dAcb4c659F2488D,0x788296BAb7c874416c34BB5d7Bc0eb2170c97334
2409,15627849,171597,156480484775,170645,952,130,103241,0x01FF6318440f7D5553a82294D78262D5f5084EFF,0x5AA17fC7F2950ECa85376C3A8CB1509e8e4B39dF
2410,15627849,21000,30000000000,21000,0,2,1005595,0x4cb4F8F7E333d994Ca18cbC8AC8d4640233c9ebC,0xc5a93444Cc4dA6EfB9e6FC6e5D3CB55A53b52396
2411,15627849,21000,30000000000,21000,0,2,1005596,0xe725f5e8Ad5a6E2dBFD88B4d6460D3729e1E60c8,0xc5a93444Cc4dA6EfB9e6FC6e5D3CB55A53b52396
2412,15627849,21000,30000000000,21000,0,2,1005597,0x6384038a79C7bd9DF79b8E364603086fD964E8d5,0xc5a93444Cc4dA6EfB9e6FC6e5D3CB55A53b52396
2413,15627849,21000,30000000000,21000,0,2,47542,0xE2f485129ef5871CA79fcAB08628E0c8660FddAa,0x4A8F1F5B2A3652131eAc54a6f183A4a2cF44A9A6
2414,15627849,21000,30000000000,21000,0,2,1005598,0x115AAfEE2afE15afc52c12b3e16556ccff7888f4,0xc5a93444Cc4dA6EfB9e6FC6e5D3CB55A53b52396
2415,15627849,239364,7629325279,237192,2172,650,116839,0xA69babEF1cA67A37Ffaf7a485DfFF3382056e78C,0x6046945C5B5eF5933b8E73a98A6AD7bF3e031df7
2416,15627849,100000,15000000000,100000,0,2,63217,0xbCa96f4D7129512D195Ebc65D537FC2324835822,0x80C67432656d59144cEFf962E8fAF8926599bCF8
2417,15627849,21000,14400000000,21000,0,2,31531,0x5F03f753021b039aB8980E6bF6C04a5bbe2Db247,0x52b4567c37b48D51198B25CaA6e79e4fDa6D9734
2418,15627849,90000,14000000000,89392,608,138,2,0xdAC17F958D2ee523a2206206994597C13D831ec7,0xaac22D4Cfe4E62fba6CE5b1ab1561c4023FFFea6
2419,15627849,108362,13000000000,107322,1040,138,5682,0x5650CA3f0289C762F83DdE1894faA9b6d0d89798,0xe2A61FEcD0C671437dc486D6ceD280C1a13873C5
2420,15627849,222222,12000000000,220658,1564,394,303,0x1Fa8559e873f698292766790AeCf8080A66433F6,0x81cc5490534FD1afEf84B81C86396566540dcbdB
2421,15627849,55729,11963688090,54785,944,138,0,0xB62132e35a6c13ee1EE0f84dC5d40bad8d815206,0x1eA3eB2aebC5D3bD39d3cC514A3Ef0EC825Ae542
2422,15627849,350000,11963688090,349368,632,138,6925033,0x8207c1FfC5B6804F6024322CcF34F29c3541Ae26,0x46340b20830761efd32832A74d7169B29FEB9758
2423,15627849,350000,11963688090,349404,596,138,6925034,0xdAC17F958D2ee523a2206206994597C13D831ec7,0x46340b20830761efd32832A74d7169B29FEB9758
2424,15627849,63000,11344504421,63000,0,2,183631,0x4824fDCE572529F0A36FBb5A085ed33641e78882,0x25eAff5B179f209Cf186B1cdCbFa463A69Df4C45
2425,15627849,100000,11312429292,99380,620,138,181431,0x473037de59cf9484632f4A27B509CFE8d4a31404,0x6238872A0Bd9F0E19073695532a7Ed77ce93C69E
2426,15627849,21000,10994297549,21000,0,2,11,0xCBD6832Ebc203e49E2B771897067fce3c58575ac,0xB556C773719fF3a0474cb74E615fCCF8b52ca387
2427,15627849,21000,10994297549,21000,0,2,53,0xCBD6832Ebc203e49E2B771897067fce3c58575ac,0x73653a0188ef234Fe83Da44B260FE3616A593813
2428,15627849,21000,10629325279,21000,0,2,0,0xF8956f7c427Ea6f2dc4B022e6b4a6B6EFEBcc4be,0xdffD0E2b4CC072Bc5Df2460b429b1543bd1044A6
2429,15627849,46121,10629325279,45501,620,138,0,0xdAC17F958D2ee523a2206206994597C13D831ec7,0x3F041d4d6D16A4c1bF81648F29c9C4752AFE0666
2430,15627849,46121,10629325279,45501,620,138,0,0xdAC17F958D2ee523a2206206994597C13D831ec7,0x66B85D8501892a7d9DBC8431304220928E73155A
2431,15627849,399984,8960000000,392880,7104,2186,152,0x68b3465833fb72A70ecDF485E0e4C7bD8665Fc45,0x156338886A8d4a2f305f9Be51Ccc55c2d120698a
2432,15627849,302559,12222968346,300887,1672,256,5122,0x507888e987257a8DdE6F8AFa46375CEfe2CbF504,0x678111a6cA5749f1744b5E080A855CEC8d631E20
2433,15627849,117738,10129325279,117534,204,74,19,0x7F9306FC1978938d5C1C57Bf6044dc67E07eeB8a,0x75646014293177849f306221e48654bA22C2c554
2434,15627849,21000,10000000000,21000,0,2,0,0xC88F7666330b4b511358b7742dC2a3234710e7B1,0xC77e17afc13C12b04927b94a78D5ABad213E30bf
2435,15627849,174344,9629325279,168516,5828,1170,3765,0xDef1C0ded9bec7F1a1670819833240f027b25EfF,0xc7c42E765017De6d08887D92E5cdc9843aA5888D
2436,15627849,30732,9629325279,30668,64,10,95,0xC02aaA39b223FE8D0A0e5C4F27eAD9083C756Cc2,0x8A12fFf62021b421bE54C777C42F2D75a8dFaE87
2437,15627849,21000,9629325279,21000,0,2,52375,0xDb0DbD38022f6451Df4720725310e486ac19ba6d,0x7c195D981AbFdC3DDecd2ca0Fed0958430488e34
2438,15627849,21000,9629325279,21000,0,2,8804462,0xe6f5e2a53A5A43aF808Bb9E967045E67b07e16ae,0x3cD751E6b0078Be393132286c442345e5DC49699
2439,15627849,46097,9629325279,45501,596,138,14926,0xdAC17F958D2ee523a2206206994597C13D831ec7,0x02d24cAB4f2c3Bf6e6EB07ea07e45F96baccFfE7
2440,15627849,21000,9629325279,21000,0,2,1228776,0x23368B6fc26D637e5b377f17E5d7C66c726F7027,0x71660c4005BA85c37ccec55d0C4493E66Fe775d3
2441,15627849,21000,9629325279,21000,0,2,8804463,0x27dc9e8490b89ed7B6eBB8c38caF3eb312C4872e,0x3cD751E6b0078Be393132286c442345e5DC49699
2442,15627849,207128,9629325279,207128,0,2,3199169,0x8b69158Da99557752f7d8d885C08F33f5c6c78a8,0x9696f59E4d72E237BE84fFD425DCaD154Bf96976
2443,15627849,207128,9629325279,206460,668,138,4708690,0x95aD61b0a150d79219dCF64E1E6Cc01f0B64C4cE,0x28C6c06298d514Db089934071355E5743bf21d60
2444,15627849,207128,9629325279,207128,0,2,4468935,0xEb3635e17C7Bef62a190C2873dBac8A5F7361DFe,0x21a31Ee1afC51d94C2eFcCAa2092aD1028285549
2445,15627849,207128,9629325279,207128,0,2,1679522,0xE170dA9eA20A5D01ae045ad7C77958Efc63f977b,0x4976A4A02f38326660D17bf34b431dC6e2eb2327
2446,15627849,207128,9629325279,207128,0,2,3492269,0x3355a4d4d3aA6Bf99aAb6f40b341cea0436064fE,0x56Eddb7aa87536c09CCc2793473599fD21A8b17F
2447,15627849,207128,9629325279,206508,620,138,4232323,0xdAC17F958D2ee523a2206206994597C13D831ec7,0xDFd5293D8e347dFe59E90eFd55b2956a1343963d
2448,15627849,201684,9629325279,195108,6576,1802,3494,0x00000000006c3852cbEf3e08E8dF289169EdE581,0xecBdE5878A4127b8DeF2AF355dc7e2be5311F904
2449,15627849,30732,9629325279,30668,64,10,1167,0xC02aaA39b223FE8D0A0e5C4F27eAD9083C756Cc2,0x4337878a01844311c874259CF527757678E19A8D
2450,15627849,100000,9629325279,99024,976,202,88934,0xdAC17F958D2ee523a2206206994597C13D831ec7,0x3018018c44338B9728d02be12d632C6691E020d1
2451,15627849,207128,9629325279,206484,644,138,4468936,0x0b38210ea11411557c13457D4dA7dC6ea731B88a,0x21a31Ee1afC51d94C2eFcCAa2092aD1028285549
2452,15627849,207128,9629325279,207128,0,2,4708691,0x211C46F06000901d427ce51ABecB463A2c026e14,0x28C6c06298d514Db089934071355E5743bf21d60
2453,15627849,207128,9629325279,207128,0,2,3199170,0x9B90c3230465CeD747765AC02784b278244063E1,0x9696f59E4d72E237BE84fFD425DCaD154Bf96976
2454,15627849,207128,9629325279,206520,608,138,3492270,0xdAC17F958D2ee523a2206206994597C13D831ec7,0x56Eddb7aa87536c09CCc2793473599fD21A8b17F
2455,15627849,207128,9629325279,207128,0,2,4232324,0x1453169a1B1Fb2160B4c64E573c2296CB131143A,0xDFd5293D8e347dFe59E90eFd55b2956a1343963d
2456,15627849,207128,9629325279,206472,656,138,4468937,0x4e3FBD56CD56c3e72c1403e103b45Db9da5B9D2B,0x21a31Ee1afC51d94C2eFcCAa2092aD1028285549
2457,15627849,207128,9629325279,206484,644,138,4708692,0x3845badAde8e6dFF049820680d1F14bD3903a5d0,0x28C6c06298d514Db089934071355E5743bf21d60
2458,15627849,207128,9629325279,206520,608,138,4232325,0x15D4c048F83bd7e37d49eA4C83a07267Ec4203dA,0xDFd5293D8e347dFe59E90eFd55b2956a1343963d
2459,15627849,70000,9629325279,69392,608,138,522,0xdAC17F958D2ee523a2206206994597C13D831ec7,0xf5491f793D47A6Ea22f5e0B9AD3990CF66c4b40B
2460,15627849,60842,9629325279,59898,944,138,0,0x4Fabb145d64652a948d72533023f6E7A623C7C53,0x3E9A02FfcB1699B82C0861E047053D393Df88E0E
2461,15627849,70000,9629325279,69416,584,138,4,0xdAC17F958D2ee523a2206206994597C13D831ec7,0x9D395ca570F6069FBe6DEcb675490b969B98F111
2462,15627849,181476,9629325279,179912,1564,394,19,0x1Fa8559e873f698292766790AeCf8080A66433F6,0x5d0db282fc6BD07336B78Bf16e96b49A20Ccdef9
2463,15627849,42000,9629325279,42000,0,2,329519,0x4B6D3b1aABFC3b165a04827E207DF577727A3980,0x9430801EBAf509Ad49202aaBC5F5Bc6fd8A3dAf8
2464,15627849,46507,9629325279,45563,944,138,68,0xf7A0383750feF5AbaCe57cc4C9ff98e3790202b3,0x5012e2f6b9d81e96622BFA2F2764fcB406d8e6C1
2465,15627849,288174,9629325279,285838,2336,522,31,0x283Af0B28c62C092C9727F1Ee09c02CA627EB7F5,0xA808AdD1FAFb2D4f8B25895c2733A518771635Ba
2466,15627849,56659,9629325279,55715,944,138,468,0xAD13C2a8d418d01F3236F4d8b9d724575a4e9d24,0xF4aac9421fb27d6f969015333EEE52BceD4A0c82
2467,15627849,237585,9629325279,233993,3592,1162,775,0x68b3465833fb72A70ecDF485E0e4C7bD8665Fc45,0x9476aed77Db00a375dd75cD3b5D6031E4EB3070A
2468,15627849,21000,9629325279,21000,0,2,20,0xA84Cef55303F847e9b8A6F4aEFae52F8bAF88B63,0x653AD40458C400d7a8061802aFb73b72eb2e63FA
2469,15627849,500000,9629325279,498284,1716,458,542321,0xa24787320ede4CC19D800bf87B41Ab9539c4dA9D,0xAe2D4617c862309A3d75A0fFB358c7a5009c673F
2470,15627849,256574,9629325279,253174,3400,970,637,0x68b3465833fb72A70ecDF485E0e4C7bD8665Fc45,0x514E494c86F9249CfDc0e072f71f71a97cf33e65
2471,15627849,54087,9629325279,53143,944,138,365,0x18aAA7115705e8be94bfFEBDE57Af9BFc265B998,0x4C86150C946c8FA03c9E5117B130C765ca5e5d72
2472,15627849,21000,9541619528,21000,0,2,11,0x61d29CE6aF17ABABfc03016c22b62c0b38b1fB0A,0x3261E0c425a79F328C1301D1E3e4928ab9B8EC9A
2473,15627849,84000,9469681496,83392,608,138,196,0xA0b86991c6218b36c1d19D4a2e9Eb0cE3606eB48,0xDb5c82032A1Da28166E86Fb75a34d72fdc58cf01
2474,15627849,75851,9440000000,75243,608,138,2,0xdAC17F958D2ee523a2206206994597C13D831ec7,0x75B8a447E784Da6d6b4074b3C3D49E62974BeE1a
2475,15627849,183027,9429325279,181107,1920,458,14,0xDEF171Fe48CF0115B1d80b88dc8eAB59176FEe57,0x4082F31be15209EeE22595C9597942f142045EB8
2476,15627849,150000,9388132081,149392,608,138,48,0x473037de59cf9484632f4A27B509CFE8d4a31404,0x39E0327CDb2662FcbD9A3DF7E1988Fe3598b9b97
2477,15627849,740000,9303582852,728872,11128,2506,9991,0xdc63118C7cA866aFbfaD3F4D2EF86A401D7692ae,0x52e77F4356bB39cBA841dC3E9c28eCe86900d68A
2478,15627849,270156,9129325280,266348,3808,970,119828,0xa57Bd00134B2850B2a1c55860c9e9ea100fDd6CF,0xeCa2e2D894D19778939bD4DfC34D2a3C45E96456
2479,15627849,179505,9274564538,177725,1780,274,17621,0x0eae044f00B0aF300500F090eA00027097d03000,0x74067744295a1b9D440E900E1Af660c90150D510
2480,15627849,920218,9152840815,919526,692,138,137,0x57c411e9a358e2d2d0a6b058cEDb709175e8fd16,0x480e6141Ea196Ca6aad3235fc9ffCc51f17A2aD1
2481,15627849,148058,9129325279,141446,6612,1802,105,0x00000000006c3852cbEf3e08E8dF289169EdE581,0x3b6915847D3c961de0f8BF994BeBb84A0e2f4929
2482,15627849,21000,9129325279,21000,0,2,141,0x94F68aa774b6f71C67bA0A699809E0dBBcbc997E,0x50dc990680ff369dB44e6a0B078BF31c8B5631dD
2483,15627849,86786,9129325279,85842,944,138,185,0xC011a73ee8576Fb46F5E1c5751cA3B9Fe0af2a6F,0x6BfE59e8fEaDDfBdBb97F7Da8c6B4550a8bD4ffd
2484,15627849,80000,9129325279,79344,656,138,579943,0xBBbbCA6A901c926F240b89EacB641d8Aec7AEafD,0x74dEc05E5b894b0EfEc69Cdf6316971802A2F9a1
2485,15627849,94813,9129325279,94205,608,138,4,0xdAC17F958D2ee523a2206206994597C13D831ec7,0x7Cd5E31875A0F3D96D01A8bcDD074844593C2434
2486,15627849,21000,9129325279,21000,0,2,160,0xbd1849da28B0BB78E61612c54B36C1d607Cf0D3D,0x06859Cf8D2feCdC74D386f4c2B83a5d5EEbFC41c
2487,15627849,123784,9129325279,122816,968,330,97,0x4e32004D8b81847A670b4a1778ACe4dCF2bBA01E,0x066DC123977849dF818ed709B375E73123E45179
2488,15627849,142995,9129325279,136407,6588,1802,109,0x00000000006c3852cbEf3e08E8dF289169EdE581,0xCc1dD65746D5910362bE6201D598BE868C83dF32
2489,15627849,132374,9129325279,126290,6084,1682,76,0x00000000006c3852cbEf3e08E8dF289169EdE581,0xd47eA9310429F7e255CE39d464BfaB9ffCF002eF
2490,15627849,401959,9129325279,398343,3616,1162,4,0x68b3465833fb72A70ecDF485E0e4C7bD8665Fc45,0xB4d60E7EbCaA8B0b8859e75Ad68E6F41f1824D99
2491,15627849,192710,9129325279,186190,6520,1738,11,0x00000000006c3852cbEf3e08E8dF289169EdE581,0xE6ED54146799BB0CAB6971D1bFFAE9c069f96dcF
2492,15627849,143796,9129325279,143592,204,74,5,0x7F9306FC1978938d5C1C57Bf6044dc67E07eeB8a,0xD9C3F73039B5358B893600c5D9cFF1299Ef91B5b
2493,15627849,21000,9129325279,21000,0,2,0,0x64f03e08c39C3794e146e93de5c015fE0bF144fc,0xb023baCa081f80F9cd856c30719fC6bDC10dD9F1
2494,15627849,108769,9129325279,104693,4076,1290,348,0x0000000000c2d145a2526bD8C716263bFeBe1A72,0x7dC94cF8962955D6F7e3F316Ebd052837426144D
2495,15627849,54007,9129325279,53291,716,138,44,0xE7f58A92476056627f9FdB92286778aBd83b285F,0xCEE4E58A05CB74cD553F3b3728Fc78f3C645085B
2496,15627849,21000,9129325279,21000,0,2,120,0x604501403f4bcE44e2E37Cf9E42d605F11a165c5,0xD505E4ea7bda12683f10AF9a4f6F5Be06413eEAd
2497,15627849,21000,9129325279,21000,0,2,775,0x31fc849F372b69C19E613B812CEb047591675B7B,0x9Fc1Bd284c8DFB757Df0fC63Da33b35B5A711a11
2498,15627849,46171,9129325279,45683,488,138,442,0x07ce5D64B7b845C8ff645E9A3825f94e6BDd82F1,0x090882db986Fc820404962d6b8E4AEF615eB4ade
2499,15627849,236352,9129325279,233580,2772,842,334,0x68b3465833fb72A70ecDF485E0e4C7bD8665Fc45,0xC2678dD17D570D961F971762eEDfe27467BbA01B
2500,15627849,162083,9129325279,155483,6600,1802,5,0x00000000006c3852cbEf3e08E8dF289169EdE581,0x6907bfE60cEc040688c59A729be002BE00C9e1Cc
2501,15627849,261721,9129325279,261517,204,74,17,0x55f1C36Bb7aE0d7D6caE97902E30A2306686Ec73,0x1034B8C85e2b5da2ecf64E20100a46Cc33E1DD97
2502,15627849,427958,9129325279,424390,3568,970,228,0x68b3465833fb72A70ecDF485E0e4C7bD8665Fc45,0xa7C1d32B4bB7155Ad5e9e53F472b9CE61BB37ddc
2503,15627849,21000,9129325279,21000,0,2,69,0x51Be9Fe668840894101c24c2Af819528fDE7d491,0x38a404D2e859572fab457ad9AdF3cd2d4781d718
2504,15627849,55888,9129325279,54944,944,138,292,0xF345754D715fb208F7b3965FA5fA0B4Cff2dFE8f,0xd8d415806d20a7D1d28758C6BD73285ef2657888
2505,15627849,46148,9129325279,45660,488,138,2479,0xC23b12EBA3af92dc3Ec94744c0c260caD0EeD0e5,0xA17138c0675173B8Ea506Fb1b96FA754BC316cc2
2506,15627849,55978,9129325279,55034,944,138,78,0xd4cB651749953988647eEE9b51DDB8DB5aeb3410,0x5207C8D3C61b6eC0e17b58444b520834B868261F
2507,15627849,55584,9129325279,54928,656,138,39,0x0198f46f520F33cd4329bd4bE380a25a90536CD5,0xf8b4881c5d87689bF76B9356a6BA31a0634D4828
2508,15627849,249837,9129325279,243809,6028,1738,351,0x68b3465833fb72A70ecDF485E0e4C7bD8665Fc45,0x3Db4Ff50e300Fb4a4AFBbf511ebc680e69378c3A
2509,15627849,919398,9129325279,918370,1028,330,401,0xd446A98F88E1d053d1F64986E3Ed083bb1Ab7E5A,0x1CeD4e3900c73A54eD775ef2740a4e38aC5b54e2
2510,15627849,227616,9129325279,224892,2724,842,87,0x68b3465833fb72A70ecDF485E0e4C7bD8665Fc45,0x5F8345a6a207DC5b977eB159E33061B5f4165622
2511,15627849,88491,9129325279,85215,3276,1034,96,0x0000000000c2d145a2526bD8C716263bFeBe1A72,0x7777777a1E09efc49C97072B1774d7c4C2eCe81d
2512,15627849,98494,9129325279,97998,496,202,32,0x19Db87284563aF276605e04f82D1a41073Bc3Db2,0xA58Df0CCEC971A9049D313535508e29d0C388509
2513,15627849,52183,9129325279,51611,572,138,44,0x0E32cEE0445413e118b14d02E0409303D338487a,0xD618A0da87593d5Ea4830bA45bD21E5F62318fB3
2514,15627849,535062,9129325279,531922,3140,906,20,0x68b3465833fb72A70ecDF485E0e4C7bD8665Fc45,0xB715cdB77806d154D4cEf39B7374f98054Bcc298
2515,15627849,60739,9129325279,53271,7468,2506,34,0x00000000006c3852cbEf3e08E8dF289169EdE581,0x8dacC95548541b5AF2ca8d35EA52E5e364854849
2516,15627849,289318,9129325279,286946,2372,522,779,0x283Af0B28c62C092C9727F1Ee09c02CA627EB7F5,0x57b8734F103eEEaD3A699656e2C2Ef031aEd9508
2517,15627849,21000,9129325279,21000,0,2,93,0xB401EDDb11b34c2ee6498fE5070DF316b68c8Bed,0x096D07fa54BaBFC1c2e4f019D6cb684cE78D00f2
2518,15627849,209826,9129325279,209458,368,138,76,0xC549d87E9CEA28961927436a2B7D6944f7CA86eb,0xE25Bb9DaeBaE9832D0BB820d3cc69b423F036F74
2519,15627849,123424,9129325279,121032,2392,394,272,0x000000000000509081d6FCD3ee63e791aD1db763,0xc609ED8bD4384b0822267c9fE4Ac04F768FEE0Ca
2520,15627849,21000,9129325279,21000,0,2,1747,0x8E6E547Fe0784940EC1A3d47A0BcE4234e91faA7,0xa26E6AFd9a12290e282f4Ab7E0FaE93B29fC8466
2521,15627849,21000,9129325279,21000,0,2,814,0x229D70Bc1ca126F854Aa9DF814af1844495bc77A,0xf9EEdDAA063cc799A80aDa98E17670Aef29E24c9
2522,15627849,21000,9129325279,21000,0,2,210,0xA4788a906CB428e371E28443AAc5bEfC314e5B71,0xCaaF8d01C55df01B897437093EAfE09810cCa6Fa
2523,15627849,21033,9000000000,21033,0,2,58,0x71Ed4E8517f327eFee735C1C4F26d520B7B48575,0xF92C916AB375a65b61a0E8A0C2420E13BbF23915
2524,15627849,684800,9000000000,680120,4680,1226,59,0xC36442b4a4522E871399CD717aBDD847Ab11FE88,0x680CfEA894cD0Bd8491c348795fa791F7386d235
2525,15627849,21000,8981502968,21000,0,2,297,0x677242C324A2B3008882EbC8a3e8D5aB621Cf0a1,0xa695A3c52773cEF134521FdCb3534648b090A481
2526,15627849,245101,8847873486,233081,12020,3858,271,0x1111111254fb6c44bAC0beD2854e76F90643097d,0x85b90a9Aad3EEF15CEA4a57cc8c7a055eF3f3721
2527,15627849,21000,8841325279,21000,0,2,113034,0xB712602574855067a77b003cf323cA37b0f05BB2,0x6081258689a75d253d87cE902A8de3887239Fe80
2528,15627849,21000,9130325279,21000,0,2,113035,0x2137c705D0b448F4C94CAF801C17b84ef0E4FC8a,0x6081258689a75d253d87cE902A8de3887239Fe80
2529,15627849,21000,8841325279,21000,0,2,38439,0xae4B4332fB78162C3512Eb53CAe038D1BAC135De,0xc341F250edbba5921F6491fAca4e16FE8b4CEd14
2530,15627849,120000,8629325279,119392,608,138,0,0xdAC17F958D2ee523a2206206994597C13D831ec7,0x8e136f33163008aD6CCcd23271e8f0573E557fA0
2531,15627849,113310,8629325279,113106,204,74,340,0x5D004ddB5D92938dAF8448b9eac1CaA593cd26Ca,0x26DC5D39Bd7A8bc2d792dcAAAC55FE6DCef25593
2532,15627849,175110,8629325279,173546,1564,394,197,0x1Fa8559e873f698292766790AeCf8080A66433F6,0xf55c68F74738E318e034F62B0Cb6fE6d0e1Ea27F
2533,15627849,250000,8629325279,250000,0,2,45337052,0xDb106534e9ed607D01Ff42ac52cC0005EfF41ec6,0xEA674fdDe714fd979de3EdF0F56AA9716B898ec8
2534,15627849,250000,8629325279,250000,0,2,45337053,0xdD6CDd564C4a9B5eB22D4F5598C35835e8d7F556,0xEA674fdDe714fd979de3EdF0F56AA9716B898ec8
2535,15627849,250000,8629325279,250000,0,2,45337054,0x584a42962399536606fB375ab6CE88D6Fb0e51c4,0xEA674fdDe714fd979de3EdF0F56AA9716B898ec8
2536,15627849,250000,8629325279,250000,0,2,45337055,0x9F6E27939364e40298658d4AcA88F25FadFb035F,0xEA674fdDe714fd979de3EdF0F56AA9716B898ec8
2537,15627849,250000,8629325279,250000,0,2,45337056,0xc204f9Da79f0aFC494068792FDe24FD32510F81A,0xEA674fdDe714fd979de3EdF0F56AA9716B898ec8
2538,15627849,250000,8629325279,250000,0,2,45337057,0x68D946171977f4ab32eA903DA5aB2fe0fFAE019d,0xEA674fdDe714fd979de3EdF0F56AA9716B898ec8
2539,15627849,113310,8629325279,113106,204,74,341,0x5D004ddB5D92938dAF8448b9eac1CaA593cd26Ca,0x26DC5D39Bd7A8bc2d792dcAAAC55FE6DCef25593
2540,15627849,250000,8629325279,250000,0,2,45337058,0x8c0b5e74CD0334E080C34bA2e1A2597bfA2D5916,0xEA674fdDe714fd979de3EdF0F56AA9716B898ec8
2541,15627849,250000,8629325279,250000,0,2,45337059,0x550Ac4119cEEEf2E0fC0F0950b22AE5d874d49E3,0xEA674fdDe714fd979de3EdF0F56AA9716B898ec8
2542,15627849,250000,8629325279,250000,0,2,45337060,0xCA73f238283c014dEDaD193E3c35723E1AF8a259,0xEA674fdDe714fd979de3EdF0F56AA9716B898ec8
2543,15627849,250000,8629325279,250000,0,2,45337061,0x20582Fdd1c80DD32CBa993C6EB937BDb4583bd69,0xEA674fdDe714fd979de3EdF0F56AA9716B898ec8
2544,15627849,250000,8629325279,250000,0,2,45337062,0x6A901b1fDa71181E669EeA3a07F54586C7348959,0xEA674fdDe714fd979de3EdF0F56AA9716B898ec8
2545,15627849,113310,8629325279,113106,204,74,342,0x5D004ddB5D92938dAF8448b9eac1CaA593cd26Ca,0x26DC5D39Bd7A8bc2d792dcAAAC55FE6DCef25593
2546,15627849,49267,8629325279,48779,488,138,407,0x7DF64F69544c5bf71171dc5ab69b8602C2FF1E27,0x2d42e1EeC1c61dD9d1dDff2405E91BA6179Aa0B8
2547,15627849,113310,8629325279,113106,204,74,343,0x5D004ddB5D92938dAF8448b9eac1CaA593cd26Ca,0x26DC5D39Bd7A8bc2d792dcAAAC55FE6DCef25593
2548,15627849,113310,8629325279,113106,204,74,344,0x5D004ddB5D92938dAF8448b9eac1CaA593cd26Ca,0x26DC5D39Bd7A8bc2d792dcAAAC55FE6DCef25593
2549,15627849,147661,8629325279,147445,216,74,169,0x03893669C978033544a160718E3d1a3226845de6,0xCEF557e276AE24293904BA0F2bbbD1FBa8Ef3338
2550,15627849,113310,8629325279,113106,204,74,345,0x5D004ddB5D92938dAF8448b9eac1CaA593cd26Ca,0x26DC5D39Bd7A8bc2d792dcAAAC55FE6DCef25593
2551,15627849,21000,8502686293,21000,0,2,62,0xBD11C58917F6D942dB3354f5Ac1A658219A4260f,0x51Dd6D50C0C46564a792028FDDf10E61573c0630
2552,15627849,100000,8400000000,99024,976,202,259897,0xdAC17F958D2ee523a2206206994597C13D831ec7,0x292f04a44506c2fd49Bac032E1ca148C35A478c8
2553,15627849,21000,8400000000,21000,0,2,2,0x6DA9d7d63883da200a8875a3c16D27265590C9b4,0x7DC4cEea0cFCf607f596c542574A3973daE06f5B
2554,15627849,76208,8375745197,75636,572,138,12,0x7b36f716a51F63FdbEe1EdCc5eB407B3C1e90684,0xA712aE74F01D7C2ebA7D9d1052122202E2D7AB1D
2555,15627849,21000,8354150573,21000,0,2,381,0xE5FdBdb64E422aC6CB048B8f0917244968253F39,0x89e496b88E241831f750AaA8a111e03D6d36dB04
2556,15627849,189972,8354150573,189908,64,10,0,0x2cac916b2A963Bf162f076C0a8a4a8200BCFBfb4,0x8Ce96164F6338A92C895678B458B3Aad09dCB522
2557,15627849,46097,8295781481,45501,596,138,102466,0xdAC17F958D2ee523a2206206994597C13D831ec7,0x21Dd5c13925407e5bCec3f27aB11a355a9Dafbe3
2558,15627849,21000,8111311772,21000,0,2,67,0xF24ef785c962d562C189A51aF3fc6e6a2c97d4C0,0xE83bC412E30c7d9f9502545924b1288F8EA52e51
2559,15627849,52285,8111311772,51641,644,138,20,0x4a220E6096B25EADb88358cb44068A3248254675,0xe8964A300ba8c5Ca28d18c0314544e7498D9d81A
2560,15627849,21000,8111311772,21000,0,2,7,0xc11cc6a2c330FB99506F93971352c07ff48d0Cae,0x26680AfD0d2461e4cfcBd61eB2532948A08dCfcf
2561,15627849,76902,8111311772,76258,644,138,8,0x090185f2135308BaD17527004364eBcC2D37e5F6,0x8d6AC550321418A6F35f4328A796CA1575a57028
2562,15627849,229071,7979170757,225467,3604,1162,256,0x68b3465833fb72A70ecDF485E0e4C7bD8665Fc45,0xd58fDD267f67D5c62f2D8B488Ee10aa4670018F5
2563,15627849,3118927,7858205037,3117075,1852,586,2195,0xADb5401CB913a78d0bA161C1Af66Ac35243b6d1c,0xD7924a51Ad327Fd8B3F680F5CC74BD66Ba784a88
2564,15627849,26000,7629325279,26000,0,2,12022,0xE94f1fa4F27D9d288FFeA234bB62E1fBC086CA0c,0xDAFEA492D9c6733ae3d56b7Ed1ADB60692c98Bc5
2565,15627850,794319,38586841000,792379,1940,522,13,0x7a250d5630B4cF539739dF2C5dAcb4c659F2488D,0xa3c7243691a24003A5b038126E75340fB5FF85BF
2566,15627850,205686,17541619528,203862,1824,458,219,0xEfF92A263d31888d860bD50809A8D171709b7b1c,0xC3685D3B1e380677AbbD7d62EF32eaCa851C902C
2567,15627850,5049432,17000000000,5042320,7112,1098,279,0x0a39DA505DfB5E0BBc6bd84428281A8ba1bC7753,0x495E889d1A6cEB447a57dcc1C68410299392380c
2568,15627850,82271,14840374600,81663,608,138,0,0x467719aD09025FcC6cF6F8311755809d45a5E5f3,0xEA70d7BE6bbafC08635F11ff2bb11EDEA77D80E5
2569,15627850,82271,14840374600,81675,596,138,1,0x467719aD09025FcC6cF6F8311755809d45a5E5f3,0x46B5C369817FF83EF679644d02B32f9d047D006d
2570,15627850,82271,14840374600,81663,608,138,0,0x467719aD09025FcC6cF6F8311755809d45a5E5f3,0x5Bd73f3c7602FA0aa4c434d29a89932d6132480F
2571,15627850,595911,13370000000,589699,6212,1482,377,0x76f4eeD9fE41262669D0250b2A97db79712aD855,0xabC67a49D7d75bD04fA1DAE22cD4b8c4F796540a
2572,15627850,105000,12820896229,104404,596,138,5441,0xdAC17F958D2ee523a2206206994597C13D831ec7,0x97b9D2102A9a65A26E1EE82D59e42d1B73B68689
2573,15627850,500000,12606841000,499056,944,138,347,0xD309A8d0498Cc73f53481e46094DC0d3aaB0d9dd,0x788296BAb7c874416c34BB5d7Bc0eb2170c97334
2574,15627850,21000,12000000000,21000,0,2,58,0x75e89d5979E4f6Fba9F97c104c2F0AFB3F1dcB88,0x3fcb73fB2b7Aeed628f37dAB031E1516Bb7e0053
2575,15627850,21000,12000000000,21000,0,2,6,0x75e89d5979E4f6Fba9F97c104c2F0AFB3F1dcB88,0x9b4a766C5c7728CE7Df70d5DB609b61F22d192D8
2576,15627850,63000,11309677429,63000,0,2,2710049,0xBF97A4Ce44904c3bC85E4Ae076f8FAc84FD7c6B0,0xC098B2a3Aa256D2140208C3de6543aAEf5cd3A94
2577,15627850,21000,10930780845,21000,0,2,152,0xCBD6832Ebc203e49E2B771897067fce3c58575ac,0x5684FbAA8B8Be7B4dd5a934cCAFA0B90A2888EF7
2578,15627850,1000000,10586841000,996180,3820,970,4805,0x3CACa7b48D0573D793d3b0279b5F0029180E83b6,0x160694f252B907CDf3862922950142a5f1Fd161a
2579,15627850,21000,10000000000,21000,0,2,1,0x39F6a6C85d39d5ABAd8A398310c52E7c374F2bA3,0x118630295d65715d69CbB2adC99cf94c642E1d77
2580,15627850,21000,9966841000,21000,0,2,0,0x27315f5F282c31fBADE4aE952d2631C05cD3a26F,0x0e8c83C39D46935Cf795A79973182439E9C21180
2581,15627850,21000,9780000000,21000,0,2,0,0x6dfc34609a05bC22319fA4Cce1d1E2929548c0D7,0xa8E1Cee40Cb3419F0d1F1A8bc400Cb7396e7125e
2582,15627850,21000,9780000000,21000,0,2,0,0x6dfc34609a05bC22319fA4Cce1d1E2929548c0D7,0x25D26E77Ca7b80a8097Af03f36c61967D5dE1366
2583,15627850,332620,9586841000,326656,5964,1676,366,0x881D40237659C251811CEC9c364ef91dC08D300C,0x4C86150C946c8FA03c9E5117B130C765ca5e5d72
2584,15627850,46280,9586841000,45420,860,138,11,0xC02aaA39b223FE8D0A0e5C4F27eAD9083C756Cc2,0x1f41509DC6F3777EF62b20645a0dc58D77c3dB51
2585,15627850,241007,9586841000,236267,4740,1484,0,0x881D40237659C251811CEC9c364ef91dC08D300C,0x8E287834C9E7706a58427824aa308685a8dbd4B1
2586,15627850,42000,9586841000,42000,0,2,329520,0xBdff2Edcb44103B816ac6de53F03E0bBfb0E9508,0x9430801EBAf509Ad49202aaBC5F5Bc6fd8A3dAf8
2587,15627850,239787,9586841000,235047,4740,1484,4,0x881D40237659C251811CEC9c364ef91dC08D300C,0xE3957D8De772F695Ae9586973F64Bffa922a9440
2588,15627850,200000,9586841000,199320,680,138,1361,0x320623b8E4fF03373931769A31Fc52A4E78B5d70,0x0D3e7F6390FA9f07640fDf083Da9F0437f93c6e6
2589,15627850,38000,9586841000,37344,656,138,3535,0xE41d2489571d322189246DaFA5ebDe1F4699F498,0x40995fd172C745559432b1ed5E753Dcaaee9a94f
2590,15627850,169216,9586841000,168776,440,138,74,0x94235659cF8b805B2c658f9ea2D6d6DDbb17C8d7,0xfCDc25ba0D9D9C16A40506802a50C6c0870d5BC6
2591,15627850,223107,9586841000,220359,2748,842,2951,0x68b3465833fb72A70ecDF485E0e4C7bD8665Fc45,0x15Ea1b7C5402126435B2b02fc1AB6c556998B004
2592,15627850,334274,9586841000,330682,3592,970,449,0x68b3465833fb72A70ecDF485E0e4C7bD8665Fc45,0x263835b05ad8972731083fa2751aCd438e6B768e
2593,15627850,155748,9586841000,155544,204,74,2053,0x7F9306FC1978938d5C1C57Bf6044dc67E07eeB8a,0x508B610a51bed4F2C8fF98CfD820271DA7AC231A
2594,15627850,207128,9586841000,207128,0,2,1312150,0xe8d3f1EF7733005819ACb24c572F0C10Ee977678,0xf60c2Ea62EDBfE808163751DD0d8693DCb30019c
2595,15627850,150000,9504209200,149380,620,138,53,0x473037de59cf9484632f4A27B509CFE8d4a31404,0x127C530aCBF19A1B9e55259a6429E056EF135AA0
2596,15627850,740000,9232690427,728956,11044,2506,43648,0x785433d8b06D77D68dF6be63944742130A4530d1,0xa938d77590aF1d98BaB7dc4a0bde594fC3F9c403
2597,15627850,21000,9087841000,21000,0,2,113036,0xBa4d81d698b9bcc2978B530F80f3AF1aC32723a0,0x6081258689a75d253d87cE902A8de3887239Fe80
2598,15627850,51723,9086841000,51079,644,138,8,0x7b32982a32bB71150FCAA99BfBadDD72c1775a10,0x133dE21365966e1C2919f67Cd98122592cFc2DE1
2599,15627850,290921,9086841000,288525,2396,522,65,0x283Af0B28c62C092C9727F1Ee09c02CA627EB7F5,0x22B19fEc21882016375718131Ab530b0c029efe4
2600,15627850,21000,9086841000,21000,0,2,424,0x20BD73764E3eB12c00F2e3074d7bE6f73a814981,0x2a951703e001A64c1202aBF7B4F588D34d3db8db
2601,15627850,21000,9086841000,21000,0,2,180,0x5B9Ce75CA02A6d72138072d04BEfB18c55E07c7f,0x76525783B4AFB360A22499D3D994DF564F63CD69
2602,15627850,235987,9086841000,233239,2748,842,36,0x68b3465833fb72A70ecDF485E0e4C7bD8665Fc45,0x44B106396B823a9B661b7b024c653d9485cBDf09
2603,15627850,46103,9086841000,45615,488,138,85,0x34Bc797F40Df0445c8429d485232874B15561728,0x0FB324D8cF0484C09ba3ba6C359723e18A76382d
2604,15627850,189370,9086841000,186586,2784,842,762,0x68b3465833fb72A70ecDF485E0e4C7bD8665Fc45,0xFcC9cF78a1494f61d41cF895102A81785a2fe27d
2605,15627850,159842,9086841000,153254,6588,1802,143,0x00000000006c3852cbEf3e08E8dF289169EdE581,0xeA0F1F68d7C3f580a80e170A21eE0cE34CDcDd17
2606,15627850,278632,9086841000,274952,3680,906,41,0x197492CCB4B1acaAAcd43432657A17832E36AB49,0x1f90BCBCeb79c0E363990CFF6d8E1Fcaa1ACdc6E
2607,15627850,55951,9086841000,55007,944,138,1455,0x04B9788559Db3869eB48C76acaC7Af17c0165B00,0x43C1Bf1a33506d2d3f023a1F354e608e7784aC46
2608,15627850,21000,9086841000,21000,0,2,3,0x98DDf0e86Cb950308756f09943133945B854307c,0xDA8DA3B735b194005346aC902D041C104EdFea00
2609,15627850,83077,9086841000,82081,996,266,516,0x3ee18B2214AFF97000D974cf647E7C347E8fa585,0xbA5148d4A7026Ddd8bf4FAdd069f46DfeD97c975
2610,15627850,21000,9086841000,21000,0,2,45,0xc623483a440A6Fb5C0D41f8E30a9F3dF49a237Ad,0x0A0F35CD114F96387f92aA87A5F0f4F79BeD2a9e
2611,15627850,109025,9086841000,108241,784,202,10,0xcDA72070E455bb31C7690a170224Ce43623d0B6f,0x1C3B9770548F919bE36494D8eAEC5372e6d9526F
2612,15627850,163836,9086841000,157208,6628,1810,32,0x00000000006c3852cbEf3e08E8dF289169EdE581,0x87f4722140088532ddBDD04e1199870FFf177ed8
2613,15627850,40000,9086841000,39796,204,74,20,0x23C38ADb5Cf6640F4Fa4D9753268c5C6426b9720,0xD4ec3B1b45dcE9C8bBCCaD19c8389fE9F37B287D
2614,15627850,283842,9086841000,280214,3628,1162,1058,0x68b3465833fb72A70ecDF485E0e4C7bD8665Fc45,0x0083e235216FFe303c9DB58e2eCA7d69F99aFD2d
2615,15627850,46763,9086841000,46275,488,138,2480,0x947600aD1AD2fADF88faF7d30193D363208fC76D,0xA17138c0675173B8Ea506Fb1b96FA754BC316cc2
2616,15627850,21000,9086841000,21000,0,2,83,0x8869b66435b249296302b3CEd9e76ccF080345A9,0x9B309ACFD351E9ae11f95fAEF0CF0E06b824ce52
2617,15627850,98786,9086841000,98582,204,74,86,0x3DdD019EAA7A729c2607fA824655487362974bE4,0x0c90D90f0d38c21ecB15d5Bd32B030977eeB2e31
2618,15627850,55923,9086841000,54979,944,138,477,0xD309A8d0498Cc73f53481e46094DC0d3aaB0d9dd,0x4bBDEc9fBbaEFc56b3b12d60605766552a8B35eF
2619,15627850,176650,9086841000,170010,6640,1810,5542,0x00000000006c3852cbEf3e08E8dF289169EdE581,0x729Cfa0F61946C8A558Da84103F332d310A9D26a
2620,15627850,49175,9086841000,48687,488,138,921,0xcb9A491f27F1AF87721c16E678CbCA21B9dA7df3,0xf47Ac3c416022A7ADeDa68571EcbB86d91469A24
2621,15627850,46113,9086841000,45625,488,138,30,0xF666663c7b3328ea66a9d2BfdCe6Edf83489136a,0x67798826B9FE74b12bDf20450E00dd754E5AB29C
2622,15627850,50671,9086841000,50051,620,138,536,0x467719aD09025FcC6cF6F8311755809d45a5E5f3,0xECd3b4b7fD0Bc9f52335f29a3e007453dE07D2b9
2623,15627850,50671,9086841000,50051,620,138,0,0x467719aD09025FcC6cF6F8311755809d45a5E5f3,0xb88e68427dDcB012D173F19a343473FCd0c9725c
2624,15627850,47563,9086841000,46611,952,202,177,0x3b8e3C1a29C5cA73Dd47Dc57781d3E7551c0A2aB,0xBd63D6A9Fc3a82f1B8f88cD094E65b3986b0d838
2625,15627850,219717,9086841000,219477,240,74,150,0xf11ED77fD65840b64602526DDC38311E9923c81B,0x4660e9CBE586a7EC727E076b5593EAb9C51b5e4C
2626,15627850,21000,9086841000,21000,0,2,70,0x0428155E9B2Cf0566bDC2f4Aaa456e5A714DA8cb,0x38a404D2e859572fab457ad9AdF3cd2d4781d718
2627,15627850,49267,9086841000,48779,488,138,1284,0x7DF64F69544c5bf71171dc5ab69b8602C2FF1E27,0x183ad812236bf1302142751fC8B21e5af9A1B43e
2628,15627850,1155305,9086841000,1142645,12660,4106,286,0x0000000000c2d145a2526bD8C716263bFeBe1A72,0xdF5218D0ed3F395e65D0A6e7Bb96C46737149028
2629,15627850,46267,9086841000,45691,576,74,277,0x283Af0B28c62C092C9727F1Ee09c02CA627EB7F5,0xdb934F70848B0a1e124B508BCD6932dE5ada5A2f
2630,15627850,102595,9086841000,101291,1304,330,6,0xA0c68C638235ee32657e8f720a23ceC1bFc77C77,0xd8f7Ee012aC8471727a9A73c4e7327Ab9E1dB523
2631,15627850,50671,9086841000,50051,620,138,0,0x467719aD09025FcC6cF6F8311755809d45a5E5f3,0x75b7aD507456099f308AfB04Ed884DC6D2895DE8
2632,15627850,50671,9086841000,50051,620,138,0,0x467719aD09025FcC6cF6F8311755809d45a5E5f3,0x35Cc7b4EA626bA254a46cf5C13Ce11f5aaF30d72
2633,15627850,21000,9086841000,21000,0,2,310156,0x95DA57847fa6b44f0C1E0D4Ae9E0a9C0b7755577,0x6596Da8B65995d5feaCfF8c2936f0b7a2051B0D0
2634,15627850,50671,9086841000,50063,608,138,145,0x467719aD09025FcC6cF6F8311755809d45a5E5f3,0xb3186F799EC434EeCBfd811468139EFA9e37C134
2635,15627850,21000,9000000000,21000,0,2,0,0x0bF5D2Eb76aE8E4e561d30A8450867DF5bCE5e09,0xEb684c8Eb3d0cFa994ffeDe55E293c72DB896e6d
2636,15627850,21000,8730000000,21000,0,2,0,0x6dfc34609a05bC22319fA4Cce1d1E2929548c0D7,0x3964101b0F3c52343DF5CADa80C86F32516a4689
2637,15627850,2000000,8602985852,1997940,2060,522,218,0x7a250d5630B4cF539739dF2C5dAcb4c659F2488D,0x3537c0a9D538c9dDA35CC8864e28075efbA5D698
2638,15627850,113310,8586841000,113106,204,74,346,0x5D004ddB5D92938dAF8448b9eac1CaA593cd26Ca,0x26DC5D39Bd7A8bc2d792dcAAAC55FE6DCef25593
2639,15627850,113310,8586841000,113106,204,74,347,0x5D004ddB5D92938dAF8448b9eac1CaA593cd26Ca,0x26DC5D39Bd7A8bc2d792dcAAAC55FE6DCef25593
2640,15627850,68803,8586841000,68599,204,74,13,0xB092Ec81F41c619EEa434357477ea8A4b1455755,0xea7e049c3dB1BFEAFE8D801334ce770F8426c0E8
2641,15627850,53238,8586841000,52546,692,138,0,0x3506424F91fD33084466F402d5D97f05F8e3b4AF,0xdC54B0A080e855c5524a8610F2eD1E7C912b59Cc
2642,15627850,113310,8586841000,113106,204,74,348,0x5D004ddB5D92938dAF8448b9eac1CaA593cd26Ca,0x26DC5D39Bd7A8bc2d792dcAAAC55FE6DCef25593
2643,15627850,181476,8586841000,179912,1564,394,950,0x1Fa8559e873f698292766790AeCf8080A66433F6,0xab349b472357A42aAb82D83dAAed8c3f335e958f
2644,15627850,250000,8586841000,250000,0,2,45337063,0x7B4389E1f15E8278192A43186c7d1D84EA8a7317,0xEA674fdDe714fd979de3EdF0F56AA9716B898ec8
2645,15627850,175110,8586841000,173546,1564,394,357,0x1Fa8559e873f698292766790AeCf8080A66433F6,0xd802Fa6C10067115a536e273E5F24523A16c2044
2646,15627850,54373,8000000000,53705,668,138,130,0xD69F306549e9d96f183B1AecA30B8f4353c2ECC3,0x721bF51c210ad66E94C67cE7b67b6f94eFBd5068
2647,15627850,84354,8000000000,84150,204,74,105,0x9b9D659D4f2cF68b6616Cc0a65683f1951Eb725C,0x308bACc0c4Babd7DFF0427941fb9433824eE21ED
2648,15627850,529486,7961778910,506674,22812,7442,13406,0x1111111254fb6c44bAC0beD2854e76F90643097d,0xaa3Cf4A9Bb743f5cB307Fe2c2C8196280bE48CED
2649,15627850,150756,7936686478,150692,64,10,2,0x65c2e54a4c75ff6da7b6B32369c1677250075fb2,0x6E652A204C80Ef2d1cb6E78dBa1ebd0f8A766288
2650,15627850,80000,7820896229,79056,944,138,0,0xdAC17F958D2ee523a2206206994597C13D831ec7,0x38ed6753f67C29305F32FD7938c40E1CC1DdF7B5
2651,15627850,78769,7794034013,78565,204,74,108,0xC5622f143972A5Da6aaBC5F5379311eE5EB48568,0xCCac7FB773dD35D3d16B95f5ec73C543E052bbb5
2652,15627850,1314973,7774309955,818753,496220,62346,34650,0xBe5dAb4A2e9cd0F27300dB4aB94BeE3A233AEB19,0x473300df21D047806A082244b417f96b32f13A33
2653,15627850,210105,7731378788,208941,1164,338,118,0x1111111254fb6c44bAC0beD2854e76F90643097d,0x870402B7f7363Efb4CCAC3471346cF748374d3C6
2654,15627850,677310,7679653264,669590,7720,3274,59275,0xE544cF993C7d477C7ef8E91D28aCA250D135aa03,0x69f36eA1ebf4Ec9E53e3aaBF11CAF62b034ff3eE
2655,15627851,285480,27819633000,274036,11444,3018,88,0x617Dee16B86534a5d792A4d7A62FB491B544111E,0xDb79D2E150A526718E03c6643770D460F6Dfea26
2656,15627851,21000,20000000000,21000,0,2,207223,0x9490a57f2066DCc4378ad390132f3aA84f8Aca19,0x72BCFA6932FeACd91CB2Ea44b0731ed8Ae04d0d3
2657,15627851,90000,20000000000,90000,0,2,221108,0x568aCaD2A2B85c918dC8D4c06A61b84876F2c2c3,0x28FFE35688fFFfd0659AEE2E34778b0ae4E193aD
2658,15627851,21040,12000000000,21040,0,2,14,0xc9f5296Eb3ac266c94568D790b6e91ebA7D76a11,0xc71e56cfF27Ff4046463D766a909082E949D05DB
2659,15627851,300014,11295399332,298474,1540,394,134154,0x98C3d3183C4b8A650614ad179A1a98be0a8d6B8E,0x8e8f818d3371F797A2Db7eDB32803607c8b3c6A9
2660,15627851,41661,10185374423,41017,644,138,0,0x6B175474E89094C44Da98b954EedeAC495271d0F,0x6b8ba1A5F1F139Af4c5c1fEcb423987Aaff923e5
2661,15627851,181458,9295399332,179906,1552,394,262,0x1Fa8559e873f698292766790AeCf8080A66433F6,0xEE0d3a42ea15660FD4261036C1bF6Ba33A0cF0F6
2662,15627851,21000,9295399332,21000,0,2,1228777,0xbe368f7086b0f9E98aF309be43afB02f40135eAC,0x71660c4005BA85c37ccec55d0C4493E66Fe775d3
2663,15627851,264182,9295399332,258974,5208,1484,69,0x881D40237659C251811CEC9c364ef91dC08D300C,0xb231E5B824119E2a7AE637eb6a68bBfAfa059af6
2664,15627851,100000,8941248759,99356,644,138,1050381,0x5Ca381bBfb58f0092df149bD3D243b08B9a8386e,0xf16E9B0D03470827A95CDfd0Cb8a8A3b46969B91
2665,15627851,363974,8891463032,358414,5560,1618,28,0xDef1C0ded9bec7F1a1670819833240f027b25EfF,0x54bAd072D16C5CcB265a9e8DaF5bE562891C2f5F
2666,15627851,46631,8795399332,46059,572,138,56,0xaE351b8Ae55B69A5007618E598dDe89d0a092c37,0x6febf08ee1430c6Bbd8F8742F456b6F77547D5f6
2667,15627851,21000,8795399332,21000,0,2,310157,0x1D1dC4c1Fc6B677eEdA5D51101eb363119634910,0x6596Da8B65995d5feaCfF8c2936f0b7a2051B0D0
2668,15627851,305284,8795399332,301956,3328,970,15,0x68b3465833fb72A70ecDF485E0e4C7bD8665Fc45,0x630D329fEbE98a0ee24c1D9AC451a04476FeC43e
2669,15627851,50671,8795399332,50051,620,138,0,0x467719aD09025FcC6cF6F8311755809d45a5E5f3,0x0FF9ed6330B72B392Ab82080e15F2e062bDf66EC
2670,15627851,21000,8795399332,21000,0,2,310158,0xc0013617cf3B4CAA29D4Db9DAF2f4FD6e2f16570,0x6596Da8B65995d5feaCfF8c2936f0b7a2051B0D0
2671,15627851,27938,8795399332,27874,64,10,831,0xC02aaA39b223FE8D0A0e5C4F27eAD9083C756Cc2,0x50Fd64b464F85162B8e559F5765d8b6F4956fe2D
2672,15627851,304329,8795399332,301077,3252,1034,203,0x68b3465833fb72A70ecDF485E0e4C7bD8665Fc45,0x5f614de434C90435e7DEE65bb7E6D958F180912D
2673,15627851,625924,8795399332,622332,3592,1162,350,0x68b3465833fb72A70ecDF485E0e4C7bD8665Fc45,0x2f978993Ca781B6904Cd4f30d137bA821FfF8Dc1
2674,15627851,288817,8795399332,286469,2348,522,5664,0x283Af0B28c62C092C9727F1Ee09c02CA627EB7F5,0x484eC62385e780f2460fEaC34864A77bA5A18134
2675,15627851,177236,8795399332,175548,1688,330,8,0xb5d2A992442988D0E4bFd1447eba4b8dC1D1A362,0x7eA5C91565a1104bc3227248a7c5E34dAa848a6E
2676,15627851,50671,8795399332,50051,620,138,23,0x467719aD09025FcC6cF6F8311755809d45a5E5f3,0x2C8fC138e0D044Ac6c1c78C5bD56C567d5F427a6
2677,15627851,69163,8795399332,68555,608,138,22,0xdAC17F958D2ee523a2206206994597C13D831ec7,0x1cf9F9046B95f3ae5Df14A662dbb23F141B90E27
2678,15627851,46613,8795399332,46125,488,138,2481,0x984F7f9953B4a55b4aF55b388D9AC67B81edF56C,0xA17138c0675173B8Ea506Fb1b96FA754BC316cc2
2679,15627851,75606,8795399332,74962,644,138,943,0xD0Cd466b34A24fcB2f87676278AF2005Ca8A78c4,0xBb07f16C0E85dE5D3e3215462293d66C54E974FF
2680,15627851,21000,8795399332,21000,0,2,5,0xeEcB6eAFBb26208B49C06565Ca368400e977B53a,0x1ae15D4a7260018F3365a071DF6b5C0F59B676af
2681,15627851,52924,8795399332,52256,668,138,3,0x12b6893cE26Ea6341919FE289212ef77e51688c8,0x5eD2f187C030833caF4e79ccF27AE3efc45C4282
2682,15627851,278958,8795399332,278590,368,138,22,0xC549d87E9CEA28961927436a2B7D6944f7CA86eb,0x389d96a6eE133EdA37138d63b10EB7Cf614AD6e5
2683,15627851,115427,8795399332,115363,64,10,0,0x12DEb1Cb5732E40Dd55B89aBB6D5C31dF13A6e38,0xB9acFcEfa71bD6E51A5f2156Bc0479e2Ef714f6d
2684,15627851,247677,8795399332,247309,368,138,497,0x0c2E57EFddbA8c768147D1fdF9176a0A6EBd5d83,0x27D447C2CAc8050e3716AaE99CE8CA37442B589e
2685,15627851,46070,8602985852,45582,488,138,478,0x008F603F0f9Aaa2C05db0F4De44cdE91fcFF430a,0x3480703463FC3Dc347EAC4CC20eF3094d920804A
2686,15627851,46070,8602985852,45582,488,138,141,0x008F603F0f9Aaa2C05db0F4De44cdE91fcFF430a,0xbdc5Ab18F06550AC75a648ae1959051f771aFCb5
2687,15627851,46070,8602985852,45582,488,138,99,0x008F603F0f9Aaa2C05db0F4De44cdE91fcFF430a,0x45676b91559B9155C8Df8b2D58D3ba89E0b05624
2688,15627851,21000,7850154522,21000,0,2,582,0x15F8733104b67F17158c417d32172Eea56C3b61D,0x8aEF89129806B23C7930DFdf2B46E22ae1849c49
2689,15627851,105000,7820896229,105000,0,2,138564,0xC85cD10Df97Ab6Bff0debcD8ff080c12A5c53EC5,0x974CaA59e49682CdA0AD2bbe82983419A2ECC400
2690,15627851,80000,7820896229,79056,944,138,0,0x514910771AF9Ca656af840dff83E8264EcF986CA,0x8f6B710259688D27717AEc39D70F81313FC5F14F
2691,15627851,150000,7820167549,149736,264,74,638775,0xA0b86991c6218b36c1d19D4a2e9Eb0cE3606eB48,0x55FE002aefF02F77364de339a1292923A15844B8
2692,15627851,191113,7541619528,190189,924,266,412,0xd588b586D61C826A0e87919b3D1a239206d58bf2,0xd7188770a2962C73CCBc8A451455a29bD38FD965
2693,15627851,60000,7541619528,59200,800,138,2,0x352E504813B9E0b30F9cA70eFc27A52D298F6697,0xf18f7639135f5D9653633808377c6652D35D08af
2694,15627851,21000,7541619528,21000,0,2,13,0x974CaA59e49682CdA0AD2bbe82983419A2ECC400,0x07d46af38503D89591889B25fBF635F53DC99f41
2695,15627851,203820,7524279090,200192,3628,1162,2484,0x68b3465833fb72A70ecDF485E0e4C7bD8665Fc45,0xd1C442e9e2dE99D95036bB13EC07C94c6fb8fc03
2696,15627851,55978,7524279090,55034,944,138,50,0xd4cB651749953988647eEE9b51DDB8DB5aeb3410,0x5fE50e298Ab5e216a5F473424EdE56Ae48790a0B
2697,15627851,18976427,7297399332,18734363,242064,35402,213,0xc0E53C70dD53b5e1A8275Aa65ec07F20038F8317,0xa5Db65D218d9A017c39c0657c0663Fee0085a5c2
2698,15627852,600000,60000000000,598000,2000,522,2002,0x7a250d5630B4cF539739dF2C5dAcb4c659F2488D,0xe7c5DE03987777a18FF279A5e8d8A91Dd91db688
2699,15627852,345758,57777502239,343898,1860,458,1047,0x7a250d5630B4cF539739dF2C5dAcb4c659F2488D,0xA1CC352bC94caDdFddaA4D095762F37B2b9bc57A
2700,15627852,200000,30580000000,199404,596,138,1205078,0xdAC17F958D2ee523a2206206994597C13D831ec7,0xFfec0067F5a79CFf07527f63D83dD5462cCf8BA4
2701,15627852,100000,30000000000,99404,596,138,1,0xdAC17F958D2ee523a2206206994597C13D831ec7,0xE21bcD64ba35c601c15f56bbf4ceA7016cE970f7
2702,15627852,420000,30000000000,419332,668,138,2198552,0x1A3496C18d558bd9C6C8f609E1B129f67AB08163,0x6cC5F688a315f3dC28A7781717a9A798a59fDA7b
2703,15627852,5049432,17000000000,5042320,7112,1098,280,0x0a39DA505DfB5E0BBc6bd84428281A8ba1bC7753,0x495E889d1A6cEB447a57dcc1C68410299392380c
2704,15627852,21000,13777502239,21000,0,2,59,0xB01cb49fe0D6D6E47EDf3A072d15dfe73155331C,0x51Ca881A137f79f76FEc2697c20B117Fc7f67DaD
2705,15627852,500000,13491968632,488904,11096,2442,8606,0x6c383B3214e78250aeC66919b6597c922CF45BaA,0x47b9161Daf189017BF1b499455c65F9234DF3FA3
2706,15627852,21000,12288219300,21000,0,2,54,0xC098B2a3Aa256D2140208C3de6543aAEf5cd3A94,0xad72542A5CF353dfAC6F8111AC83b6293Ae041DD
2707,15627852,100000,12241583596,99404,596,138,28,0xdAC17F958D2ee523a2206206994597C13D831ec7,0xE40d7ddb17dbD3A9aa37b666893863533f10Ae4d
2708,15627852,100000,12241583596,99404,596,138,2,0xdAC17F958D2ee523a2206206994597C13D831ec7,0xb1a900e4740694F063122B078Cf2148b0466D34c
2709,15627852,222222,12000000000,220658,1564,394,296,0x1Fa8559e873f698292766790AeCf8080A66433F6,0xe6967E174f7A195ADCB833929e37240875e4d7cB
2710,15627852,100000,11667617925,99380,620,138,181432,0x473037de59cf9484632f4A27B509CFE8d4a31404,0x6238872A0Bd9F0E19073695532a7Ed77ce93C69E
2711,15627852,90912,11500338668,89968,944,138,0,0xA0b86991c6218b36c1d19D4a2e9Eb0cE3606eB48,0x88af037858F5dCE1872B97c1547BBc5201521EdF
2712,15627852,68485,11500338668,67449,1036,202,4709906,0xf4d2888d29D722226FafA5d9B24F9164c092421E,0x2FAF487A4414Fe77e2327F0bf4AE2a264a776AD2
2713,15627852,97381,11500338668,96785,596,138,4709907,0xA0b86991c6218b36c1d19D4a2e9Eb0cE3606eB48,0x2FAF487A4414Fe77e2327F0bf4AE2a264a776AD2
2714,15627852,21000,10873162614,21000,0,2,122,0xCBD6832Ebc203e49E2B771897067fce3c58575ac,0x6E26A1a36059F1DB052D2707F67533560140aD50
2715,15627852,77437,10155190334,76769,668,138,0,0x5b52bfB8062Ce664D74bbCd4Cd6DC7Df53Fd7233,0x502922a5A1e39A4164893ec58A8C98A4d4a5C434
2716,15627852,180310,10277502239,179814,496,202,67,0xbbA10c994E2780b459CF6511d9ad3D4f5D38B5A1,0xB639C32e88867cA4D392d1b93082150eBB800dE6
2717,15627852,143796,10277502239,143592,204,74,163,0x7F9306FC1978938d5C1C57Bf6044dc67E07eeB8a,0x375Dae8e3F7c60AdfFa7db18590Dcdf6F0de2223
2718,15627852,198704,10277502239,196664,2040,650,608,0x2B2e8cDA09bBA9660dCA5cB6233787738Ad68329,0x1e799C0EA1504D3d93f6777Eca479335d8D5d636
2719,15627852,141151,10277502239,140959,192,74,15,0x2d77B594B9BBaED03221F7c63Af8C4307432daF1,0x043B74A9e54b39488943b047406205650dF2e35E
2720,15627852,143796,10277502239,143592,204,74,41,0x7F9306FC1978938d5C1C57Bf6044dc67E07eeB8a,0x3079E48b3df5B8b27c0F0E03AbD484B764D7fB2f
2721,15627852,117738,10277502239,117534,204,74,20,0x7F9306FC1978938d5C1C57Bf6044dc67E07eeB8a,0x75646014293177849f306221e48654bA22C2c554
2722,15627852,50000,9727728773,50000,0,2,503551,0x7191d8d6939a45F160CB3bf59FB0f0dFe2A06585,0x000F422887eA7d370FF31173FD3B46c8F66A5B1c
2723,15627852,117533,10157502239,117341,192,74,3,0xfc33E8b6E160A81DdB442B07355D01DF711EFEee,0x69E6456f1dEAc1AD675dDbf217D8b48caf982833
2724,15627852,78556,10157502239,77900,656,138,0,0x12b6893cE26Ea6341919FE289212ef77e51688c8,0xd27a1906Bb99c5A38c33d3db67871053825A02b0
2725,15627852,100000,9482868287,99428,572,138,12,0xC18c07a18198A6340cf4d94855fE5eb6DD33b46E,0x3261E0c425a79F328C1301D1E3e4928ab9B8EC9A
2726,15627852,46707,9877502239,46219,488,138,501,0xbef7Dcc0335Ec876e2DC530b883F34c8807d61fc,0xeC9bf38c72D871acFffdeD3342fa7E08a61bbbbb
2727,15627852,46707,9877502239,46219,488,138,458,0xbef7Dcc0335Ec876e2DC530b883F34c8807d61fc,0x65840A9471a8Df058E2AFeEd473CFd82f16cCCCc
2728,15627852,46707,9877502239,46219,488,138,677,0xbef7Dcc0335Ec876e2DC530b883F34c8807d61fc,0xc295D8F3b0b766a424fdE52FE32eF9dB99DaaaaA
2729,15627852,21000,9360000000,21000,0,2,0,0x6dfc34609a05bC22319fA4Cce1d1E2929548c0D7,0x34c2Cd3A76988101c965ec9301f94B8abAE1700f
2730,15627852,21000,9360000000,21000,0,2,705871,0x6f964Abb38ECC1c45a8a6c283CF7bb29fd93c81f,0x6dfc34609a05bC22319fA4Cce1d1E2929548c0D7
2731,15627852,21000,9333088958,21000,0,2,16,0x36F6C70732F67914c69D32D9780047a39Bc4d191,0x2dCBB48DD9BfE50fB4235BEadAE5A85270CCa771
2732,15627852,73120,9777502239,72820,300,74,69,0xf7A0383750feF5AbaCe57cc4C9ff98e3790202b3,0x5012e2f6b9d81e96622BFA2F2764fcB406d8e6C1
2733,15627852,21000,9777502239,21000,0,2,864,0x215D54D0B98840017dC4103bABECE6E79d924cCA,0xA9E37368004605E856991a0A21ac766703429BD5
2734,15627852,36015,9777502239,35751,264,74,105,0xC02aaA39b223FE8D0A0e5C4F27eAD9083C756Cc2,0x2BD29af09c6743C7B1CD3358C2ecE9582e20eF09
2735,15627852,46118,9777502239,45630,488,138,12,0x2acAb3DEa77832C09420663b0E1cB386031bA17B,0x1f41509DC6F3777EF62b20645a0dc58D77c3dB51
2736,15627852,21000,9777502239,21000,0,2,776,0xd95D30fd3e089816d14972B15d4dC4E2DF9D0cb4,0x9476aed77Db00a375dd75cD3b5D6031E4EB3070A
2737,15627852,91140,9777502239,90196,944,138,0,0xA0b86991c6218b36c1d19D4a2e9Eb0cE3606eB48,0x21b02b173c2d5ffE86eD9c8C4D530eF74aCC2BE1
2738,15627852,291856,9777502239,287780,4076,1098,1,0xe66B31678d6C16E9ebf358268a790B763C133750,0x21b02b173c2d5ffE86eD9c8C4D530eF74aCC2BE1
2739,15627852,39630,9777502239,39354,276,74,645,0xC02aaA39b223FE8D0A0e5C4F27eAD9083C756Cc2,0x103246339988c3A3eC32086A179d6D6b8dE34c4F
2740,15627852,236403,9777502239,232847,3556,1162,14,0x68b3465833fb72A70ecDF485E0e4C7bD8665Fc45,0xbB5c7A3d87C7623A02b3850aDc7aCa7CA541DA6b
2741,15627852,38000,9777502239,37332,668,138,62,0xE41d2489571d322189246DaFA5ebDe1F4699F498,0xf3Ac9Be9e56a9f0DCfe5C10D10D502E81Eb4fa80
2742,15627852,38000,9777502239,37344,656,138,105,0xE41d2489571d322189246DaFA5ebDe1F4699F498,0x86dFDb7Aa4c560AFFBd686fF939b5C60425FbE28
2743,15627852,200000,9777502239,199320,680,138,1400,0x320623b8E4fF03373931769A31Fc52A4E78B5d70,0xa7309Ec13DAc9707eD660DcED2e5809b590B27C2
2744,15627852,56713,9777502239,55769,944,138,450,0xAb1A4a5681463DF2313D2624A28f16cd0418884F,0x263835b05ad8972731083fa2751aCd438e6B768e
2745,15627852,23300,9777502239,23300,0,2,0,0xA9D1e08C7793af67e9d92fe308d5697FB81d3E43,0x25b5b7fF7c5f513d107404Adb255F34D909d8831
2746,15627852,21000,9777502239,21000,0,2,1,0xddfAbCdc4D8FfC6d5beaf154f18B778f892A0740,0x5eEee9e52549F60C86e47DC31c5871ed84fa1F41
2747,15627852,21000,9777502239,21000,0,2,0,0xddfAbCdc4D8FfC6d5beaf154f18B778f892A0740,0x64f03e08c39C3794e146e93de5c015fE0bF144fc
2748,15627852,23300,9777502239,23300,0,2,1,0xA9D1e08C7793af67e9d92fe308d5697FB81d3E43,0xDb106534e9ed607D01Ff42ac52cC0005EfF41ec6
2749,15627852,23300,9777502239,23300,0,2,2,0xA9D1e08C7793af67e9d92fe308d5697FB81d3E43,0x20582Fdd1c80DD32CBa993C6EB937BDb4583bd69
2750,15627852,21000,9777502239,21000,0,2,0,0xddfAbCdc4D8FfC6d5beaf154f18B778f892A0740,0xdf88C71Bd6E696F074E7F73aB077092A75733A2C
2751,15627852,21000,9777502239,21000,0,2,0,0xddfAbCdc4D8FfC6d5beaf154f18B778f892A0740,0xC8A1f707bea1432eeB8f2504d5eCbd28676E5905
2752,15627852,21000,9777502239,21000,0,2,5721,0xddfAbCdc4D8FfC6d5beaf154f18B778f892A0740,0x4675C7e5BaAFBFFbca748158bEcBA61ef3b0a263
2753,15627852,23300,9777502239,23300,0,2,29,0xA9D1e08C7793af67e9d92fe308d5697FB81d3E43,0x584a42962399536606fB375ab6CE88D6Fb0e51c4
2754,15627852,21000,9777502239,21000,0,2,0,0xddfAbCdc4D8FfC6d5beaf154f18B778f892A0740,0xA6C5247478eD473bBa80A627dEeba93324f6CCed
2755,15627852,21000,9777502239,21000,0,2,6,0xddfAbCdc4D8FfC6d5beaf154f18B778f892A0740,0xA903F4e43BCAE409a551C0CF9cB47562906885D0
2756,15627852,21000,9777502239,21000,0,2,7,0xddfAbCdc4D8FfC6d5beaf154f18B778f892A0740,0x6183dDDdf53E906ff52B64847c554C6A3c01228E
2757,15627852,23300,9777502239,23300,0,2,11019,0xA9D1e08C7793af67e9d92fe308d5697FB81d3E43,0xCe352e98934499be70F641353f16A47D9E1E3aBd
2758,15627852,23300,9777502239,23300,0,2,0,0xA9D1e08C7793af67e9d92fe308d5697FB81d3E43,0xf9B22664112563B57E781D05036bb158ac130FB2
2759,15627852,23300,9777502239,23300,0,2,9,0xA9D1e08C7793af67e9d92fe308d5697FB81d3E43,0x06E6132BE474dD4f115637a19b288deD605EE6E6
2760,15627852,23300,9777502239,23300,0,2,3,0xA9D1e08C7793af67e9d92fe308d5697FB81d3E43,0x98b0A9e12763374E1C95127959f3dfc11995277f
2761,15627852,23300,9777502239,23300,0,2,194,0xA9D1e08C7793af67e9d92fe308d5697FB81d3E43,0xb41eb83113Aecd6082fDf005294F7A510A60d326
2762,15627852,23300,9777502239,23300,0,2,0,0xA9D1e08C7793af67e9d92fe308d5697FB81d3E43,0xc2C9E8ffA0ab83E26115D9346BeFAe09Bf860BA9
2763,15627852,23300,9777502239,23300,0,2,1,0xA9D1e08C7793af67e9d92fe308d5697FB81d3E43,0x0Eae2c51d95a2C7b9a08bab3614cD3fDc39c58a7
2764,15627852,23300,9777502239,23300,0,2,5,0xA9D1e08C7793af67e9d92fe308d5697FB81d3E43,0x1ABF5512744a9B8165364887bD7E5f53a5A6d0b5
2765,15627852,229100,9777502239,225472,3628,1162,1361,0x68b3465833fb72A70ecDF485E0e4C7bD8665Fc45,0xc3FD9C40521394c1DbcF57d6912baBCf394F33C0
2766,15627852,21000,9777502239,21000,0,2,8265746,0x8DC880ed5C124c91fe832a1290380aFA1d31EEBC,0xb5d85CBf7cB3EE0D56b3bB207D5Fc4B82f43F511
2767,15627852,48780,9777502239,48184,596,138,14927,0xA0b86991c6218b36c1d19D4a2e9Eb0cE3606eB48,0x02d24cAB4f2c3Bf6e6EB07ea07e45F96baccFfE7
2768,15627852,21000,9777502239,21000,0,2,6578029,0xCb6A53a9b89bB4670027D8e8A9ed345F33CD5839,0xeB2629a2734e272Bcc07BDA959863f316F4bD4Cf
2769,15627852,21000,9777502239,21000,0,2,469158,0xf5eb59674AC055264DBCf4eD8cfb64cb63667b98,0xb739D0895772DBB71A89A3754A160269068f0D45
2770,15627852,21000,9777502239,21000,0,2,8804464,0x4ef8f1a0451f1E8349C5e68145898d5331478aeE,0x3cD751E6b0078Be393132286c442345e5DC49699
2771,15627852,21000,9777502239,21000,0,2,346920,0x00e8f905E062a68094C989C417D6eB5375748122,0x77696bb39917C91A0c3908D577d5e322095425cA
2772,15627852,21000,9777502239,21000,0,2,346921,0x32F5059f91A84D79b8bcF894d91AF6254b70D048,0x77696bb39917C91A0c3908D577d5e322095425cA
2773,15627852,245930,9777502239,240638,5292,1484,33,0x881D40237659C251811CEC9c364ef91dC08D300C,0xF33FAE8A57BFB5e222aF42580dAb40fbe6eDf5FF
2774,15627852,400490,9777502239,397266,3224,906,208,0x68b3465833fb72A70ecDF485E0e4C7bD8665Fc45,0xD4854c4EdEC0a3e5b160b1e10b45192cE1E96e01
2775,15627852,39617,9777502239,39353,264,74,376,0xC02aaA39b223FE8D0A0e5C4F27eAD9083C756Cc2,0x46B767DB672F149eF2C794069F63C516eAdEC536
2776,15627852,70000,9777502239,69392,608,138,523,0xdAC17F958D2ee523a2206206994597C13D831ec7,0xf5491f793D47A6Ea22f5e0B9AD3990CF66c4b40B
2777,15627852,77842,9777502239,77174,668,138,0,0x95aD61b0a150d79219dCF64E1E6Cc01f0B64C4cE,0x1a2dc289f8899a26E977B3848befDd8aF6864562
2778,15627852,200000,9777502239,199572,428,138,816,0xb47e3cd837dDF8e4c57F05d70Ab865de6e193BBB,0xb4Bb4156e5e6Ca5D81041f616c27dfFB253B7845
2779,15627852,207128,9777502239,207128,0,2,3492271,0xC6Fc3f59b26e057D965730B7d3758e646568c6A8,0x56Eddb7aa87536c09CCc2793473599fD21A8b17F
2780,15627852,207128,9777502239,207128,0,2,3199171,0xaD7771b49D5bAB75798057f9A9c5023C708DbC12,0x9696f59E4d72E237BE84fFD425DCaD154Bf96976
2781,15627852,207128,9777502239,207128,0,2,4468938,0x8710eDC10C2fc16eE9D00bA65f2359B5F61fd92B,0x21a31Ee1afC51d94C2eFcCAa2092aD1028285549
2782,15627852,207128,9777502239,207128,0,2,4708693,0xeC886428A7BF05DBDd1DE7979e3Cb669C9Ac28C8,0x28C6c06298d514Db089934071355E5743bf21d60
2783,15627852,207128,9777502239,207128,0,2,1679523,0x9497F7B6942ad122c525D81047ee443cF55644E2,0x4976A4A02f38326660D17bf34b431dC6e2eb2327
2784,15627852,207128,9777502239,206472,656,138,4232326,0x4Fabb145d64652a948d72533023f6E7A623C7C53,0xDFd5293D8e347dFe59E90eFd55b2956a1343963d
2785,15627852,207128,9777502239,207128,0,2,4232327,0x5209Bef8B7771952a0092139f67Dcd97e960DD44,0xDFd5293D8e347dFe59E90eFd55b2956a1343963d
2786,15627852,207128,9777502239,206472,656,138,4232328,0x3506424F91fD33084466F402d5D97f05F8e3b4AF,0xDFd5293D8e347dFe59E90eFd55b2956a1343963d
2787,15627852,56713,9777502239,55769,944,138,101,0x3bf0DA0C8Cdef2582C3Ea0077901eF2A23EA12d1,0x8EA6C6FD2A3e866C86A2E53e065B8156C2ac0101
2788,15627852,38000,9777502239,37344,656,138,712,0xE41d2489571d322189246DaFA5ebDe1F4699F498,0x9140B03C504Ec92BD62f619f226daE8C17D61cc4
2789,15627852,38000,9777502239,37344,656,138,1,0xE41d2489571d322189246DaFA5ebDe1F4699F498,0x4fAb5B0771F12013Ab8D54E1822Fea8F48240f02
2790,15627852,42000,9777502239,42000,0,2,329521,0x19070Ce9B1a6bcBDfe0387095AF1e744f9Ef134a,0x9430801EBAf509Ad49202aaBC5F5Bc6fd8A3dAf8
2791,15627852,650000,9777502239,648004,1996,586,174,0x02777053d6764996e594c3E88AF1D58D5363a2e6,0x3ac40debB51e999FB4b1763685c4bD4EB7C9D366
2792,15627852,200000,9777502239,199320,680,138,1362,0x320623b8E4fF03373931769A31Fc52A4E78B5d70,0x0D3e7F6390FA9f07640fDf083Da9F0437f93c6e6
2793,15627852,200000,9777502239,199320,680,138,1363,0x320623b8E4fF03373931769A31Fc52A4E78B5d70,0x0D3e7F6390FA9f07640fDf083Da9F0437f93c6e6
2794,15627852,79381,9260000000,78785,596,138,50,0xA0b86991c6218b36c1d19D4a2e9Eb0cE3606eB48,0xd59b80d00a6BF409f46F0eD3117fBea95666B47C
2795,15627852,21000,9694870439,21000,0,2,41,0xeaebc4b2044Ab3B11e3aEAe1e444B67B7b1F8338,0xF627fFbD0597F34052D4D64d0f3BE4De8Fb85c08
2796,15627852,150000,9636582105,149392,608,138,30,0x473037de59cf9484632f4A27B509CFE8d4a31404,0x25B4B72e56AF0cC2CC23Fe52F9d6912aB677D87E
2797,15627852,21000,9000000000,21000,0,2,41,0x14da509045AE939DE5E93C37dA7C21BFf22fF146,0x35bd0E3703bC2DF72E16Aaa79F514EDF28Ab3c8B
2798,15627852,254459,9439916580,241171,13288,4114,46628,0x1111111254fb6c44bAC0beD2854e76F90643097d,0x839d4641F97153b0ff26aB837860c479E2Bd0242
2799,15627852,100000,9423351666,99392,608,138,368495,0xdAC17F958D2ee523a2206206994597C13D831ec7,0xeC30d02f10353f8EFC9601371f56e808751f396F
2800,15627852,100000,9423351666,99404,596,138,368496,0xdAC17F958D2ee523a2206206994597C13D831ec7,0xeC30d02f10353f8EFC9601371f56e808751f396F
2801,15627852,90000,9423351666,90000,0,2,784407,0x1B5F0fe9F237D9571AA50997e967fF386F052927,0xcaD621da75a66c7A8f4FF86D30A2bF981Bfc8FdD
2802,15627852,21000,9278502239,21000,0,2,113037,0xad72542A5CF353dfAC6F8111AC83b6293Ae041DD,0x6081258689a75d253d87cE902A8de3887239Fe80
2803,15627852,21000,9278502239,21000,0,2,113038,0xC23813Cb4C261938F342d9C3869385563D58b04a,0x6081258689a75d253d87cE902A8de3887239Fe80
2804,15627852,21000,9283502239,21000,0,2,113039,0x6E805A268899D389E728d9797C9cBe96cD370949,0x6081258689a75d253d87cE902A8de3887239Fe80
2805,15627852,178957,9277502239,172473,6484,1738,504,0x00000000006c3852cbEf3e08E8dF289169EdE581,0x5711328D6Ad4C27D320E0BE0109e9C003Ef0548F
2806,15627852,21000,9277502239,21000,0,2,18,0x5bAB06Aab8aEcD0E60c8287391233F2285ad7071,0x1034B8C85e2b5da2ecf64E20100a46Cc33E1DD97
2807,15627852,117533,9277502239,117341,192,74,0,0xfc33E8b6E160A81DdB442B07355D01DF711EFEee,0x65AdDA4F7bFd91ade129cd47d16104d761cf256F
2808,15627852,21000,9277502239,21000,0,2,86,0xc3959A250C6C4b869249076Ca4079C5599f57ff4,0x947319e8f24F67BbF288a037c300b61FF32b9787
2809,15627852,2069391,9277502239,2060355,9036,3338,121,0xcCbCa4F9651Ef122D58d7EC5acCa27D806840209,0x1a083628b6Acfec6f80d623cc71f48E7045c2a2D
2810,15627852,21000,9277502239,21000,0,2,79,0xec83D11BD8b6dc7d367347e3e86C49c88706e441,0xD6D87Eeb421eEeb50bFF52f6aB35350C48B876Ed
2811,15627852,240787,9277502239,218887,21900,5090,1187,0x57f1887a8BF19b14fC0dF6Fd9B2acc9Af147eA85,0xcCc78D2a72FA509F6e6834599f01Be5864351157
2812,15627852,330481,9277502239,315965,14516,4746,45,0x83C8F28c26bF6aaca652Df1DbBE0e1b56F8baBa2,0xbd1849da28B0BB78E61612c54B36C1d607Cf0D3D
2813,15627852,94813,9277502239,94205,608,138,15,0xdAC17F958D2ee523a2206206994597C13D831ec7,0xf2669039FCFC8472CEFEf5CCD42e825646A16e2e
2814,15627852,239275,9277502239,236059,3216,1034,174,0x68b3465833fb72A70ecDF485E0e4C7bD8665Fc45,0x1c1e419C93604074c92650ad97Aa48A220F982d2
2815,15627852,115427,9277502239,115363,64,10,33,0x12DEb1Cb5732E40Dd55B89aBB6D5C31dF13A6e38,0xf4754fCdd8cc2ACdE3D856d69Bbe8F25E5f03244
2816,15627852,81435,9277502239,80839,596,138,12,0xaaAEBE6Fe48E54f431b0C390CfaF0b017d09D42d,0x7D4297D04e3F8c2E14C422852142E238349b6893
2817,15627852,54448,9277502239,53892,556,202,9,0x084b1c3C81545d370f3634392De611CaaBFf8148,0xDa70fB6592450C4520f23a2E1AE8CE3CCA335294
2818,15627852,46052,9277502239,45564,488,138,333,0xb967D2335A3879b7CAE42E085f88274EBff90Fc4,0xd98d839275cf356Ec9E34A146C7EDaAa69f29022
2819,15627852,46103,9277502239,45615,488,138,21,0x346378C67d0F71343F80299ed8C0407aC2Df05eB,0x5Ce90C58e06921d1609F72B2d2283225e0E66508
2820,15627852,307061,9277502239,304677,2384,522,1,0x283Af0B28c62C092C9727F1Ee09c02CA627EB7F5,0x057505990F3BB16a912c65D5E4E7918e4C370ee7
2821,15627852,62406,9277502239,61466,940,202,40,0x1Fa8559e873f698292766790AeCf8080A66433F6,0x5A6F2a16A2CCC60A1399C79bd9377ddFeA894C7E
2822,15627852,62391,9277502239,61463,928,202,41,0x1Fa8559e873f698292766790AeCf8080A66433F6,0x218698cBf5F9f2227F2C3f8Bc7B4bF70003B8D38
2823,15627852,62391,9277502239,61463,928,202,41,0x1Fa8559e873f698292766790AeCf8080A66433F6,0x4C0F00F51d8387570451046197ecc87182244Ab4
2824,15627852,21000,9277502239,21000,0,2,0,0x1E2f2DF4193973c6117229534a5E5cd9439A8841,0x9D4eeA20bF0F3D262a09a6D705049E657A2CE163
2825,15627852,140559,9277502239,140075,484,202,45,0x92A92b59d0e89e497d1feD9ED3A25AA54Db4c2d9,0xD618A0da87593d5Ea4830bA45bD21E5F62318fB3
2826,15627852,62391,9277502239,61463,928,202,43,0x1Fa8559e873f698292766790AeCf8080A66433F6,0x018FBA7700a9Be07bFC146f9B7E3dB2332bFd962
2827,15627852,174331,9277502239,162407,11924,3786,8,0x00000000006c3852cbEf3e08E8dF289169EdE581,0x7378711DE38d222F984B4a6C1CC550C1efBFa113
2828,15627852,158666,9277502239,155982,2684,714,1509405,0x1522900B6daFac587d499a862861C0869Be6E428,0x00BDb5699745f5b860228c8f939ABF1b9Ae374eD
2829,15627852,62406,9277502239,61466,940,202,45,0x1Fa8559e873f698292766790AeCf8080A66433F6,0xC5e76028Dd2Cc70C46310AA58426489a3Db3e03b
2830,15627852,62406,9277502239,61466,940,202,43,0x1Fa8559e873f698292766790AeCf8080A66433F6,0xa56aC0F0AAf05B5ded4835D896064252bc809535
2831,15627852,21000,9277502239,21000,0,2,15,0x5bAB06Aab8aEcD0E60c8287391233F2285ad7071,0xD9Ca7dBAB4F1aa1E52f7e7013b8588596C380799
2832,15627852,21000,9277502239,21000,0,2,1,0xFE4E1E81081d7A351C3617626476cE571d10764E,0x5A8A849A12242D804621Ef4d7e62F2d08104aA48
2833,15627852,215174,9277502239,212402,2772,842,4210,0x68b3465833fb72A70ecDF485E0e4C7bD8665Fc45,0x4Ed952edDB2DF5EcB924Cab763cC926f10F3F070
2834,15627852,62406,9277502239,61466,940,202,43,0x1Fa8559e873f698292766790AeCf8080A66433F6,0xC3B344e907FAb6a2E12264F5f8CbCD7B550ad4c8
2835,15627852,63457,9277502239,63253,204,74,26,0x486F0BcB8cE7F4f6440AadFB64a8fcEcb2FaE46F,0x36e25475A8C00cFb5C44674E10000C4011EFDF3e
2836,15627852,148122,9277502239,141446,6676,1810,106,0x00000000006c3852cbEf3e08E8dF289169EdE581,0x3b6915847D3c961de0f8BF994BeBb84A0e2f4929
2837,15627852,62406,9277502239,61466,940,202,46,0x1Fa8559e873f698292766790AeCf8080A66433F6,0x71DD37118A798469a4FCc6b648De62dda5964Dcb
2838,15627852,62391,9277502239,61463,928,202,40,0x1Fa8559e873f698292766790AeCf8080A66433F6,0x660f144201B5592EB114F3aC32004C4D934BDdCa
2839,15627852,62406,9277502239,61466,940,202,43,0x1Fa8559e873f698292766790AeCf8080A66433F6,0xc14351FCEC96B5D0C56bF428879f62E5a0f789af
2840,15627852,46025,9277502239,45537,488,138,2482,0x3035Bb5FDd9597903776dA28e41614e1B2ca39BC,0xA17138c0675173B8Ea506Fb1b96FA754BC316cc2
2841,15627852,62406,9277502239,61466,940,202,208,0x1Fa8559e873f698292766790AeCf8080A66433F6,0x58D90f249ee09f7f8F282B83bE30f84F56F8663e
2842,15627852,117604,9277502239,113528,4076,1290,4,0x0000000000c2d145a2526bD8C716263bFeBe1A72,0x03f14D5930fB58107CDb2fe9DE6E7d4B2a1b2E5F
2843,15627852,62406,9277502239,61466,940,202,61,0x1Fa8559e873f698292766790AeCf8080A66433F6,0xA00C45cA3A73673d10542C9a15CFD138715eDA24
2844,15627852,62406,9277502239,61466,940,202,65,0x1Fa8559e873f698292766790AeCf8080A66433F6,0x1Ef81542D453a6C6347b94f42a01aE15156187e7
2845,15627852,321891,9277502239,316075,5816,1674,2613,0x59728544B08AB483533076417FbBB2fD0B17CE3a,0xD73e0DEf01246b650D8a367A4b209bE59C8bE8aB
2846,15627852,55923,9277502239,54979,944,138,335,0xD309A8d0498Cc73f53481e46094DC0d3aaB0d9dd,0xC2678dD17D570D961F971762eEDfe27467BbA01B
2847,15627852,21000,9277502239,21000,0,2,446,0xA28B5EA7E8AAe6F5F9b35aaDaA9bb2cC9e9C3ed5,0xD93382C2107fc500A9fd84056206F939Fe6c3891
2848,15627852,62406,9277502239,61466,940,202,71,0x1Fa8559e873f698292766790AeCf8080A66433F6,0x3063afA2e6115313b95E78A75911fb68D1F5a0b0
2849,15627852,62406,9277502239,61466,940,202,77,0x1Fa8559e873f698292766790AeCf8080A66433F6,0x55B3f5ea72e626324A4D02aB5306b5E81B4bF04D
2850,15627852,46280,9277502239,45420,860,138,400,0xC02aaA39b223FE8D0A0e5C4F27eAD9083C756Cc2,0xB5f451712c5662EBfDd93B58db99d76b462ea88e
2851,15627852,62406,9277502239,61466,940,202,63,0x1Fa8559e873f698292766790AeCf8080A66433F6,0xFc13D653C3788c09DaaC02592cf78583DfE6FB06
2852,15627852,450037,9277502239,414809,35228,12306,288,0x00000000006c3852cbEf3e08E8dF289169EdE581,0xe43a5dAd69423b6541e92D6884DF9Bc6cE687567
2853,15627852,94813,9277502239,94205,608,138,130,0xdAC17F958D2ee523a2206206994597C13D831ec7,0xA18FdA0Ca6A836Feb0AC9ff497D43c1468D7d966
2854,15627852,1000000,9277502239,998036,1964,522,9,0x7a250d5630B4cF539739dF2C5dAcb4c659F2488D,0x152619812C4fd6da35Ff18881d3123bFb0172653
2855,15627852,114246,9277502239,106362,7884,1226,36,0x6E99ee539594fa6a621a29022Aa50AE7f32f14BB,0x3816e1adA945f0a4495036D8F7E852A82495F4f4
2856,15627852,62391,9277502239,61463,928,202,79,0x1Fa8559e873f698292766790AeCf8080A66433F6,0xE6142eab80A8409773E45d5D1b00daAeb5187b97
2857,15627852,241896,9277502239,237560,4336,1162,464,0x6F5CC3EDEa92AB52b75bad50Bcf4C6daa781B87e,0x293994b0Bc3eED688A4697871381d43fc4AA6FD5
2858,15627852,62406,9277502239,61466,940,202,80,0x1Fa8559e873f698292766790AeCf8080A66433F6,0x935a07601ecBA0ccFC07e2d3818b5fafecea53e2
2859,15627852,62406,9277502239,61466,940,202,63,0x1Fa8559e873f698292766790AeCf8080A66433F6,0x3d443A943be5D013b8da79A10d6Cd4273837C7c9
2860,15627852,21000,9277502239,21000,0,2,71,0xd4FcA5A6A07C41b2f02a8430B96Bf959Ac440393,0x38a404D2e859572fab457ad9AdF3cd2d4781d718
2861,15627852,21000,9277502239,21000,0,2,72,0x24B47d3780B480Cd97759eEdb25720CdFF4db2CB,0x38a404D2e859572fab457ad9AdF3cd2d4781d718
2862,15627852,62406,9277502239,61466,940,202,70,0x1Fa8559e873f698292766790AeCf8080A66433F6,0x7Df6281e95d28bfa988b87035691e4189523A3fa
2863,15627852,290770,9277502239,287938,2832,842,30,0x68b3465833fb72A70ecDF485E0e4C7bD8665Fc45,0x4286066191295F70b10878a79C3F36B282DbE01d
2864,15627852,203131,9277502239,199855,3276,1034,76,0x0000000000c2d145a2526bD8C716263bFeBe1A72,0x9CAb85210e4F82f2128c0975429c256e31FdEfC5
2865,15627852,21000,9277502239,21000,0,2,388,0xd5928959718A706D0f734cA136D87DdFbC6014f4,0x83cB506ED2C58F604767ed13Ab74E8dD3CE39402
2866,15627852,62406,9277502239,61466,940,202,96,0x1Fa8559e873f698292766790AeCf8080A66433F6,0x4DbbC9278e589C5F0a975216F3E4CD51abE6385d
2867,15627852,21000,9277502239,21000,0,2,47,0xc623483a440A6Fb5C0D41f8E30a9F3dF49a237Ad,0x8B91AAefA98502f778ac7ad25B649749a0E09c9D
2868,15627852,62406,9277502239,61466,940,202,113,0x1Fa8559e873f698292766790AeCf8080A66433F6,0x0351b2FcC2458389dC88BE06EFb8560F72fC5255
2869,15627852,136494,9277502239,136430,64,10,106,0x1344A36A1B56144C3Bc62E7757377D288fDE0369,0x6780ac060FdcBA20AE02A6197c84Bdc70CF8716B
2870,15627852,62406,9277502239,61466,940,202,107,0x1Fa8559e873f698292766790AeCf8080A66433F6,0xa38D781b1bf5A05fF9c0869dEefA17E4b7b6885E
2871,15627852,1106658,9277502239,1106290,368,138,472,0x2b591e99afE9f32eAA6214f7B7629768c40Eeb39,0xCF162B0bEBc44B49238D9C08398695868c6B30B5
2872,15627852,115427,9277502239,115363,64,10,1,0x12DEb1Cb5732E40Dd55B89aBB6D5C31dF13A6e38,0xB9acFcEfa71bD6E51A5f2156Bc0479e2Ef714f6d
2873,15627852,115427,9277502239,115363,64,10,2,0x12DEb1Cb5732E40Dd55B89aBB6D5C31dF13A6e38,0xB9acFcEfa71bD6E51A5f2156Bc0479e2Ef714f6d
2874,15627852,62406,9277502239,61466,940,202,135,0x1Fa8559e873f698292766790AeCf8080A66433F6,0x9f64785EA3f4CFf5dB47633f02b92526Aa2cDee7
2875,15627852,62391,9277502239,61463,928,202,126,0x1Fa8559e873f698292766790AeCf8080A66433F6,0x8e7a08002c90E80Fc25A7b09Cc06c5E0149a9Fe3
2876,15627852,62391,9277502239,61463,928,202,148,0x1Fa8559e873f698292766790AeCf8080A66433F6,0x0bf91ce8F96516492518F08D00e2956078fFdDAc
2877,15627852,92151,9277502239,92087,64,10,0,0x4Dbd4fc535Ac27206064B68FfCf827b0A60BAB3f,0x7569810D943cd9Ca096D072f083e48b1e42A5E7B
2878,15627852,65329,9277502239,64377,952,202,19,0x61CEcE14E222385D5aC83f3d0cbd518f5fEB3559,0x5630bab8549Aaaf78435023c389c586aA0c356Ae
2879,15627852,43986,9277502239,43558,428,138,13,0xcDA72070E455bb31C7690a170224Ce43623d0B6f,0x16BA96fEAC14743CAFe73Ec74f1F2536E23d8f01
2880,15627852,62406,9277502239,61466,940,202,164,0x1Fa8559e873f698292766790AeCf8080A66433F6,0xAd7aECf27fCA2Bb9fc37e0D6A63cf59FF90527d2
2881,15627852,500000,9277502239,498040,1960,394,60925,0x585C3d4Da9b533C7e3dF8AC7356C882859298cEe,0xd5cf0Cb9a8DF9B46f077f561d8b76c34A69bD82F
2882,15627852,46113,9277502239,45625,488,138,7,0xFE5A28F19934851695783a0C8CCb25d678bB05D3,0x9079cCFb205fc1885a428421D49f901CB5f45Db4
2883,15627852,261721,9277502239,261517,204,74,18,0x55f1C36Bb7aE0d7D6caE97902E30A2306686Ec73,0x4205b76aed697f30b07b815C87d8AEC7997f93b7
2884,15627852,62406,9277502239,61466,940,202,180,0x1Fa8559e873f698292766790AeCf8080A66433F6,0xc10ed3DB1317eF94973D175B622459c7382A0eA9
2885,15627852,46187,9277502239,45615,572,138,1,0x6661c87764AdF7FffA3c7922FA6EDFa2fd62cCfC,0x279211050b09d549c204783FcD67E8Fb6e682933
2886,15627852,183924,9277502239,180272,3652,1162,1081,0x68b3465833fb72A70ecDF485E0e4C7bD8665Fc45,0xCe0Bdca2Bb503639aE43E280fbA9a49F966f7B8A
2887,15627852,51458,9277502239,50970,488,138,192,0x7F9306FC1978938d5C1C57Bf6044dc67E07eeB8a,0xE536FfBacbB00b6358dDAFC82603074a9a869d0f
2888,15627852,878610,9277502239,824174,54436,18058,342,0xaE9C73fd0Fd237c1c6f66FE009d24ce969e98704,0xD4361e724359661127e1511eb1be5879e632a744
2889,15627852,62406,9277502239,61466,940,202,252,0x1Fa8559e873f698292766790AeCf8080A66433F6,0xB15B7508129d6F888F27573e1ea32577e95430A1
2890,15627852,62406,9277502239,61466,940,202,595,0x1Fa8559e873f698292766790AeCf8080A66433F6,0x6FB3FE8b8A9e5A3396b5Fce9f61cAe179a8D1e2b
2891,15627852,21000,9277502239,21000,0,2,281,0x34d404995990b4176CE02e4Cf23F32f70D2eb28b,0x3e8D20198AB61c62066C4A463F0cAa8879d29474
2892,15627852,136578,9277502239,131898,4680,842,376,0xeae422887230C0FFB91Fd8F708f5fdD354C92F2F,0x424c0d0b13b9CEd6A5F0D8EEE1C1e0171857E98A
2893,15627852,290447,9277502239,288051,2396,522,280,0x283Af0B28c62C092C9727F1Ee09c02CA627EB7F5,0xA5Dc6d8522ba72eA8cC4d9Fc6e07EaBd21b4dF49
2894,15627852,389640,8878502239,386248,3392,714,59076,0x00000000C2Cf7648c169b25ef1C217864bFa38cC,0x5093852B185c1BDF2a87Cb76824ca43611400a02
2895,15627852,340478,8396399332,337350,3128,714,8125,0x00000000C2Cf7648c169b25ef1C217864bFa38cC,0x51A83f2aD30Ce3e0a5f39108f54cDB46401267e0
2896,15627852,261619,8396399332,259215,2404,460,2726,0xAAeCf92bEe252Ad8a31FDB66aa80E733Aa7dE609,0x4aD60235bE56324B9dc08BB831a202405D47Dc30
2897,15627852,297198,8777502239,293898,3300,1034,487,0x68b3465833fb72A70ecDF485E0e4C7bD8665Fc45,0x7862958ee0797a7ABD33A65030fC608a656febB7
2898,15627852,21000,8777502239,21000,0,2,174,0x90Bd6e7341Ef3fb67e62777d7eB69490E25e6e4a,0x06f0e4207Ac4e8b1c798113f4cc977d0331d1A1B
2899,15627852,21000,8586841000,21000,0,2,46,0x915b497404bcFA3DCB91076205F5DCFe186c92b8,0x3E9E527860d909a5241b566e96e779a067401F1B
2900,15627852,269128,8777502239,265320,3808,970,100936,0xa57Bd00134B2850B2a1c55860c9e9ea100fDd6CF,0x431B5A84aCC1297Eda88259f300262F1bc3A74f3
2901,15627852,21000,8777502239,21000,0,2,137,0x7C41A97b1EdB34a50F1353F7a9D5f20038CB3623,0x76921615041fE0bf3e3FE837f77D4A57310710C0
2902,15627852,280936,8777502239,278668,2268,650,111458,0xA69babEF1cA67A37Ffaf7a485DfFF3382056e78C,0x065e3DbaFCb2C26A978720f9eB4Bce6aD9D644a1
2903,15627852,270156,8777502239,266348,3808,970,117897,0xa57Bd00134B2850B2a1c55860c9e9ea100fDd6CF,0x26bce6eCb5b10138e4bf14aC0ffcc8727FEF3B2e
2904,15627852,143066,8777502239,136402,6664,1810,713,0x00000000006c3852cbEf3e08E8dF289169EdE581,0x4A557358Eaa1C29D2EF6375d5c138e7E60eE84B0
2905,15627852,53238,8777502239,52546,692,138,0,0x3506424F91fD33084466F402d5D97f05F8e3b4AF,0x5Afc0f4907478fa5E8f92CA3e9f44D95242cb94e
2906,15627852,181476,8777502239,179912,1564,394,127,0x1Fa8559e873f698292766790AeCf8080A66433F6,0x4FB198b9A61cb9FFffb91026944c32f73C58bA09
2907,15627852,53788,8544695750,52844,944,138,95,0x3597bfD533a99c9aa083587B074434E61Eb0A258,0x900b00C0cd0CEEFdC27855e2bC76A8c2D5c192BC
2908,15627852,46109,8231155116,45501,608,138,102467,0xdAC17F958D2ee523a2206206994597C13D831ec7,0x21Dd5c13925407e5bCec3f27aB11a355a9Dafbe3
2909,15627852,167899,8000000000,165815,2084,522,131,0x7a250d5630B4cF539739dF2C5dAcb4c659F2488D,0x721bF51c210ad66E94C67cE7b67b6f94eFBd5068
2910,15627852,600000,7975792060,596452,3548,906,1,0x6fBF1b6A681307f86c2d212f0f6Ad72621309eF1,0x1eA3eB2aebC5D3bD39d3cC514A3Ef0EC825Ae542
2911,15627852,21000,8417502239,21000,0,2,0,0x894c81FaBbdFF02A5d34595e6599B6D81F5bc833,0x648250c27B825c93bd6842a055ccfb3FBE70B6eE
2912,15627852,90000,7820896229,89392,608,138,5556,0xA0b86991c6218b36c1d19D4a2e9Eb0cE3606eB48,0x34E2cB7513A50b19f450a067ed5230A86c13A2E9
2913,15627852,150000,8302270456,149392,608,138,638776,0xA0b86991c6218b36c1d19D4a2e9Eb0cE3606eB48,0x55FE002aefF02F77364de339a1292923A15844B8
2914,15627852,281571,8006381997,277943,3628,1162,226,0x68b3465833fb72A70ecDF485E0e4C7bD8665Fc45,0xB6D1aa613F99AcA09a4aE736C37B0d9073f0265F
2915,15627852,94813,8006381997,94205,608,138,15,0xdAC17F958D2ee523a2206206994597C13D831ec7,0x033e63c821a0392A8ACBbffC647608ea76b2EB36
2916,15627852,52501,8006381997,51845,656,138,2,0x514910771AF9Ca656af840dff83E8264EcF986CA,0x0D3048b05d744E13f94f64aD7Ab44eA643B2F62d
2917,15627852,325351,7964971194,160587,164764,20794,183243,0x5E4e65926BA27467555EB562121fac00D24E9dD2,0x6887246668a3b87F54DeB3b94Ba47a6f63F32985
2918,15627853,257187,8057759671,244875,12312,3530,91228,0xA69babEF1cA67A37Ffaf7a485DfFF3382056e78C,0x4603180BBB8221157880AfaA84638E0fc467738D
2919,15627853,242022,8057759671,239850,2172,650,93261,0xA69babEF1cA67A37Ffaf7a485DfFF3382056e78C,0xFF82BF5238637B7E5E345888BaB9cd99F5Ebe331
2920,15627853,212320,20045969923,210768,1552,322,44446,0x00010033a85Db632570dCCe90D00008f000072f7,0x000000007Cb2bD00Ae5Eb839930Bb7847ae5B039
2921,15627853,69974,58057759671,69030,944,138,1048,0xd4cB651749953988647eEE9b51DDB8DB5aeb3410,0xA1CC352bC94caDdFddaA4D095762F37B2b9bc57A
2922,15627853,100000,50000000000,99392,608,138,0,0xdAC17F958D2ee523a2206206994597C13D831ec7,0x2017BD725F9432Cee396dc43e34680d5C649d129
2923,15627853,100000,30000000000,99392,608,138,0,0xdAC17F958D2ee523a2206206994597C13D831ec7,0x6384038a79C7bd9DF79b8E364603086fD964E8d5
2924,15627853,100000,30000000000,99392,608,138,0,0xdAC17F958D2ee523a2206206994597C13D831ec7,0x4cb4F8F7E333d994Ca18cbC8AC8d4640233c9ebC
2925,15627853,100000,30000000000,99392,608,138,2,0xA0b86991c6218b36c1d19D4a2e9Eb0cE3606eB48,0x115AAfEE2afE15afc52c12b3e16556ccff7888f4
2926,15627853,100000,30000000000,99392,608,138,337,0xdAC17F958D2ee523a2206206994597C13D831ec7,0xE2f485129ef5871CA79fcAB08628E0c8660FddAa
2927,15627853,100000,30000000000,99392,608,138,0,0xdAC17F958D2ee523a2206206994597C13D831ec7,0xe725f5e8Ad5a6E2dBFD88B4d6460D3729e1E60c8
2928,15627853,210000,30000000000,210000,0,2,843593,0x97B793DBf0Ee5A7E7c32128aCdc016d58c5D51AF,0xA7EFAe728D2936e78BDA97dc267687568dD593f3
2929,15627853,150000,30000000000,149344,656,138,11173683,0x3fDb992A8FdFAE1023EBC056e5f04bfDc90970A5,0xFBb1b73C4f0BDa4f67dcA266ce6Ef42f520fBB98
2930,15627853,90000,20000000000,89344,656,138,25985,0x321C2fE4446C7c963dc41Dd58879AF648838f98D,0x30741289523c2e4d2A62c7D6722686D14E723851
2931,15627853,523330,18057759671,519690,3640,1162,861,0x68b3465833fb72A70ecDF485E0e4C7bD8665Fc45,0x0a2eB196bFf5573F456D47A9fA26208a24BB5996
2932,15627853,243597,14897629700,241561,2036,522,1360,0x25553828F22bDD19a20e4F12F052903Cb474a335,0xe5956B4807116084E595057De6d795b7FDe12A3b
2933,15627853,77371,14291495348,76715,656,138,2188225,0x9D65fF81a3c488d585bBfb0Bfe3c7707c7917f54,0x75e89d5979E4f6Fba9F97c104c2F0AFB3F1dcB88
2934,15627853,1500000,13057759671,1499056,944,138,1847,0x011b0beAe3eC5953B4805b064cC78f6F892A99cC,0x5666ba60D132EDf7341166eDB2e733d79B4BCDE2
2935,15627853,390664,13027449837,385360,5304,1082,196481,0x0000000000007F150Bd6f54c40A34d7C3d5e9f56,0x0197ABe48f0a9826D10F44DaD7050f26586Eb9bA
2936,15627853,82186,12241583596,81590,596,138,6,0xdAC17F958D2ee523a2206206994597C13D831ec7,0x1501836Cef9dF36Ae813b002E664f6146c973BEA
2937,15627853,100000,12241583596,99392,608,138,0,0xdAC17F958D2ee523a2206206994597C13D831ec7,0xD057FF7643b20ca6F0e558577b8004a83b7c651D
2938,15627853,289504,12001466152,285812,3692,570,16445,0xED77777586D73C58EB4D6BEBDF9c85C2d5F56C2d,0x5f0df4aE784dB40B2D5460Aa4415A662527e43Cf
2939,15627853,5000000,12001466152,4997732,2268,650,119829,0xA69babEF1cA67A37Ffaf7a485DfFF3382056e78C,0xeCa2e2D894D19778939bD4DfC34D2a3C45E96456
2940,15627853,356690,12001466152,353382,3308,714,7335,0x00000000C2Cf7648c169b25ef1C217864bFa38cC,0x93E77ac5a0450deDb8Afc0320f620E315146e219
2941,15627853,222222,12000000000,220670,1552,394,288,0x1Fa8559e873f698292766790AeCf8080A66433F6,0x281D18d9bb2F597C7394C441d8b8A500CAa20ff5
2942,15627853,350000,11661464933,350000,0,2,6925035,0x7c91D210052Fb7D76415545C64141cA3E560c4B6,0x46340b20830761efd32832A74d7169B29FEB9758
2943,15627853,350000,11661464933,350000,0,2,6925036,0x98A0d237cd78E45F900014212A9A067e9D5EeDCa,0x46340b20830761efd32832A74d7169B29FEB9758
2944,15627853,350000,11661464933,349392,608,138,6925037,0xA0b86991c6218b36c1d19D4a2e9Eb0cE3606eB48,0x46340b20830761efd32832A74d7169B29FEB9758
2945,15627853,350000,11661464933,349392,608,138,6925038,0xdAC17F958D2ee523a2206206994597C13D831ec7,0x46340b20830761efd32832A74d7169B29FEB9758
2946,15627853,21000,11620000000,21000,0,2,6,0x0ECc605193b33Db44AeB3bd5ad51E5b8589b7322,0x98bf4A4171080B9B6A0CF1fF48Bb5f23acc4c927
2947,15627853,70000,11000000000,69404,596,138,266,0xdAC17F958D2ee523a2206206994597C13D831ec7,0xDFc210b2C283955F2D7c12b8d62237Aa636Bc627
2948,15627853,21000,11000000000,21000,0,2,91,0x17aB4667A7Cd5C5CF79B779f8528c76AeA461A52,0xdCd84f278d195D7bc965d16464D8511Ac5cc395F
2949,15627853,21000,11000000000,21000,0,2,0,0x703fAC6AD06b9cff3dc4063CA50502d8291f87fB,0x39A0d855b4f1127b387F006CEFbAc1CB42E0efe1
2950,15627853,21000,10730159185,21000,0,2,1,0xCBD6832Ebc203e49E2B771897067fce3c58575ac,0x2576319e138A983061EE4374F7D2b2fDf27F11Ca
2951,15627853,21000,10730159185,21000,0,2,3,0xCBD6832Ebc203e49E2B771897067fce3c58575ac,0xcA97f1EdA0795685c1d831ac94865f559cc87D93
2952,15627853,144678,10557759671,143294,1384,394,70,0x0BABA1Ad5bE3a5C0a66E7ac838a129Bf948f1eA4,0x90FEdB809d30520C46977b55be9D1ef87C611EAB
2953,15627853,143796,10557759671,143592,204,74,15,0x7F9306FC1978938d5C1C57Bf6044dc67E07eeB8a,0x60d770D1707EDF692601A4dD4ea802d241C7fF19
2954,15627853,150756,10557759671,150692,64,10,7,0x65c2e54a4c75ff6da7b6B32369c1677250075fb2,0x3B49BD8DfD57B9a501A05d1Ff80C089eb029823F
2955,15627853,21000,10477759671,21000,0,2,23,0xA554849eBb0E2BBB668f69541d58Bd42ddbc86cc,0x9034B7e63b53Cd2ecF68D21b0c5Ecc097bE36b15
2956,15627853,69000,10457759671,68512,488,138,290,0xD27dcbcC8778a8AB33AAc529Df36a634567Be325,0xAE71F9Ae16783E3b67560B45A513FF6F8e5a0a45
2957,15627853,361753,10291464022,356781,4972,1018,83031,0x0000000000007F150Bd6f54c40A34d7C3d5e9f56,0x0336E78E4D09b8A6A84D34d0fD103452dE57A7A3
2958,15627853,753340,10057759671,744680,8660,2442,4102,0x68b3465833fb72A70ecDF485E0e4C7bD8665Fc45,0xaAa313393E79ea3454939e843E0AA8DEC66A9949
2959,15627853,21000,10057759671,21000,0,2,88935,0x71De0264475Cb3db664BA1Fb5C9F3f1879991d3F,0x3018018c44338B9728d02be12d632C6691E020d1
2960,15627853,38000,10057759671,37332,668,138,3,0xE41d2489571d322189246DaFA5ebDe1F4699F498,0xa5bbEb2bCE3B3035Df4Aa1DEF996532CA29179af
2961,15627853,207128,10057759671,206520,608,138,4232329,0xdAC17F958D2ee523a2206206994597C13D831ec7,0xDFd5293D8e347dFe59E90eFd55b2956a1343963d
2962,15627853,207128,10057759671,207128,0,2,3492272,0xBc86dA04ab1A0926bAA23e0C1F49F75A31EAeCd1,0x56Eddb7aa87536c09CCc2793473599fD21A8b17F
2963,15627853,38000,10057759671,37344,656,138,7162,0xE41d2489571d322189246DaFA5ebDe1F4699F498,0xe3792A9c235D434B702023b33F03C48C41631090
2964,15627853,207128,10057759671,207128,0,2,4468939,0x578673583f6948888f58AB7a1B085e89b6Fd4F56,0x21a31Ee1afC51d94C2eFcCAa2092aD1028285549
2965,15627853,207128,10057759671,206508,620,138,4708694,0xdAC17F958D2ee523a2206206994597C13D831ec7,0x28C6c06298d514Db089934071355E5743bf21d60
2966,15627853,201916,10057759671,199180,2736,842,158,0x68b3465833fb72A70ecDF485E0e4C7bD8665Fc45,0xccbfEE66dDb3E7e14394b128294e532BBa772C00
2967,15627853,77187,10057759671,76699,488,138,841,0x7F9306FC1978938d5C1C57Bf6044dc67E07eeB8a,0x6B0a789e01eC7e7c2d02905d9DaBD3e879Ff7417
2968,15627853,207128,10057759671,206508,620,138,3492273,0xdAC17F958D2ee523a2206206994597C13D831ec7,0x56Eddb7aa87536c09CCc2793473599fD21A8b17F
2969,15627853,21000,10057759671,21000,0,2,469159,0x0444AEb79BAD8ed93473C9AD597Fc4fdC0C009CC,0xb739D0895772DBB71A89A3754A160269068f0D45
2970,15627853,21000,10057759671,21000,0,2,8265747,0x30e4094f6D678F78bD96102BA27DA1d005D251b9,0xb5d85CBf7cB3EE0D56b3bB207D5Fc4B82f43F511
2971,15627853,2000000,10057759671,1993184,6816,1610,171038,0xA9D1e08C7793af67e9d92fe308d5697FB81d3E43,0x7830c87C02e56AFf27FA8Ab1241711331FA86F43
2972,15627853,21000,10057759671,21000,0,2,8265748,0x47838ef51d0F1C49B40A400F4252a91E1F43a2D1,0xb5d85CBf7cB3EE0D56b3bB207D5Fc4B82f43F511
2973,15627853,2000000,10057759671,1992148,7852,1738,171039,0xA9D1e08C7793af67e9d92fe308d5697FB81d3E43,0x7830c87C02e56AFf27FA8Ab1241711331FA86F43
2974,15627853,21000,10057759671,21000,0,2,469160,0xB8Cca5b6d8b673dE87160a3F7768504baDa0aEe3,0xb739D0895772DBB71A89A3754A160269068f0D45
2975,15627853,21000,10057759671,21000,0,2,52376,0xa516B3825ab8626711Cb1d6F631a0Ed67189EECA,0x7c195D981AbFdC3DDecd2ca0Fed0958430488e34
2976,15627853,21000,10057759671,21000,0,2,1783202,0xc15703280c897e2B68c28a4b7311914a22c612F8,0x503828976D22510aad0201ac7EC88293211D23Da
2977,15627853,21000,10057759671,21000,0,2,6578030,0x2E5D888b1364564c1AA0082E4DaDeEf0Cf69C54F,0xeB2629a2734e272Bcc07BDA959863f316F4bD4Cf
2978,15627853,21000,10057759671,21000,0,2,7100798,0xCb46b412Dd77d3714A21E1cba7De307b168DD161,0xddfAbCdc4D8FfC6d5beaf154f18B778f892A0740
2979,15627853,142261,10057759671,135673,6588,1802,200,0x00000000006c3852cbEf3e08E8dF289169EdE581,0xDB11249D40E05c050348ecA59cF90Fdd6b161aCb
2980,15627853,44465,10057759671,42717,1748,522,507,0x1A90B3Dead0113740266b7F7Ea1136e8ED1b48C5,0x62Ef8b356751612Ad33863c454825BF94998AF2E
2981,15627853,42000,10057759671,42000,0,2,329522,0xF56F4B7bfA410a4ce28a0da0918D4626E7E0d37D,0x9430801EBAf509Ad49202aaBC5F5Bc6fd8A3dAf8
2982,15627853,21000,10057759671,21000,0,2,1,0xA090e606E30bD747d4E6245a1517EbE430F0057e,0x87E9F402637146A13c4594eDaA82942392620a8f
2983,15627853,21000,10057759671,21000,0,2,5722,0xA090e606E30bD747d4E6245a1517EbE430F0057e,0x4675C7e5BaAFBFFbca748158bEcBA61ef3b0a263
2984,15627853,21000,10057759671,21000,0,2,3,0xA090e606E30bD747d4E6245a1517EbE430F0057e,0x7B4389E1f15E8278192A43186c7d1D84EA8a7317
2985,15627853,21000,10057759671,21000,0,2,1,0xA090e606E30bD747d4E6245a1517EbE430F0057e,0x3636C7CCECA450B2Ffaaa938e204C42E58Ae2ae6
2986,15627853,21000,10057759671,21000,0,2,1,0xA090e606E30bD747d4E6245a1517EbE430F0057e,0x26E4918C171D3f7907AE8E8EcEA2d2FE2BACE1be
2987,15627853,21000,10057759671,21000,0,2,1,0xA090e606E30bD747d4E6245a1517EbE430F0057e,0x94C126499d320f1f210C79e2C838E1ab7EbD776c
2988,15627853,21000,10057759671,21000,0,2,1,0xA090e606E30bD747d4E6245a1517EbE430F0057e,0xe734a05fb309A67d88b81F4fBA313DE14e68Cc91
2989,15627853,21000,10057759671,21000,0,2,1,0xA090e606E30bD747d4E6245a1517EbE430F0057e,0xCc5Ae548E7F49A37Db8c3a906C533814dF10C17d
2990,15627853,21000,10057759671,21000,0,2,1,0xA090e606E30bD747d4E6245a1517EbE430F0057e,0x6b2aA12A97edBDC733608884e5cF6539D8963d75
2991,15627853,21000,10057759671,21000,0,2,1,0xA090e606E30bD747d4E6245a1517EbE430F0057e,0x64CBFBb09E2784C2864Fd8CeEdAb70DD286FD12C
2992,15627853,21000,10057759671,21000,0,2,1,0xA090e606E30bD747d4E6245a1517EbE430F0057e,0x133968e2034A19268E617f223A7D133B61c7CBCc
2993,15627853,21000,10057759671,21000,0,2,1,0xA090e606E30bD747d4E6245a1517EbE430F0057e,0x830445Dee8a20F465566289b9645F1EdeECaD2A9
2994,15627853,30732,10057759671,30668,64,10,361,0xC02aaA39b223FE8D0A0e5C4F27eAD9083C756Cc2,0x56BA8Fd2E10556c9991959539e58f1AE8Da3ACD2
2995,15627853,21000,10057759671,21000,0,2,1,0xA090e606E30bD747d4E6245a1517EbE430F0057e,0x8C83c99396149B01506C0E57Ed713F4642e77Bf0
2996,15627853,21000,10057759671,21000,0,2,1,0xA090e606E30bD747d4E6245a1517EbE430F0057e,0x3077E0D8FFA611AC60a6AEdb4919199Ce46AbcaE
2997,15627853,21000,10057759671,21000,0,2,1,0xA090e606E30bD747d4E6245a1517EbE430F0057e,0x9bce2023310B7fF82330A1B6A79875Dd05717f30
2998,15627853,21000,10057759671,21000,0,2,1,0xA090e606E30bD747d4E6245a1517EbE430F0057e,0x8b2ff3D7D6b084bcF9b18c8f897229Fbfd2B5eb0
2999,15627853,21000,10057759671,21000,0,2,1,0xA090e606E30bD747d4E6245a1517EbE430F0057e,0xfB2515498D2b9114a5b24615152bD8cB9Dc576d5
3000,15627853,21000,10057759671,21000,0,2,1,0xA090e606E30bD747d4E6245a1517EbE430F0057e,0x1e04800a1eD6f25462dB30397ad672D0635B59D4
3001,15627853,21000,10057759671,21000,0,2,1,0xA090e606E30bD747d4E6245a1517EbE430F0057e,0xF080060Ba73e4DC6198FF0d52a359Cd753B2d494
3002,15627853,21000,10057759671,21000,0,2,1,0xA090e606E30bD747d4E6245a1517EbE430F0057e,0xefdD2F14253c298c1FD74d8f4Fbd26E8b9CE75f8
3003,15627853,21000,10057759671,21000,0,2,1,0xA090e606E30bD747d4E6245a1517EbE430F0057e,0x8129446D672a833B6dd44fB0b77d64079Dd20803
3004,15627853,21000,10057759671,21000,0,2,1,0xA090e606E30bD747d4E6245a1517EbE430F0057e,0x91a8821A6c0F10355B7ce25fc61Fa2FACFc01fac
3005,15627853,21000,10057759671,21000,0,2,1,0xA090e606E30bD747d4E6245a1517EbE430F0057e,0x1325a05BeedF345C65EC73B92406B7290F1eE386
3006,15627853,21000,10057759671,21000,0,2,1,0xA090e606E30bD747d4E6245a1517EbE430F0057e,0x29937ef7a1e64ee6737b69045dC0787F4D519c19
3007,15627853,21000,10057759671,21000,0,2,1,0xA090e606E30bD747d4E6245a1517EbE430F0057e,0x8A9f1Aca6A05e4fbf9F6Ff64456AdeaD5ad53442
3008,15627853,21000,10057759671,21000,0,2,1,0xA090e606E30bD747d4E6245a1517EbE430F0057e,0x2dc63bD0bFCf0C43B8C33743bC83C509A875f0c7
3009,15627853,21000,10057759671,21000,0,2,1,0xA090e606E30bD747d4E6245a1517EbE430F0057e,0xdEA6Fc182A69B0f742e9ec879280a92460aba8E5
3010,15627853,21000,10057759671,21000,0,2,1,0xA090e606E30bD747d4E6245a1517EbE430F0057e,0xf353476b2a6c696B6D91337d13ed6ab0DC133E39
3011,15627853,21000,10057759671,21000,0,2,1,0xA090e606E30bD747d4E6245a1517EbE430F0057e,0x85ea8cFe0f5Ef18D03664bF869a6C637b00B9443
3012,15627853,21000,10057759671,21000,0,2,1,0xA090e606E30bD747d4E6245a1517EbE430F0057e,0x00368F02f56eEF02940e46A62d431B0b7A03F779
3013,15627853,21000,10057759671,21000,0,2,1,0xA090e606E30bD747d4E6245a1517EbE430F0057e,0xBF293F931b9F923511CaFF83Cef39Cf2154ebe06
3014,15627853,21000,10057759671,21000,0,2,1,0xA090e606E30bD747d4E6245a1517EbE430F0057e,0xF306DD51903581c5c5357a914CF59663107De5B5
3015,15627853,21000,10057759671,21000,0,2,1,0xA090e606E30bD747d4E6245a1517EbE430F0057e,0x052D502eA49d5b16d437481e97839F9a179EA26b
3016,15627853,21000,10057759671,21000,0,2,1,0xA090e606E30bD747d4E6245a1517EbE430F0057e,0x7a23DBab9a6d67FCb2Da58b0b65d83b9DC7cb741
3017,15627853,21000,10057759671,21000,0,2,1,0xA090e606E30bD747d4E6245a1517EbE430F0057e,0xB88eED23c0dfDf16E4F8BA81b1CAd17cbb38662f
3018,15627853,21000,10057759671,21000,0,2,1,0xA090e606E30bD747d4E6245a1517EbE430F0057e,0x64484A44a346c704086d98a086666E45c610650e
3019,15627853,21000,10057759671,21000,0,2,1,0xA090e606E30bD747d4E6245a1517EbE430F0057e,0x621418c566EF7cf062f34d4bd4CC3f2Dfd7c23eF
3020,15627853,21000,10057759671,21000,0,2,1,0xA090e606E30bD747d4E6245a1517EbE430F0057e,0x7f2efD68fb3E7829375e477a27aF66D1E0B66466
3021,15627853,21000,10057759671,21000,0,2,1,0xA090e606E30bD747d4E6245a1517EbE430F0057e,0xF76858FCAe59FDF5b42D60402B6FCBFef6f1A769
3022,15627853,21000,10057759671,21000,0,2,1,0xA090e606E30bD747d4E6245a1517EbE430F0057e,0xF33E5F349Ef64702a0121f9fd4C536cb867D7038
3023,15627853,21000,10057759671,21000,0,2,1,0xA090e606E30bD747d4E6245a1517EbE430F0057e,0x19782e000cFcbf9015004130fB10D2864da09763
3024,15627853,21000,10057759671,21000,0,2,1,0xA090e606E30bD747d4E6245a1517EbE430F0057e,0xE52Fd092342D7A18eA09bD7dD95e13Fe45645152
3025,15627853,21000,10057759671,21000,0,2,1,0xA090e606E30bD747d4E6245a1517EbE430F0057e,0x44e4635eF5ef67fBeB634136769d97f6EBA14076
3026,15627853,21000,10057759671,21000,0,2,1,0xA090e606E30bD747d4E6245a1517EbE430F0057e,0x84d44031293f3A7Df371db6Ffe3a7363e8aD0352
3027,15627853,21000,10057759671,21000,0,2,1,0xA090e606E30bD747d4E6245a1517EbE430F0057e,0x178a20D7F6386E1aDdA757EBA2dAc9BD1775Ebda
3028,15627853,21000,10057759671,21000,0,2,1,0xA090e606E30bD747d4E6245a1517EbE430F0057e,0xBDFd56407A4df070f305F93442aB6F4Eec9C28EC
3029,15627853,21000,10057759671,21000,0,2,1,0xA090e606E30bD747d4E6245a1517EbE430F0057e,0x67024c92467213c04d7BEB83Cc61C6a7997e9883
3030,15627853,21000,10057759671,21000,0,2,1,0xA090e606E30bD747d4E6245a1517EbE430F0057e,0xD5a2182b7CF3d1136673506FE648800c1Fae2DFc
3031,15627853,21000,10057759671,21000,0,2,1,0xA090e606E30bD747d4E6245a1517EbE430F0057e,0x545Eec11BFD64a906fEdC2378BAD9606C259cDFD
3032,15627853,21000,10057759671,21000,0,2,1,0xA090e606E30bD747d4E6245a1517EbE430F0057e,0x95F00AF662Db9271691781b94fa6C22590c96Ce4
3033,15627853,21000,10057759671,21000,0,2,1,0xA090e606E30bD747d4E6245a1517EbE430F0057e,0x5f4d6C2CCa0379b7470f74c2df1D927CB63d4CF2
3034,15627853,39617,10057759671,39353,264,74,2784,0xC02aaA39b223FE8D0A0e5C4F27eAD9083C756Cc2,0x17A77D63765963d0Cb9deC12Fa8F62E68Fee8fD4
3035,15627853,21000,10057759671,21000,0,2,1,0xA090e606E30bD747d4E6245a1517EbE430F0057e,0xBF6B619D34b068c3dFb06738f6e878bcc82DA618
3036,15627853,21000,10057759671,21000,0,2,1,0xA090e606E30bD747d4E6245a1517EbE430F0057e,0xfFFefD661f2C6551da2837e5443F2a8e1a606F39
3037,15627853,21000,10057759671,21000,0,2,1,0xA090e606E30bD747d4E6245a1517EbE430F0057e,0xe9fad74b9ABf2e776ef2F2b0B4563DedE67bcD99
3038,15627853,21000,10057759671,21000,0,2,1,0xA090e606E30bD747d4E6245a1517EbE430F0057e,0x249d48A2389f4D6178c86d7368dC2f4e336E779d
3039,15627853,21000,10057759671,21000,0,2,1,0xA090e606E30bD747d4E6245a1517EbE430F0057e,0xCF87817A4F2896f4a44704fEAeE919A3C5D56959
3040,15627853,21000,10057759671,21000,0,2,1,0xA090e606E30bD747d4E6245a1517EbE430F0057e,0xec7F91Fad65d72F93548e07aa1603D93de001D7a
3041,15627853,21000,10057759671,21000,0,2,1,0xA090e606E30bD747d4E6245a1517EbE430F0057e,0xf53E6FC60200c706b5A9cAf17Fa3a2aa5983606a
3042,15627853,21000,10057759671,21000,0,2,1,0xA090e606E30bD747d4E6245a1517EbE430F0057e,0xc885FD0044cC0a9Ce06acC3c918a618b7aDA33fA
3043,15627853,21000,10057759671,21000,0,2,1,0xA090e606E30bD747d4E6245a1517EbE430F0057e,0x37E511E4a9d9F3303b848732E3F85F3bf9CA7574
3044,15627853,21000,10057759671,21000,0,2,1,0xA090e606E30bD747d4E6245a1517EbE430F0057e,0xE8631A14C2935958336d104B05fe8fdAD6005b4E
3045,15627853,21000,10057759671,21000,0,2,1,0xA090e606E30bD747d4E6245a1517EbE430F0057e,0x33b2da055a2FEe907708dc6c7c0D2783f4FF4f41
3046,15627853,21000,10057759671,21000,0,2,1,0xA090e606E30bD747d4E6245a1517EbE430F0057e,0x5d320B85589185B895DF5cc37ec561EC6FC2ca88
3047,15627853,21000,10057759671,21000,0,2,1,0xA090e606E30bD747d4E6245a1517EbE430F0057e,0xC6D52F665908EeD4866cE4a613e02997dd9a260C
3048,15627853,21000,10057759671,21000,0,2,1,0xA090e606E30bD747d4E6245a1517EbE430F0057e,0x532687ab60523bD63f997eA5E1c99FD839C9DE77
3049,15627853,21000,10057759671,21000,0,2,1,0xA090e606E30bD747d4E6245a1517EbE430F0057e,0x5C84FBB1733bd895D2452D7f705277486f1473BA
3050,15627853,21000,10057759671,21000,0,2,1,0xA090e606E30bD747d4E6245a1517EbE430F0057e,0x1f606dC0DF72170FD3228AEeCBc13E4E607a1924
3051,15627853,21000,10057759671,21000,0,2,1,0xA090e606E30bD747d4E6245a1517EbE430F0057e,0xA3f77d09C7681dCC4af1E4411Ae4176552C2f4f0
3052,15627853,21000,10057759671,21000,0,2,1,0xA090e606E30bD747d4E6245a1517EbE430F0057e,0x487fe874f5b4B62E9246bAf02ade95114186c3da
3053,15627853,21000,10057759671,21000,0,2,1,0xA090e606E30bD747d4E6245a1517EbE430F0057e,0xABf58e051C29Ab94712D74ee93f226e08A16dd74
3054,15627853,21000,10057759671,21000,0,2,1,0xA090e606E30bD747d4E6245a1517EbE430F0057e,0x3aF910954c52D1d07a6B746E154Cc2675DF1D6F2
3055,15627853,21000,10057759671,21000,0,2,1,0xA090e606E30bD747d4E6245a1517EbE430F0057e,0xef0E6352840CD7FA3516Bb18eA0C93409fe2b24B
3056,15627853,21000,10057759671,21000,0,2,1,0xA090e606E30bD747d4E6245a1517EbE430F0057e,0xa2645F2F9Af9F684a7AFA4376669B9B9F3Af0470
3057,15627853,21000,10057759671,21000,0,2,1,0xA090e606E30bD747d4E6245a1517EbE430F0057e,0x1F51183FBB6606086e43d8337A4dBd8968EFc534
3058,15627853,21000,10057759671,21000,0,2,1,0xA090e606E30bD747d4E6245a1517EbE430F0057e,0x7Af99b7e316Ca27481315663bfAceA33f458ba1C
3059,15627853,21000,10057759671,21000,0,2,1,0xA090e606E30bD747d4E6245a1517EbE430F0057e,0xdf05071294125398426150d088e3ED2fe8B17db7
3060,15627853,21000,10057759671,21000,0,2,1,0xA090e606E30bD747d4E6245a1517EbE430F0057e,0x38cAE3A6d67149995997ad8A0fb0Ebb719cbb2dA
3061,15627853,21000,10057759671,21000,0,2,1,0xA090e606E30bD747d4E6245a1517EbE430F0057e,0x14DC2e040fB493C14Cce75f880297b15a8634430
3062,15627853,21000,10057759671,21000,0,2,1,0xA090e606E30bD747d4E6245a1517EbE430F0057e,0xd8dA8A7265b0809d5b9371FD9AD996de42382501
3063,15627853,21000,10057759671,21000,0,2,1,0xA090e606E30bD747d4E6245a1517EbE430F0057e,0x0BDed8D845C79791896B866e4F77A3A395a7cd7f
3064,15627853,21000,10057759671,21000,0,2,1,0xA090e606E30bD747d4E6245a1517EbE430F0057e,0x79164c7897d0377Bc7125B7E54e18c84Dd441f70
3065,15627853,21000,10057759671,21000,0,2,1,0xA090e606E30bD747d4E6245a1517EbE430F0057e,0x06359a179b3ddc829a310DACcebB34380Ae05940
3066,15627853,21000,10057759671,21000,0,2,2759937,0xF501B1AD5dFC929cD31bb69fa58f668d27241184,0x267be1C1D684F78cb4F6a176C4911b741E4Ffdc0
3067,15627853,21000,10057759671,21000,0,2,1,0xA090e606E30bD747d4E6245a1517EbE430F0057e,0x7946A488Edbe716d80477070e84d07864F8DAD97
3068,15627853,21000,10057759671,21000,0,2,1,0xA090e606E30bD747d4E6245a1517EbE430F0057e,0x79fbFf9a317595d1C0289636661eD99b9308c753
3069,15627853,21000,10057759671,21000,0,2,1,0xA090e606E30bD747d4E6245a1517EbE430F0057e,0xd4509cb9bf19a73d5dFf4BA9a7240b921d8B0Dad
3070,15627853,21000,10057759671,21000,0,2,1,0xA090e606E30bD747d4E6245a1517EbE430F0057e,0x6153741C46C2698Cc82eC68c2D339605383159eF
3071,15627853,21000,10057759671,21000,0,2,1,0xA090e606E30bD747d4E6245a1517EbE430F0057e,0x0D79538505B51b4C180A61009442Aa167F006652
3072,15627853,21000,10057759671,21000,0,2,1,0xA090e606E30bD747d4E6245a1517EbE430F0057e,0x10905be96e745e77F658e3ddbA02ba2D75D8cb6B
3073,15627853,21000,10057759671,21000,0,2,1,0xA090e606E30bD747d4E6245a1517EbE430F0057e,0xED93B1968210E47A891eAbBB530a8007C39f170B
3074,15627853,21000,10057759671,21000,0,2,1,0xA090e606E30bD747d4E6245a1517EbE430F0057e,0x74eAF86C2a4D3B98a287660705f9a1bDD1248EB3
3075,15627853,21000,10057759671,21000,0,2,1,0xA090e606E30bD747d4E6245a1517EbE430F0057e,0x85253B5fD12433C0321E86ECb3E46565964F5A62
3076,15627853,21000,10057759671,21000,0,2,1,0xA090e606E30bD747d4E6245a1517EbE430F0057e,0x73D3fAC1d37E224Bf0ac95264c406749EEF5fA47
3077,15627853,21000,10057759671,21000,0,2,6,0xA090e606E30bD747d4E6245a1517EbE430F0057e,0x6AD6CADdE089B54Eee5538fD94BE73A5de776C9F
3078,15627853,21000,10057759671,21000,0,2,1,0xA090e606E30bD747d4E6245a1517EbE430F0057e,0x5C1bf6ce86a9D30d6C8537b76662Cc7380748bEB
3079,15627853,21000,10057759671,21000,0,2,1,0xA090e606E30bD747d4E6245a1517EbE430F0057e,0x9C53FC496F6f5138b637D7a5B3b1F2365EC74018
3080,15627853,21000,10057759671,21000,0,2,1,0xA090e606E30bD747d4E6245a1517EbE430F0057e,0xdC832b9C6313D6b1f5731808C7064114e2E51c98
3081,15627853,21000,10057759671,21000,0,2,3,0xA090e606E30bD747d4E6245a1517EbE430F0057e,0x1c64531Ed3AFAf315Ab1773688d8Ab7ADFE98E87
3082,15627853,21000,10057759671,21000,0,2,1,0xA090e606E30bD747d4E6245a1517EbE430F0057e,0x94E64344F83195c64Ac40CC67AE55A57Bc2c5ea4
3083,15627853,21000,10057759671,21000,0,2,1,0xA090e606E30bD747d4E6245a1517EbE430F0057e,0x318e4BF15B828EE216445882bA3ECbbC3bfd21f1
3084,15627853,21000,10057759671,21000,0,2,1,0xA090e606E30bD747d4E6245a1517EbE430F0057e,0x79357Ffc0C44Bdef8a1566e3dfEc02D3d347441d
3085,15627853,21000,10057759671,21000,0,2,1,0xA090e606E30bD747d4E6245a1517EbE430F0057e,0xBEE8bB03C5ed393d6cb6ab8bBCeA198aDa4C9833
3086,15627853,21000,10057759671,21000,0,2,3,0xA090e606E30bD747d4E6245a1517EbE430F0057e,0x5DA4f60e021b607425107D07183ACD71896b7f94
3087,15627853,21000,10057759671,21000,0,2,3,0xA090e606E30bD747d4E6245a1517EbE430F0057e,0x3F816d5DD09F85e3aC3104e3d9D34FAB1A2afbbc
3088,15627853,21000,10057759671,21000,0,2,1,0xA090e606E30bD747d4E6245a1517EbE430F0057e,0xbD10480a59C962Ef94f6B9f9FC68a073acb50c3A
3089,15627853,21000,10057759671,21000,0,2,1,0xA090e606E30bD747d4E6245a1517EbE430F0057e,0xAf544D24cD2A3BA39B7aB5B3575023FB941Bf5ab
3090,15627853,21000,10057759671,21000,0,2,1,0xA090e606E30bD747d4E6245a1517EbE430F0057e,0xd535aB4fEfD2487Aa030124617e238172c16De57
3091,15627853,21000,10057759671,21000,0,2,20,0xA090e606E30bD747d4E6245a1517EbE430F0057e,0xb87B012e10B34b6331a8D70ca21D7a8Ee6eC5D2b
3092,15627853,21000,10057759671,21000,0,2,4,0xA090e606E30bD747d4E6245a1517EbE430F0057e,0x57846bFbA539EeDdb65A1F4bE31F09367429E0cB
3093,15627853,21000,10057759671,21000,0,2,3,0xA090e606E30bD747d4E6245a1517EbE430F0057e,0x0254db7ef6e19850fcea2D2d873169002cB5aDA4
3094,15627853,21000,10057759671,21000,0,2,3,0xA090e606E30bD747d4E6245a1517EbE430F0057e,0xfBF05990aEfE0D0eFD55D7Ae0005364BF585AEc6
3095,15627853,21000,10057759671,21000,0,2,1,0xA090e606E30bD747d4E6245a1517EbE430F0057e,0x23b20dcD8f1d8ff84f31b5709e1CAd464fea00f6
3096,15627853,21000,10057759671,21000,0,2,2,0xA090e606E30bD747d4E6245a1517EbE430F0057e,0xfb9bdcFc48a10C8a2e1dd0D4696C73C041dBc504
3097,15627853,21000,10057759671,21000,0,2,1,0xA090e606E30bD747d4E6245a1517EbE430F0057e,0x19E1a3B27978681f848adB00a2d0200638318Fa2
3098,15627853,21000,10057759671,21000,0,2,2,0xA090e606E30bD747d4E6245a1517EbE430F0057e,0x1828184f530136D5e54ad51B973F9F20d7E940DE
3099,15627853,21000,10057759671,21000,0,2,3,0xA090e606E30bD747d4E6245a1517EbE430F0057e,0x3cD365fBa9806418C46A5619E4c4D915997BC3e2
3100,15627853,21000,10057759671,21000,0,2,5,0xA090e606E30bD747d4E6245a1517EbE430F0057e,0x56E9c80D19dE348fA108f0B2A6AA0b4000d50C93
3101,15627853,21000,10057759671,21000,0,2,4,0xA090e606E30bD747d4E6245a1517EbE430F0057e,0xB02993aB5507aD5673A3633b137D7fBf0e6D1A63
3102,15627853,21000,10057759671,21000,0,2,1,0xA090e606E30bD747d4E6245a1517EbE430F0057e,0xDE037A31CCc55516A0c5e9E0557756D48bDC5ebE
3103,15627853,21000,10057759671,21000,0,2,3,0xA090e606E30bD747d4E6245a1517EbE430F0057e,0x364c4a2d8d9B557474BA596D7a30172C68E0dAA1
3104,15627853,21000,10057759671,21000,0,2,1,0xA090e606E30bD747d4E6245a1517EbE430F0057e,0x7AEb6681e4973edb2598099821714e725CD3c1ef
3105,15627853,38000,10057759671,37344,656,138,2224,0xE41d2489571d322189246DaFA5ebDe1F4699F498,0x49710476eeF14761f3ceDACaC944ec8693f993E8
3106,15627853,21000,10057759671,21000,0,2,3,0xA090e606E30bD747d4E6245a1517EbE430F0057e,0xD2fe1CF6aAEbac1b76006d413230F98F432a4867
3107,15627853,21000,10057759671,21000,0,2,3,0xA090e606E30bD747d4E6245a1517EbE430F0057e,0xc5f4653E5D5678fC832D8A45879F264fD47ED937
3108,15627853,21000,10057759671,21000,0,2,3,0xA090e606E30bD747d4E6245a1517EbE430F0057e,0x6F96F976684c4c158Ee920f092792B9EBA1a1787
3109,15627853,21000,10057759671,21000,0,2,1,0xA090e606E30bD747d4E6245a1517EbE430F0057e,0x31595D4dC7584A5f6C04710Ef9F8E3C829284BC0
3110,15627853,38000,10057759671,37344,656,138,59,0xE41d2489571d322189246DaFA5ebDe1F4699F498,0xFe177011Cd1C75AD5467aaE5F10Ff260E67B3Bdc
3111,15627853,21000,10057759671,21000,0,2,3,0xA090e606E30bD747d4E6245a1517EbE430F0057e,0x10c7B324882e236289ab56282F5661864772A92f
3112,15627853,21000,10057759671,21000,0,2,3,0xA090e606E30bD747d4E6245a1517EbE430F0057e,0x46F1780e684BA906611560a50C0b51fa890ddFcC
3113,15627853,21000,10057759671,21000,0,2,1,0xA090e606E30bD747d4E6245a1517EbE430F0057e,0x714dD560cD8Fe4bCb521e412869940A145cd5747
3114,15627853,21000,10057759671,21000,0,2,1,0xA090e606E30bD747d4E6245a1517EbE430F0057e,0x01BEF272D1Bb1315Fd13aA358b5f9630B2e579fb
3115,15627853,21000,10057759671,21000,0,2,3,0xA090e606E30bD747d4E6245a1517EbE430F0057e,0x64dA101417a27c28158B99e61CecE40C60B8d6F9
3116,15627853,21000,10057759671,21000,0,2,3,0xA090e606E30bD747d4E6245a1517EbE430F0057e,0x3d07581cCbb4D39e6Ce86185239e36F1A9c3A3F6
3117,15627853,21000,10057759671,21000,0,2,1,0xA090e606E30bD747d4E6245a1517EbE430F0057e,0xd8F83B5328D26032CB31507De589e1Bb22065482
3118,15627853,21000,10057759671,21000,0,2,2,0xA090e606E30bD747d4E6245a1517EbE430F0057e,0x48D6950119426999C6D2e70BB9F28eC6cDAaDC91
3119,15627853,21000,10057759671,21000,0,2,2,0xA090e606E30bD747d4E6245a1517EbE430F0057e,0x33b88698cb9704D51A518CDafb635F7306a21213
3120,15627853,21000,10057759671,21000,0,2,3,0xA090e606E30bD747d4E6245a1517EbE430F0057e,0xf73058c3924a0839be46bd7fa67953840De5F456
3121,15627853,21000,10057759671,21000,0,2,2,0xA090e606E30bD747d4E6245a1517EbE430F0057e,0x54E37E5289192E1A7264483B443294D6f0398F9E
3122,15627853,21000,10057759671,21000,0,2,2,0xA090e606E30bD747d4E6245a1517EbE430F0057e,0xD5c9676f90EA7add481188dc61EE6b6253AE5FFE
3123,15627853,21000,10057759671,21000,0,2,2,0xA090e606E30bD747d4E6245a1517EbE430F0057e,0x57dCde302AAd3A6343d6A1478FdFe04dE2Cd6832
3124,15627853,21000,10057759671,21000,0,2,2,0xA090e606E30bD747d4E6245a1517EbE430F0057e,0xAdf816559104f34bC2dD54aE0539DB16a63dA915
3125,15627853,21000,10057759671,21000,0,2,3,0xA090e606E30bD747d4E6245a1517EbE430F0057e,0xCB4fAF27f6fFCE7067cEB1a17655eed7CfdE1a97
3126,15627853,21000,10057759671,21000,0,2,1,0xA090e606E30bD747d4E6245a1517EbE430F0057e,0xE03AfB11D718758685804138aeBE5F2780541dF5
3127,15627853,21000,10057759671,21000,0,2,3,0xA090e606E30bD747d4E6245a1517EbE430F0057e,0xc4ffaaAe89D21967272B529Aa92D24387322D596
3128,15627853,21000,10057759671,21000,0,2,2,0xA090e606E30bD747d4E6245a1517EbE430F0057e,0xE4A84A4BbDeB88F592c18b2C635777233B501343
3129,15627853,21000,10057759671,21000,0,2,1,0xA090e606E30bD747d4E6245a1517EbE430F0057e,0x2d2647fe8ec5F36Ee740b0EC8B7042FadDCa239A
3130,15627853,21000,10057759671,21000,0,2,3,0xA090e606E30bD747d4E6245a1517EbE430F0057e,0xdB4CAd3E675994aEB6A778Ad4bB67f0c019cBb92
3131,15627853,21000,10057759671,21000,0,2,2,0xA090e606E30bD747d4E6245a1517EbE430F0057e,0xe0e7293f390F7df9406d43ad50235dD5D7EfC54a
3132,15627853,21000,10057759671,21000,0,2,4,0xA090e606E30bD747d4E6245a1517EbE430F0057e,0x479273a6593E20d4Db7B4De8849f4B387528Af76
3133,15627853,344041,10057759671,341077,2964,650,75,0x03f7724180AA6b939894B5Ca4314783B0b36b329,0xfCDc25ba0D9D9C16A40506802a50C6c0870d5BC6
3134,15627853,21000,10057759671,21000,0,2,3,0xA090e606E30bD747d4E6245a1517EbE430F0057e,0x5E3c1Bbf64b34E31dfe7c160d23491Bb4811CB0F
3135,15627853,21000,10057759671,21000,0,2,3,0xA090e606E30bD747d4E6245a1517EbE430F0057e,0x54244B5fe943b8a371A1c9040C9C67b4A31d9E9D
3136,15627853,21000,10057759671,21000,0,2,2,0xA090e606E30bD747d4E6245a1517EbE430F0057e,0x273eF801a36e8184932AD48d6aaE929d28134753
3137,15627853,21000,10057759671,21000,0,2,2,0xA090e606E30bD747d4E6245a1517EbE430F0057e,0x373D175ce792BeAF7230e51e1214b8e86b0f92d4
3138,15627853,21000,10057759671,21000,0,2,1,0xA090e606E30bD747d4E6245a1517EbE430F0057e,0x4F001bd12732F43b5634E49DfB0a2fb51b179d4B
3139,15627853,21000,10057759671,21000,0,2,3,0xA090e606E30bD747d4E6245a1517EbE430F0057e,0x482E20F773C337D689e856f439b03696d2cD5C08
3140,15627853,21000,10057759671,21000,0,2,3,0xA090e606E30bD747d4E6245a1517EbE430F0057e,0xe84dd35314354DB2A9dB0a57d4c5C8760045ad35
3141,15627853,21000,10057759671,21000,0,2,3,0xA090e606E30bD747d4E6245a1517EbE430F0057e,0x24c8E30d45C229058402d26562FaA5Af93C7e9CC
3142,15627853,21000,10057759671,21000,0,2,3,0xA090e606E30bD747d4E6245a1517EbE430F0057e,0x04596c9a345F46C0EC3AEc659615186FaAa53525
3143,15627853,21000,10057759671,21000,0,2,4,0xA090e606E30bD747d4E6245a1517EbE430F0057e,0x78442AC9578D7543f33ec33c9698089ba63CC20f
3144,15627853,21000,10057759671,21000,0,2,3,0xA090e606E30bD747d4E6245a1517EbE430F0057e,0xdAd624a2b328e49bb1A94cEba6521A3BC33bcCB7
3145,15627853,21000,10057759671,21000,0,2,3,0xA090e606E30bD747d4E6245a1517EbE430F0057e,0x6B77e4f862571dEB419Bd6e665EC965fC356c4e6
3146,15627853,21000,10057759671,21000,0,2,2,0xA090e606E30bD747d4E6245a1517EbE430F0057e,0xC2a3Af5986768FB37090EC826dE11349cd1B0f57
3147,15627853,21000,10057759671,21000,0,2,3,0xA090e606E30bD747d4E6245a1517EbE430F0057e,0x7dF26612CA9f0c8F2f3940073e0A596e041dF9A7
3148,15627853,21000,10057759671,21000,0,2,1,0xA090e606E30bD747d4E6245a1517EbE430F0057e,0x1B7C86B296175143F903a851e9460C42d4028279
3149,15627853,21000,10057759671,21000,0,2,1,0xA090e606E30bD747d4E6245a1517EbE430F0057e,0xF0E2f72913FcD37e74a52C09e68F85F0dEcF1e19
3150,15627853,21000,10057759671,21000,0,2,3,0xA090e606E30bD747d4E6245a1517EbE430F0057e,0xb835EF59FA3E09eB73Dc887CB65fdB599Dc4a1eC
3151,15627853,21000,10057759671,21000,0,2,2,0xA090e606E30bD747d4E6245a1517EbE430F0057e,0xCc8AC933D5634Ad1bc31c04f6D4610E3EF0c7CD1
3152,15627853,21000,10057759671,21000,0,2,3,0xA090e606E30bD747d4E6245a1517EbE430F0057e,0x2d2a7605088B18426755F8217E2ea7F847B08A98
3153,15627853,21000,10057759671,21000,0,2,2,0xA090e606E30bD747d4E6245a1517EbE430F0057e,0x62d27B9e431DB800dE7991D9194Ac7c23037a89F
3154,15627853,21000,10057759671,21000,0,2,4,0xA090e606E30bD747d4E6245a1517EbE430F0057e,0x66ABb7d9f617131099b134F2B597DFAbb0964436
3155,15627853,21000,10057759671,21000,0,2,3,0xA090e606E30bD747d4E6245a1517EbE430F0057e,0x567D7563E28813B1688A6C6C68cdB381830CF0f4
3156,15627853,21000,10057759671,21000,0,2,2,0xA090e606E30bD747d4E6245a1517EbE430F0057e,0x86f0096AE3E23A817Ca891f7437154b894A89Fac
3157,15627853,21000,10057759671,21000,0,2,1,0xA090e606E30bD747d4E6245a1517EbE430F0057e,0xdA1C2fb6D0B05B73913793ea9E77168321610Bd6
3158,15627853,21000,10057759671,21000,0,2,1,0xA090e606E30bD747d4E6245a1517EbE430F0057e,0xf15822FBebd8C59E50548fA46ff53989d88AD26e
3159,15627853,21000,10057759671,21000,0,2,2,0xA090e606E30bD747d4E6245a1517EbE430F0057e,0xe05b7E45ef5351525c0b2c4c6624D4D99943CF6d
3160,15627853,21000,10057759671,21000,0,2,3,0xA090e606E30bD747d4E6245a1517EbE430F0057e,0x944FB9FC5d1BEeE4024769ef92aA71CBCF967e32
3161,15627853,207128,10057759671,206484,644,138,1312151,0x514910771AF9Ca656af840dff83E8264EcF986CA,0xf60c2Ea62EDBfE808163751DD0d8693DCb30019c
3162,15627853,21000,10057759671,21000,0,2,3,0xA090e606E30bD747d4E6245a1517EbE430F0057e,0x9E8B3Af98dC7Fd58b03696E37B6dC897a6cF3f70
3163,15627853,21000,10057759671,21000,0,2,2,0xA090e606E30bD747d4E6245a1517EbE430F0057e,0x6B4056b1b26f20C36cA524792379FE930ABB7001
3164,15627853,36015,10000000000,35751,264,74,106,0xC02aaA39b223FE8D0A0e5C4F27eAD9083C756Cc2,0x2BD29af09c6743C7B1CD3358C2ecE9582e20eF09
3165,15627853,65000,10000000000,64404,596,138,0,0xdAC17F958D2ee523a2206206994597C13D831ec7,0x566e7C9Bf07E450021874846137e744E5970e3CA
3166,15627853,245410,10000000000,241118,4292,1098,3,0xe66B31678d6C16E9ebf358268a790B763C133750,0xe5E6296f781a0e7C653576987cD9825b6821e934
3167,15627853,191041,10000000000,190165,876,266,1388,0xd588b586D61C826A0e87919b3D1a239206d58bf2,0xC22d03e13B888Dabb33A1575e4F6542f0e996622
3168,15627853,408529,10000000000,403737,4792,1546,6695,0x68b3465833fb72A70ecDF485E0e4C7bD8665Fc45,0xA574225Ffa9b40db38D387B041484c0C1a499098
3169,15627853,70000,9980925316,69404,596,138,24,0xdAC17F958D2ee523a2206206994597C13D831ec7,0x52f06773dCf80E9dA7463b2dF30783e98C9C4f6D
3170,15627853,21000,9970000000,21000,0,2,705872,0x56c07F7d8d6809E552511b52EEcDFA2A407a4907,0x6dfc34609a05bC22319fA4Cce1d1E2929548c0D7
3171,15627853,561091,9937759671,549259,11832,3914,291,0xDEF171Fe48CF0115B1d80b88dc8eAB59176FEe57,0x17D065070486Ca0fC8b4B382b946BE79Fb4fF10D
3172,15627853,60105,9794087314,60105,0,2,48494,0x4dC9e781Fef18fa4Dc5217A5Ee1156f668B5aF55,0x4dC9e781Fef18fa4Dc5217A5Ee1156f668B5aF55
3173,15627853,268426,9733277156,268426,0,2,122590,0x1c8F6A5F009E051CaB9C3851ca2DA2c936b2775A,0x1c8F6A5F009E051CaB9C3851ca2DA2c936b2775A
3174,15627853,268374,9579573918,266106,2268,650,131295,0xA69babEF1cA67A37Ffaf7a485DfFF3382056e78C,0x60b86AF869f23aEb552fB7F3CaBD11B829f6Ab2F
3175,15627853,240201,9579573918,237797,2404,460,2727,0xAAeCf92bEe252Ad8a31FDB66aa80E733Aa7dE609,0x4aD60235bE56324B9dc08BB831a202405D47Dc30
3176,15627853,21000,9563759671,21000,0,2,102635,0xe7Fa465fe6dab51bffF17aD09425D320B0d4d1a6,0x2Db1D8CdF1Abe8C70b531a790CDf2FF38aecF652
3177,15627853,21000,9563759671,21000,0,2,57300,0x1b213D9d7FF0B1Fe5f6C41144D27ABEAc6A54359,0xCfC0F98f30742B6d880f90155d4EbB885e55aB33
3178,15627853,21000,9558759671,21000,0,2,113040,0x8f67cfe77336358abDa1b58333AbAD8A6C936F0D,0x6081258689a75d253d87cE902A8de3887239Fe80
3179,15627853,51938,9557759671,51450,488,138,616,0xA642375Cc15249A81da9c435fB4eDD8A9343ce7F,0x44CbDb1979FbC26Fc72156959191f322005E8F37
3180,15627853,46682,9557759671,46194,488,138,2483,0x82235445a7f634279E33702cc004B0FDb002fDa7,0xA17138c0675173B8Ea506Fb1b96FA754BC316cc2
3181,15627853,46722,9557759671,46150,572,138,1266,0xCF3bc939f9B2487092936F21cC0757b2b523B7aA,0x7c03C6FC64293c460bE652F4015aD232E695aC8e
3182,15627853,285312,9557759671,282528,2784,842,43,0x68b3465833fb72A70ecDF485E0e4C7bD8665Fc45,0xc9E9768cC2b993a5D3707c5Dc569C5A92157F115
3183,15627853,69264,9557759671,68608,656,138,3,0xd35c06a2781f648c75290976ecF71E71582188B7,0xbb45051a5EDab022b6e39FfC7d3291c9aa267A4a
3184,15627853,21000,9557759671,21000,0,2,36,0xc623483a440A6Fb5C0D41f8E30a9F3dF49a237Ad,0xB5e7B19a7c3D0EEDe3064Cfb3fdf0FBEa5ed6A67
3185,15627853,204945,9557759671,198309,6636,1802,142,0x00000000006c3852cbEf3e08E8dF289169EdE581,0xd99881A272e14666a5b4394f9deeb383fa05F38B
3186,15627853,166162,9557759671,165110,1052,330,17,0x2A5c2568b10A0E826BfA892Cf21BA7218310180b,0x1573c1a68Bd95B17f1B8c4AB4E4d817600c31981
3187,15627853,103575,9557759671,96811,6764,1098,509,0x11B197e078e41aF41Bc1d9e03407090e61e40BAA,0x297233737e77615B8cC1347d12d10C9147b56dF6
3188,15627853,204904,9557759671,201700,3204,1034,3,0x68b3465833fb72A70ecDF485E0e4C7bD8665Fc45,0x4F3e651fe077A653A3e51d0C060b02D2111a9934
3189,15627853,60691,9557759671,53271,7420,2506,429,0x00000000006c3852cbEf3e08E8dF289169EdE581,0x6Bc5A51d2335F8f86Cc1065Cf58E4273eb9D6A87
3190,15627853,45038,9557759671,44974,64,10,44,0xC02aaA39b223FE8D0A0e5C4F27eAD9083C756Cc2,0x314f225CfDd8FFb092f556E8b9FfCf4328c3A710
3191,15627853,148592,9557759671,142004,6588,1802,57,0x00000000006c3852cbEf3e08E8dF289169EdE581,0x0ACA580f1Fe36FE49e9E359C64C5A5e71c64e643
3192,15627853,328423,9557759671,325223,3200,906,229,0x68b3465833fb72A70ecDF485E0e4C7bD8665Fc45,0xa7C1d32B4bB7155Ad5e9e53F472b9CE61BB37ddc
3193,15627853,21000,9557759671,21000,0,2,0,0x010C916016300Dc5518A16d4455838611048814B,0x709778DeC036bA302Ccbea6a3011474945C12bC0
3194,15627853,233346,9557759671,226682,6664,1810,75,0x00000000006c3852cbEf3e08E8dF289169EdE581,0x58ED8e76752539f387a2a6e040384D285D3973bD
3195,15627853,800000,9557759671,799796,204,74,7,0x6AE0D3b09f87319807cf1AF13C8eE41832075CB5,0x51BbbD7dcC7d30C5C4162333d9320D467597C8E4
3196,15627853,55904,9557759671,54960,944,138,1,0x011b0beAe3eC5953B4805b064cC78f6F892A99cC,0x7D35286C7d6864Cf6A61b4EC90F3d2FB6F8C7935
3197,15627853,219160,9557759671,216400,2760,842,607,0x68b3465833fb72A70ecDF485E0e4C7bD8665Fc45,0x0254b349c49D1c3375453140Be3674C028C81251
3198,15627853,190549,9557759671,183961,6588,1802,1673,0x00000000006c3852cbEf3e08E8dF289169EdE581,0xA244312A1C313BD79F75dCfedcdA850997Fd356F
3199,15627853,21000,9557759671,21000,0,2,70,0x1EcDEdD382c068E771f9556109a1518B5609A2c8,0xBa412D28e82D6f087C7D155c5875A46C97a82442
3200,15627853,259615,9557759671,256819,2796,842,10,0x68b3465833fb72A70ecDF485E0e4C7bD8665Fc45,0x2383281b534d3Ca72D46F5A0570c7D4B68f12E01
3201,15627853,463378,9557759671,460246,3132,1034,45,0xcCbCa4F9651Ef122D58d7EC5acCa27D806840209,0xCEE4E58A05CB74cD553F3b3728Fc78f3C645085B
3202,15627853,60755,9557759671,53271,7484,2514,156,0x00000000006c3852cbEf3e08E8dF289169EdE581,0xD6bCbfD4C9584Aa0279227B78a988383F03a9F0D
3203,15627853,46280,9557759671,45420,860,138,40,0xC02aaA39b223FE8D0A0e5C4F27eAD9083C756Cc2,0x3106804Fc9E3A769aDD46c28712a1f1EA960D441
3204,15627853,205559,9557759671,191519,14040,4130,312,0x9EbFB53Fa8526906738856848A27cB11b0285C3f,0x1bE7340d3067850824F54860aee9cb22ED78629e
3205,15627853,21000,9557759671,21000,0,2,94,0xa914e25784885DcbA88eB4ad5478Da0c8EaC41BC,0x3FB0Be5316a579c477E24B2a276f1c103BA6Cce8
3206,15627853,191339,9557759671,184687,6652,1810,632,0x00000000006c3852cbEf3e08E8dF289169EdE581,0xa752468B958D520e0d9f64D2cCc4301c2d4Eb6d8
3207,15627853,172909,9557759671,171317,1592,330,177,0x84c2b16FA6877a8fF4F3271db7ea837233DFd6f0,0x6792c4bDc1b45EfA131ecCa985A28EF5c4622E48
3208,15627853,51406,9557759671,50918,488,138,23,0xF2a9904458d938be0a5B9410cE32af1b3eE00cEa,0x814444012a50A540bA3d1C80a05227F0d06C8b7A
3209,15627853,45038,9557759671,44974,64,10,24,0xC02aaA39b223FE8D0A0e5C4F27eAD9083C756Cc2,0x749767cC11F5462B02FeD9ac7ED7056EAaB3805D
3210,15627853,21000,9557759671,21000,0,2,73,0x70A40d3EA0567219F825C6d4ef1F7444d4276023,0x38a404D2e859572fab457ad9AdF3cd2d4781d718
3211,15627853,46113,9557759671,45625,488,138,2484,0x9639cfa649A2dbA8B902f43F24A81Ac4E9C849fe,0xA17138c0675173B8Ea506Fb1b96FA754BC316cc2
3212,15627853,247622,9557759671,244470,3152,906,62,0x68b3465833fb72A70ecDF485E0e4C7bD8665Fc45,0x67608a6cB71ED83Cc406905Ce29375d2C69bE8ae
3213,15627853,289961,9557759671,287577,2384,522,340,0x283Af0B28c62C092C9727F1Ee09c02CA627EB7F5,0x0e05FC263cB57dB89aa9f32cc3f4743244520c45
3214,15627853,55840,9557759671,54896,944,138,17,0x55C08ca52497e2f1534B59E2917BF524D4765257,0x1E759C0af530cc66D0E0283Aa0748a79Dc9228DF
3215,15627853,143002,9557759671,136402,6600,1802,1042,0x00000000006c3852cbEf3e08E8dF289169EdE581,0x15848c6f03195e84e6A142Ae4B4d56531150FF3d
3216,15627853,21000,9557759671,21000,0,2,284,0xCf3e2fcA28cc127Ba29cc27049E850f3d4c59f48,0x5478c40F3FCC8cbe126D442991a2Dc53B34877ed
3217,15627853,219630,9557759671,217774,1856,522,563,0x000000000000509081d6FCD3ee63e791aD1db763,0xC0717434fAe0A3E1FC0615f7e016d06ff6601605
3218,15627853,162719,9557759671,152067,10652,3402,257,0x00000000006c3852cbEf3e08E8dF289169EdE581,0xE1301E4b98Ee2Fa6e77a9A788774fCB29f87b744
3219,15627853,46263,9557759671,45691,572,138,862,0x0322F6f11A94CFB1b5B6E95E059d8DEB2bf17D6A,0x939484d835D090F44929E63e45EC2e76CB402A08
3220,15627853,288832,9557759671,286472,2360,522,8,0x283Af0B28c62C092C9727F1Ee09c02CA627EB7F5,0x409Eb9D78a4d5D6863947f2e5A7AD1E4f5b47C76
3221,15627853,55923,9557759671,54979,944,138,239,0xD309A8d0498Cc73f53481e46094DC0d3aaB0d9dd,0x5c66Fa36978803eB832eDd8E7d06EFbD703ba70E
3222,15627853,46169,9557759671,45597,572,138,934,0xABB3738f04Dc2Ec20f4AE4462c3d069d02AE045B,0x1AC03ef8272FabD680c7Bf307119406f52802126
3223,15627853,52093,9557759671,51005,1088,138,8,0x5FDCCA53617f4d2b9134B29090C87D01058e27e9,0x702E9f185d6cDfD6b076d9Db3D10fBC27F75883c
3224,15627853,475236,9557759671,471912,3324,1226,1352,0xABB3738f04Dc2Ec20f4AE4462c3d069d02AE045B,0xbEC00274dc8b2775ba887D18b980A95E4898AD6D
3225,15627853,21000,9557759671,21000,0,2,10,0x3E6BA192edF31098FcD288FB3122BA6409B05b2e,0x55FdEee3cEcb521B3cFcD35385DB39C3CC4C7668
3226,15627853,48851,9557759671,47551,1300,202,650,0x57f1887a8BF19b14fC0dF6Fd9B2acc9Af147eA85,0xD501ae1812E3008EC5A6459F40171415a535Bc8F
3227,15627853,181465,9557759671,177813,3652,1162,263,0x68b3465833fb72A70ecDF485E0e4C7bD8665Fc45,0x26e35CDb264614d6843B57D444082EA62709c4f9
3228,15627853,46547,9557759671,46059,488,138,9,0xaE351b8Ae55B69A5007618E598dDe89d0a092c37,0xbF0193AcdA16F4395e35F8c0Ee17ab32399a7632
3229,15627853,94737,9557759671,94305,432,74,28,0xae7ab96520DE3A18E5e111B5EaAb095312D7fE84,0x72789b9D7583a1ADD1Dc2093493f8D2a49255602
3230,15627853,148604,9557759671,142040,6564,1802,1470,0x00000000006c3852cbEf3e08E8dF289169EdE581,0x9A8e646A2C545801444899C9Ad598473C7571664
3231,15627853,46103,9557759671,45615,488,138,136,0x346378C67d0F71343F80299ed8C0407aC2Df05eB,0x36920E436FAe6365Fa495e943C891Fd6Ea64459f
3232,15627853,21000,9557759671,21000,0,2,178,0x11C1B767dcaDFf92A4aa3ffc3cE7f336AFE53ad2,0xBd63D6A9Fc3a82f1B8f88cD094E65b3986b0d838
3233,15627853,85896,9557759671,85692,204,74,14,0xB092Ec81F41c619EEa434357477ea8A4b1455755,0xea7e049c3dB1BFEAFE8D801334ce770F8426c0E8
3234,15627853,429311,9158759671,427687,1624,292,26582,0xC8046263d5B5544F6413a98B4693488499195A46,0xEf5a3745F822f8F83693564c54904d7FF156CFb2
3235,15627853,21000,9057759671,21000,0,2,71,0xBcb958331862BeD5e3aF56695583F9ec2C6C7ff9,0xC9FAfff9DE5Dd71A3bb93F6E9F4297A1C929b7B7
3236,15627853,275337,9057759671,272109,3228,1034,9,0x68b3465833fb72A70ecDF485E0e4C7bD8665Fc45,0x239202754C1de5B802F50272EdEBFcfe87da848B
3237,15627853,275632,9057759671,274444,1188,338,6,0x1111111254fb6c44bAC0beD2854e76F90643097d,0x019C75e7335B443d2d0fE04Cc29CEBE6b86093F6
3238,15627853,175110,9057759671,173546,1564,394,72,0x1Fa8559e873f698292766790AeCf8080A66433F6,0x7F6c313eBd7D90A55eE6Fc871f01aabC66A5a906
3239,15627853,383899,9057759671,378643,5256,1082,105722,0x0000000000007F150Bd6f54c40A34d7C3d5e9f56,0x60530f5Ca4CB9907e0FBE67cA3AFCbFE56D19A5c
3240,15627853,55956,9057759671,55012,944,138,764,0x30dcBa0405004cF124045793E1933C798Af9E66a,0xB4cEF3CA34db5A5ea3116dcd924d318bCbD7Ad17
3241,15627853,109012,8586841000,108240,772,202,37,0xcDA72070E455bb31C7690a170224Ce43623d0B6f,0x532fbC7a9B4D8DbBC01cFa7c7DC97be19D5edb81
3242,15627853,21000,8286639429,21000,0,2,29,0x4aC822e45c581B2f089C50E89911aBE7a260CF83,0x3A3b10F3Bb092FA2A11d936B469853159FcF7DFD
3243,15627853,93617,8249330621,92973,644,138,341553,0x626E8036dEB333b408Be468F951bdB42433cBF18,0x6cc8dCbCA746a6E4Fdefb98E1d0DF903b107fd21
3244,15627853,69792,8249330621,69184,608,138,3,0xA0b86991c6218b36c1d19D4a2e9Eb0cE3606eB48,0xc97D9Df7e4F0a1B6b01E61e301F2968DD7065fD7
3245,15627853,67109,8249330621,66501,608,138,0,0xdAC17F958D2ee523a2206206994597C13D831ec7,0xFEC22C4Ef7DEB4b62404025704432e3156FA344E
3246,15627853,67109,8249330621,66501,608,138,0,0xdAC17F958D2ee523a2206206994597C13D831ec7,0xE832369B52a072eC869507db72B60206a54fC341
3247,15627853,69792,8249330621,69184,608,138,12,0xA0b86991c6218b36c1d19D4a2e9Eb0cE3606eB48,0x9Cc0Ff93eE7Eb78772043B3e92a2cBf71E4d944c
3248,15627853,67109,8249330621,66501,608,138,24,0xdAC17F958D2ee523a2206206994597C13D831ec7,0xfA9358F687DD03450a322D94eE3B857Eb08CeeaC
3249,15627853,109885,8249330621,109217,668,138,3,0xc50EF449171a51FbeAFd7c562b064B6471C36caA,0x6117D9b907c3D330F745f1564a1F0dD0D48b5B55
3250,15627853,90000,8238322393,90000,0,2,3479097,0x39935e6AAD3B12e1243F858289A678527E45f932,0xd24400ae8BfEBb18cA49Be86258a3C749cf46853
3251,15627853,64200,8238322393,63488,712,202,3479098,0x5f65f7b609678448494De4C87521CdF6cEf1e932,0xd24400ae8BfEBb18cA49Be86258a3C749cf46853
3252,15627853,90000,8416032217,90000,0,2,3479099,0x6552f769a26a2f1A2B052198863c5e77e9Bf88F7,0xd24400ae8BfEBb18cA49Be86258a3C749cf46853
3253,15627853,100984,8059759671,96704,4280,1290,123,0x86c544EF388A600BDF2E4B181017115E68294942,0xdC02e3061126A0BB2921C6636BD13a6da704392f
3254,15627853,30000,8057759671,30000,0,2,639,0xBA401CdaC1A3b6AEeDe21c9C4a483be6C29F88C5,0xf573d99385C05c23B24ed33De616ad16a43a0919
3255,15627854,35000,350000000000,35000,0,2,231,0xdf0C37C3D8D74E652925f00ab25B023F504df101,0xCb914830D06868854a390E21103dde19F01Ea4d1
3256,15627854,285326,33205788303,282530,2796,842,24,0x68b3465833fb72A70ecDF485E0e4C7bD8665Fc45,0xC1e4f8Dca5D91DE30d8427Af68aA2D45C6bcFCE1
3257,15627854,5049368,17000000000,5042268,7100,1098,281,0x0a39DA505DfB5E0BBc6bd84428281A8ba1bC7753,0x495E889d1A6cEB447a57dcc1C68410299392380c
3258,15627854,90000,14840374600,89332,668,138,913,0x321C2fE4446C7c963dc41Dd58879AF648838f98D,0x0a885dc33A3A7F1B967446cBB1443BF5a6E59f1c
3259,15627854,600000,13205788303,598164,1836,458,1707,0x7a250d5630B4cF539739dF2C5dAcb4c659F2488D,0x0b8207ec94676910CedBa3b5a07eD2BBA3f93c2e
3260,15627854,21000,13000000000,21000,0,2,2324,0x3E22a86E22E461a636bF64092754CdA6f46996e2,0xce0df2BA6c2BD425F3Ffbbea708F0B5f21ae1e6a
3261,15627854,21000,11967788303,21000,0,2,251468,0x854aE8072c8D0BdC761D5251ac8827729E907C29,0x151B381058f91cF871E7eA1eE83c45326F61e96D
3262,15627854,77419,11928624732,76763,656,138,4709908,0x4Fabb145d64652a948d72533023f6E7A623C7C53,0x2FAF487A4414Fe77e2327F0bf4AE2a264a776AD2
3263,15627854,93850,11928624732,93242,608,138,4709909,0xdAC17F958D2ee523a2206206994597C13D831ec7,0x2FAF487A4414Fe77e2327F0bf4AE2a264a776AD2
3264,15627854,97410,11928624732,96790,620,138,4709910,0xA0b86991c6218b36c1d19D4a2e9Eb0cE3606eB48,0x2FAF487A4414Fe77e2327F0bf4AE2a264a776AD2
3265,15627854,21000,11921209755,21000,0,2,67395,0x00A6426e17279926FF37E72B8F735d0C57d2c3dd,0x963737C550E70FFe4D59464542a28604eDb2eF9a
3266,15627854,21000,11205788303,21000,0,2,1793,0xc663C43dd3FA56bdb1f09D0457905853364A5852,0x233DFD8F3B420b54B561F1275AE2A8cE14FC416E
3267,15627854,21000,11000000000,21000,0,2,7,0xa103Cc8eB72D77E3305fBAE8ea7Cc3D51ef929A6,0xA8F2397E3C498ddc9F99E2F94afeacd8DC8a05b9
3268,15627854,143796,10705788303,143592,204,74,5,0x7F9306FC1978938d5C1C57Bf6044dc67E07eeB8a,0xB9F031f57c4E43b649466f39fCc810000AA66F2c
3269,15627854,21000,10205788303,21000,0,2,3,0xA090e606E30bD747d4E6245a1517EbE430F0057e,0x4DD56cA8fE1C0139EC35bC6d916977e84DD41aFf
3270,15627854,21000,10205788303,21000,0,2,2,0xA090e606E30bD747d4E6245a1517EbE430F0057e,0x284308C7A5A1402b85C686CB490A438649104430
3271,15627854,21000,10205788303,21000,0,2,2,0xA090e606E30bD747d4E6245a1517EbE430F0057e,0x37CBd1aBf645475FB0fbbD3f193f3fe04Ea284C6
3272,15627854,21000,10205788303,21000,0,2,3,0xA090e606E30bD747d4E6245a1517EbE430F0057e,0x00ac2c1716aca0D36D38c15592D67bC2FE83F071
3273,15627854,21000,10205788303,21000,0,2,3,0xA090e606E30bD747d4E6245a1517EbE430F0057e,0x4D49Ed6b50fF03A6b2F51ad606e153706FA104bE
3274,15627854,21000,10205788303,21000,0,2,3,0xA090e606E30bD747d4E6245a1517EbE430F0057e,0x9005ac6a4151Ac9f0bD1F70F1AdfB9ba1fDaE3C2
3275,15627854,21000,10205788303,21000,0,2,4,0xA090e606E30bD747d4E6245a1517EbE430F0057e,0x40809Ead83c53bCe113a68558aE62F7192F76995
3276,15627854,21000,10205788303,21000,0,2,5,0xA090e606E30bD747d4E6245a1517EbE430F0057e,0x4F77a0934cacdFB766eC28d029864DEd0e4aE2D8
3277,15627854,21000,10205788303,21000,0,2,3,0xA090e606E30bD747d4E6245a1517EbE430F0057e,0x13381670B3E98a4C7C4Dab6294a4F7Ef856DE3e3
3278,15627854,50000,10205788303,50000,0,2,170062,0xc7734D2e30c9776088Ad57C6C0045ce17fDc79fB,0x8D56f551b44a6dA6072a9608d63d664ce67681a5
3279,15627854,21000,10205788303,21000,0,2,2,0xA090e606E30bD747d4E6245a1517EbE430F0057e,0x2e21f289064a10103A8C2529a9cc7E78F0bC9e34
3280,15627854,21000,10205788303,21000,0,2,4,0xA090e606E30bD747d4E6245a1517EbE430F0057e,0x6f402e31cA4d7a49515e91900Df2475C74E47Fc9
3281,15627854,21000,10205788303,21000,0,2,2,0xA090e606E30bD747d4E6245a1517EbE430F0057e,0x68594E91644C904347C474bC3f3e69Db8f85A5e5
3282,15627854,21000,10205788303,21000,0,2,1,0xA090e606E30bD747d4E6245a1517EbE430F0057e,0x13bDBDCfD05f6070E8B1299D1989EB048d8D4D27
3283,15627854,21000,10205788303,21000,0,2,1,0xA090e606E30bD747d4E6245a1517EbE430F0057e,0xB36e46178871a980C41B7F24C9A4547e9E822e56
3284,15627854,21000,10205788303,21000,0,2,1,0xA090e606E30bD747d4E6245a1517EbE430F0057e,0x4d3384d3B8b6f9fdfE48B01f5934C3731e86213B
3285,15627854,21000,10205788303,21000,0,2,3,0xA090e606E30bD747d4E6245a1517EbE430F0057e,0x82811610Ba0aEfeAf13e4d9263cFb4e9593d7f87
3286,15627854,21000,10205788303,21000,0,2,4,0xA090e606E30bD747d4E6245a1517EbE430F0057e,0x8110E64a2C7934683D2333c9F22F448Ef243687F
3287,15627854,21000,10205788303,21000,0,2,2,0xA090e606E30bD747d4E6245a1517EbE430F0057e,0x8ab0eeEf925bFA2E9BC97adc0756d63F2Ab44870
3288,15627854,21000,10205788303,21000,0,2,2,0xA090e606E30bD747d4E6245a1517EbE430F0057e,0xFE7dA0205105519BF135F6352d7282E48c8B38CF
3289,15627854,21000,10205788303,21000,0,2,3,0xA090e606E30bD747d4E6245a1517EbE430F0057e,0x9C55C2784e6112a04981BBf2dcA4720a4C71d302
3290,15627854,21000,10205788303,21000,0,2,3,0xA090e606E30bD747d4E6245a1517EbE430F0057e,0xE67891a26F43fC73d447Ec3280AB93affBd7CA8f
3291,15627854,21000,10205788303,21000,0,2,3,0xA090e606E30bD747d4E6245a1517EbE430F0057e,0xbE97D2A700D0fB81f593b2e9ed3e96558816ce52
3292,15627854,21000,10205788303,21000,0,2,2,0xA090e606E30bD747d4E6245a1517EbE430F0057e,0xC582B4D12F9a4B49C91e7a5a5599D354b3F37F38
3293,15627854,21000,10205788303,21000,0,2,1,0xA090e606E30bD747d4E6245a1517EbE430F0057e,0xb209B5Babec4Eb123b5aC9B0eE94959B58c40F08
3294,15627854,21000,10205788303,21000,0,2,3,0xA090e606E30bD747d4E6245a1517EbE430F0057e,0xE3527e64160E198357C248fD2CF0e07b771b349D
3295,15627854,21000,10205788303,21000,0,2,2,0xA090e606E30bD747d4E6245a1517EbE430F0057e,0xd0832E86984C607C787137F74f3bcd070E9F7cCa
3296,15627854,21000,10205788303,21000,0,2,1,0xA090e606E30bD747d4E6245a1517EbE430F0057e,0x3C1C233CBa1f2BD38D2df5a233d88aA8447260f1
3297,15627854,21000,10205788303,21000,0,2,2,0xA090e606E30bD747d4E6245a1517EbE430F0057e,0x8dC309c8355DB3ac0c6FF6CEaa9D276B6fea6fFE
3298,15627854,21000,10205788303,21000,0,2,3,0xA090e606E30bD747d4E6245a1517EbE430F0057e,0x1f46B58648299Ab792937aB993ab9c4e8BA09302
3299,15627854,21000,10205788303,21000,0,2,3,0xA090e606E30bD747d4E6245a1517EbE430F0057e,0x28B257B3533AD51cCE6C14b8E6ABeb8a577174bf
3300,15627854,21000,10205788303,21000,0,2,3,0xA090e606E30bD747d4E6245a1517EbE430F0057e,0xF4e96E554e2664Ad4f85dBF6ECD8063E502D7043
3301,15627854,21000,10205788303,21000,0,2,2,0xA090e606E30bD747d4E6245a1517EbE430F0057e,0x69F2E0D0c6A26afe67C2eeDeF5B8eE3b34796E48
3302,15627854,21000,10205788303,21000,0,2,2,0xA090e606E30bD747d4E6245a1517EbE430F0057e,0xe3cEc5Ab5f24eDD7878D1DF185fc88A8E75E7B04
3303,15627854,21000,10205788303,21000,0,2,3,0xA090e606E30bD747d4E6245a1517EbE430F0057e,0x882CA0f1679A831528AcAa8efEC88a97Cc64110b
3304,15627854,21000,10205788303,21000,0,2,2,0xA090e606E30bD747d4E6245a1517EbE430F0057e,0x1da56E3FCf9E34DaBBDC79756d95E01B2F0979c8
3305,15627854,21000,10205788303,21000,0,2,3,0xA090e606E30bD747d4E6245a1517EbE430F0057e,0xfed45c8d7E13De38227C0ae04713228Bed88aDe0
3306,15627854,21000,10205788303,21000,0,2,3,0xA090e606E30bD747d4E6245a1517EbE430F0057e,0xABf09C37397B2E07CAD63E5138c06A9609617008
3307,15627854,21000,10205788303,21000,0,2,3,0xA090e606E30bD747d4E6245a1517EbE430F0057e,0xa429D3c748b84501554eb014c675db9D65c788C6
3308,15627854,21000,10205788303,21000,0,2,3,0xA090e606E30bD747d4E6245a1517EbE430F0057e,0x02e5D140347db750c417BD778F3EF28293BD76Da
3309,15627854,21000,10205788303,21000,0,2,2,0xA090e606E30bD747d4E6245a1517EbE430F0057e,0x3b3a61120AF766344d33A2F4F00D6CAF23337a9c
3310,15627854,21000,10205788303,21000,0,2,3,0xA090e606E30bD747d4E6245a1517EbE430F0057e,0xbd352Ce7e4912C1D170431CbBdBCAfD599862Df1
3311,15627854,21000,10205788303,21000,0,2,2,0xA090e606E30bD747d4E6245a1517EbE430F0057e,0x841fd0DC047f0472689fFACB3C6e18e0d9B0cF41
3312,15627854,21000,10205788303,21000,0,2,1,0xA090e606E30bD747d4E6245a1517EbE430F0057e,0x2e1A6C3c3C6497B3F3149D36F4EE50FD2ce65f4e
3313,15627854,21000,10205788303,21000,0,2,3,0xA090e606E30bD747d4E6245a1517EbE430F0057e,0xbb5C080F279f903C200cF08cd227706AdfaF60A6
3314,15627854,21000,10205788303,21000,0,2,1,0xA090e606E30bD747d4E6245a1517EbE430F0057e,0x28E93C72B7e9Cd6C93A59F303765e870489C6fa1
3315,15627854,21000,10205788303,21000,0,2,2,0xA090e606E30bD747d4E6245a1517EbE430F0057e,0xAE34F693E145eEb3FC02C266A03257B3e001807b
3316,15627854,21000,10205788303,21000,0,2,8,0xA090e606E30bD747d4E6245a1517EbE430F0057e,0x20a6Ef15e22dfCa7d6CC72d92de0dfb27B1e314C
3317,15627854,21000,10205788303,21000,0,2,3,0xA090e606E30bD747d4E6245a1517EbE430F0057e,0x52C7FBbBc50757060E6Ab0CC7AF754967f66cA49
3318,15627854,21000,10205788303,21000,0,2,2,0xA090e606E30bD747d4E6245a1517EbE430F0057e,0xd7dA38C6C45842Ce3e1a7B8e818343C05A0a2fc1
3319,15627854,21000,10205788303,21000,0,2,4,0xA090e606E30bD747d4E6245a1517EbE430F0057e,0x4cCEA45aa4400154768EfB60E17d7B8273dDD330
3320,15627854,21000,10205788303,21000,0,2,2,0xA090e606E30bD747d4E6245a1517EbE430F0057e,0xc4d64158215dF899d80b0640BdA9Acb57AbeA969
3321,15627854,21000,10205788303,21000,0,2,3,0xA090e606E30bD747d4E6245a1517EbE430F0057e,0x155f0759C399654888F84e37C7bd75d5c60C60d5
3322,15627854,21000,10205788303,21000,0,2,3,0xA090e606E30bD747d4E6245a1517EbE430F0057e,0x9E76417EF37b13A432722b0EAD82CC40f435277C
3323,15627854,21000,10205788303,21000,0,2,2,0xA090e606E30bD747d4E6245a1517EbE430F0057e,0x68F28Be52ef54c4Fe72932d353b3AB0DDf07E039
3324,15627854,21000,10205788303,21000,0,2,3,0xA090e606E30bD747d4E6245a1517EbE430F0057e,0xc2692d66230Dc8f00590482dB03f60FA96078633
3325,15627854,21000,10205788303,21000,0,2,2,0xA090e606E30bD747d4E6245a1517EbE430F0057e,0xC54E5fF8BaBd1497FE789758A7c51754C2442c01
3326,15627854,21000,10205788303,21000,0,2,3,0xA090e606E30bD747d4E6245a1517EbE430F0057e,0xD9F9505bE3Ba3498189d41a0c0D06b55CeeC3fcc
3327,15627854,21000,10205788303,21000,0,2,3,0xA090e606E30bD747d4E6245a1517EbE430F0057e,0xE97177De9Af72Cb3E38E065173A00c22fef2404B
3328,15627854,21000,10205788303,21000,0,2,8,0xA090e606E30bD747d4E6245a1517EbE430F0057e,0x90967c7308CccB2987B36f2499d7f6CCaA3aFc61
3329,15627854,21000,10205788303,21000,0,2,1,0xA090e606E30bD747d4E6245a1517EbE430F0057e,0x22922DEf4a742D373b8ce1a5D4Fa7090BcC08B37
3330,15627854,21000,10205788303,21000,0,2,3,0xA090e606E30bD747d4E6245a1517EbE430F0057e,0x9F6b104AF96B00cA563C1E403385CF2C5e7bC282
3331,15627854,21000,10205788303,21000,0,2,1,0xA090e606E30bD747d4E6245a1517EbE430F0057e,0x7552B1e2093Ebe412ce839dEdc787791Bf4C64a4
3332,15627854,21000,10205788303,21000,0,2,3,0xA090e606E30bD747d4E6245a1517EbE430F0057e,0x6b6b830812A92cF99Fc2d5EBA410D49F415bE461
3333,15627854,21000,10205788303,21000,0,2,3,0xA090e606E30bD747d4E6245a1517EbE430F0057e,0x3382aFB8e999e11BD0961B89207525e16A74aDf4
3334,15627854,21000,10205788303,21000,0,2,2,0xA090e606E30bD747d4E6245a1517EbE430F0057e,0x841855e72ba5FaF8597aeA67F69D851918b6B949
3335,15627854,21000,10205788303,21000,0,2,2,0xA090e606E30bD747d4E6245a1517EbE430F0057e,0x59e474f107b18f28EB51908F7d714a6BBc190Be2
3336,15627854,21000,10205788303,21000,0,2,3,0xA090e606E30bD747d4E6245a1517EbE430F0057e,0x8A79f41f4547c840C95A2ad6899dbE645a8e8F32
3337,15627854,21000,10205788303,21000,0,2,3,0xA090e606E30bD747d4E6245a1517EbE430F0057e,0x52b3BC3f2521e5F711F73116D9bA531604e2cD83
3338,15627854,21000,10205788303,21000,0,2,3,0xA090e606E30bD747d4E6245a1517EbE430F0057e,0x8952dB044254f96FC5BADF41b3CB6942c7CEf2e0
3339,15627854,21000,10205788303,21000,0,2,3,0xA090e606E30bD747d4E6245a1517EbE430F0057e,0xb0fF9d7B25EA76a9729312cDdF4Ea1c06b42520B
3340,15627854,21000,10205788303,21000,0,2,3,0xA090e606E30bD747d4E6245a1517EbE430F0057e,0xD979Df0BaD77CaD6358e293cB1dC59F5BFef9fd5
3341,15627854,21000,10205788303,21000,0,2,3,0xA090e606E30bD747d4E6245a1517EbE430F0057e,0x0AE62c3bcf43F996870fc174960E9cA0892c150F
3342,15627854,21000,10205788303,21000,0,2,3,0xA090e606E30bD747d4E6245a1517EbE430F0057e,0x0fC30d3C11faD71eF2315272428d1a0445d3562e
3343,15627854,21000,10205788303,21000,0,2,3,0xA090e606E30bD747d4E6245a1517EbE430F0057e,0xB2cd90dbBbCC15320D1e5Fb8df9dd37a9d67a59b
3344,15627854,21000,10205788303,21000,0,2,1,0xA090e606E30bD747d4E6245a1517EbE430F0057e,0xc570c1D611716c9B831C68D06eFCa7b2e2535892
3345,15627854,21000,10205788303,21000,0,2,3,0xA090e606E30bD747d4E6245a1517EbE430F0057e,0x337eA89e827B0eb2a953EC16B87C4eF1e602Be9e
3346,15627854,21000,10205788303,21000,0,2,2,0xA090e606E30bD747d4E6245a1517EbE430F0057e,0x62Fc984cCaaf10D82062d4941543B7aA71969B67
3347,15627854,21000,10205788303,21000,0,2,2,0xA090e606E30bD747d4E6245a1517EbE430F0057e,0xdbf8F87F1d0546dCa80bFa816eC162e6EF2d1a1A
3348,15627854,21000,10205788303,21000,0,2,3,0xA090e606E30bD747d4E6245a1517EbE430F0057e,0xd435b819eeeB21fa4a3A399411a30924c225d5cD
3349,15627854,21000,10205788303,21000,0,2,3,0xA090e606E30bD747d4E6245a1517EbE430F0057e,0x7b25a17bCD301C2b8b6EB2Cf7E07CAbDEa7ae451
3350,15627854,21000,10205788303,21000,0,2,1,0xA090e606E30bD747d4E6245a1517EbE430F0057e,0xf9D8577F4daE6a98d401D617c63e08b9AC23ADE2
3351,15627854,21000,10205788303,21000,0,2,2,0xA090e606E30bD747d4E6245a1517EbE430F0057e,0x0178702a84534d62389E617f031BC4D80009EEbA
3352,15627854,21000,10205788303,21000,0,2,2,0xA090e606E30bD747d4E6245a1517EbE430F0057e,0x9bD617dC2Cf68e2B74b8ada7a0c10C0e1f5B65fa
3353,15627854,21000,10205788303,21000,0,2,1,0xA090e606E30bD747d4E6245a1517EbE430F0057e,0x816aF0a8804Cc6616c27f2b454188a5231283578
3354,15627854,21000,10205788303,21000,0,2,3,0xA090e606E30bD747d4E6245a1517EbE430F0057e,0xe8A3724b48Ec24016a681f8C7270b27939119C92
3355,15627854,21000,10205788303,21000,0,2,1,0xA090e606E30bD747d4E6245a1517EbE430F0057e,0x27d63a246ebaD338EbB5485cdFA1aAd545786CCC
3356,15627854,21000,10205788303,21000,0,2,2,0xA090e606E30bD747d4E6245a1517EbE430F0057e,0x6BCB7A08291b91a31EeFCe0dB2f3b7F391Ed8B06
3357,15627854,21000,10205788303,21000,0,2,1,0xA090e606E30bD747d4E6245a1517EbE430F0057e,0xAfb5f12D5c5eE406ad2363b3260022d844CBe047
3358,15627854,21000,10205788303,21000,0,2,3,0xA090e606E30bD747d4E6245a1517EbE430F0057e,0xA84F3073A928e7E26b7b34E392326A32F852DF49
3359,15627854,21000,10205788303,21000,0,2,2,0xA090e606E30bD747d4E6245a1517EbE430F0057e,0xf845441bA8A1aAF22acB4bB259604f3F99e9B95D
3360,15627854,21000,10205788303,21000,0,2,3,0xA090e606E30bD747d4E6245a1517EbE430F0057e,0x1b6Ba7085060DB83f326836Ead3a96aeA2614661
3361,15627854,21000,10205788303,21000,0,2,1,0xA090e606E30bD747d4E6245a1517EbE430F0057e,0x87775Db01daa68a995e8C3e4Ae8cB24Aa67084A1
3362,15627854,21000,10205788303,21000,0,2,1,0xA090e606E30bD747d4E6245a1517EbE430F0057e,0x3e7e40f1102b84D35192e08534fa635E5eEC9cF1
3363,15627854,21000,10205788303,21000,0,2,3,0xA090e606E30bD747d4E6245a1517EbE430F0057e,0x541B8C4b8c3FB864B8e98289D538E07816750BC5
3364,15627854,21000,10205788303,21000,0,2,3,0xA090e606E30bD747d4E6245a1517EbE430F0057e,0xa5edb4B4e3CEdC5eeDCB58De590e6c91d4b17e71
3365,15627854,21000,10205788303,21000,0,2,3,0xA090e606E30bD747d4E6245a1517EbE430F0057e,0x0BeE9A38faEA5a0E1Fe6E1cA1c56B189341f8DCd
3366,15627854,210000,10205788303,209060,940,202,1207,0xF845e3d7AE916CA50C7Db40808E9Cc579B5f6705,0x4a465C6dB61C0055469a891D5BAF7A4DD1c7ae15
3367,15627854,21000,10205788303,21000,0,2,3,0xA090e606E30bD747d4E6245a1517EbE430F0057e,0x7aB04154f4F07B916c3369D001173F72D1D1D73a
3368,15627854,21000,10205788303,21000,0,2,1,0xA090e606E30bD747d4E6245a1517EbE430F0057e,0x4562A528BcE913f7b9d82c0A9B8B9098202ACa08
3369,15627854,21000,10205788303,21000,0,2,3,0xA090e606E30bD747d4E6245a1517EbE430F0057e,0x10998Cc6af2493897153d416c3cd211DCed98E8B
3370,15627854,21000,10205788303,21000,0,2,1,0xA090e606E30bD747d4E6245a1517EbE430F0057e,0xdC59Ebab0ce1645A8Dd62996936D589055B7916F
3371,15627854,21000,10205788303,21000,0,2,2,0xA090e606E30bD747d4E6245a1517EbE430F0057e,0x71419fF9323374aBd38a6E7Ea914D261DDEe9989
3372,15627854,21000,10205788303,21000,0,2,2,0xA090e606E30bD747d4E6245a1517EbE430F0057e,0x4D7dCdEBc18Abc5d10585945988b91080F280904
3373,15627854,21000,10205788303,21000,0,2,2,0xA090e606E30bD747d4E6245a1517EbE430F0057e,0x5c19b26dF032df725850195707971E5b88298879
3374,15627854,21000,10205788303,21000,0,2,2,0xA090e606E30bD747d4E6245a1517EbE430F0057e,0xB6eA3D9e94480B571bA9cA4404754F28BA13DC8D
3375,15627854,21000,10205788303,21000,0,2,3,0xA090e606E30bD747d4E6245a1517EbE430F0057e,0x5A9fb9e1d28A1Ac931529047E22757cEb9785C8c
3376,15627854,21000,10205788303,21000,0,2,3,0xA090e606E30bD747d4E6245a1517EbE430F0057e,0xdd16d72ea8950104BF08043ea76684394d3Dafa3
3377,15627854,21000,10205788303,21000,0,2,3,0xA090e606E30bD747d4E6245a1517EbE430F0057e,0xD00fb50a67c1a41b7c227B0E2298911A07B0F5C4
3378,15627854,21000,10205788303,21000,0,2,3,0xA090e606E30bD747d4E6245a1517EbE430F0057e,0xDd5b87541D87981e20eA86f0d598c597d2Be500F
3379,15627854,21000,10205788303,21000,0,2,3,0xA090e606E30bD747d4E6245a1517EbE430F0057e,0x16348C62397d5EbCd8BD0c1DE820c0ff5Ba97C1a
3380,15627854,21000,10205788303,21000,0,2,3,0xA090e606E30bD747d4E6245a1517EbE430F0057e,0xd3CF7eB64fBeaEdA6094a5cf664e0fAedFfAD956
3381,15627854,21000,10205788303,21000,0,2,2,0xA090e606E30bD747d4E6245a1517EbE430F0057e,0x2b9fd6574aAd325A568e3AFC3462aC241e6CfEa7
3382,15627854,21000,10205788303,21000,0,2,3,0xA090e606E30bD747d4E6245a1517EbE430F0057e,0x980D11b0F6F750c04c0CC9180fC7D6C176Db9c1e
3383,15627854,21000,10205788303,21000,0,2,1,0xA090e606E30bD747d4E6245a1517EbE430F0057e,0xA719cE7ffFa98572ba8288Cbb3982069571d5a13
3384,15627854,21000,10205788303,21000,0,2,3,0xA090e606E30bD747d4E6245a1517EbE430F0057e,0x3Fe831F517acDb82FEfBaD36dB76B5d43c179d29
3385,15627854,21000,10205788303,21000,0,2,3,0xA090e606E30bD747d4E6245a1517EbE430F0057e,0x39972B7232887eD4bAe82fb670b280Aba5422a9D
3386,15627854,21000,10205788303,21000,0,2,2,0xA090e606E30bD747d4E6245a1517EbE430F0057e,0x235B5149f75745BEE547887DF9ee23357D83e320
3387,15627854,21000,10205788303,21000,0,2,2,0xA090e606E30bD747d4E6245a1517EbE430F0057e,0xCB920AfC92f64398c5C49d3B7aDE2501a2FDa0D9
3388,15627854,21000,10205788303,21000,0,2,1,0xA090e606E30bD747d4E6245a1517EbE430F0057e,0x33D00Ba678DBbFddb0049056a1dcE52d60901890
3389,15627854,21000,10205788303,21000,0,2,3,0xA090e606E30bD747d4E6245a1517EbE430F0057e,0x7191dD2f411674C75fAA83a5BeD6ad452bD4528c
3390,15627854,21000,10205788303,21000,0,2,2,0xA090e606E30bD747d4E6245a1517EbE430F0057e,0x07cc4E9F5964953DB514A28C0d4fCfE89cE7F1e7
3391,15627854,21000,10205788303,21000,0,2,2,0xA090e606E30bD747d4E6245a1517EbE430F0057e,0xB05D8212cF7e958F844Dffa6216C37368ee399f3
3392,15627854,21000,10205788303,21000,0,2,2,0xA090e606E30bD747d4E6245a1517EbE430F0057e,0x948fCaf544b7E59d597BffFd76D93F5fDD899610
3393,15627854,21000,10205788303,21000,0,2,1,0xA090e606E30bD747d4E6245a1517EbE430F0057e,0x78579DCeECB52855d819141BCf05c4fA62835E0A
3394,15627854,21000,10205788303,21000,0,2,3,0xA090e606E30bD747d4E6245a1517EbE430F0057e,0x5bdd9EDF6bEadB3041f7a5fac9d50963C4e092dB
3395,15627854,21000,10205788303,21000,0,2,3,0xA090e606E30bD747d4E6245a1517EbE430F0057e,0x27Cb700bFE76Da85a517a78E213B8d4D700F64d2
3396,15627854,21000,10205788303,21000,0,2,3,0xA090e606E30bD747d4E6245a1517EbE430F0057e,0x29786F8a2316758f46e756001217155227580Fc8
3397,15627854,21000,10205788303,21000,0,2,1,0xA090e606E30bD747d4E6245a1517EbE430F0057e,0x89ee4E3CFe40657a4285a7f64a333Aeb533168d3
3398,15627854,21000,10205788303,21000,0,2,3,0xA090e606E30bD747d4E6245a1517EbE430F0057e,0xB0861AD9fd2Ff0a81628d918aCc45A3e120Fe7Ec
3399,15627854,21000,10205788303,21000,0,2,3,0xA090e606E30bD747d4E6245a1517EbE430F0057e,0x15e408E6195F8f6d380eC1C5d2D6876a880fE1fA
3400,15627854,21000,10205788303,21000,0,2,2,0xA090e606E30bD747d4E6245a1517EbE430F0057e,0x2Fe8b152c72F4B710e372569a5E3D3a6e2d419d9
3401,15627854,21000,10205788303,21000,0,2,2,0xA090e606E30bD747d4E6245a1517EbE430F0057e,0x37Ca888c2E2ABB20a83927Def7b6968f6d0Ad788
3402,15627854,21000,10205788303,21000,0,2,2,0xA090e606E30bD747d4E6245a1517EbE430F0057e,0xce9BaD6CcCe1fafF8D2EaE5Fd41C6A7AACB13093
3403,15627854,21000,10205788303,21000,0,2,3,0xA090e606E30bD747d4E6245a1517EbE430F0057e,0x5D3188fA2bD82FF9BF0C0dAa1250d7EE7Dd22bCE
3404,15627854,21000,10205788303,21000,0,2,1,0xA090e606E30bD747d4E6245a1517EbE430F0057e,0x49347e1BE6Eb53C0828c68AcC383A52C57E5eBd7
3405,15627854,21000,10205788303,21000,0,2,1,0xA090e606E30bD747d4E6245a1517EbE430F0057e,0xA506FF971d6A91b140fb33945d29A793746763D9
3406,15627854,21000,10205788303,21000,0,2,2,0xA090e606E30bD747d4E6245a1517EbE430F0057e,0x69041f0A21A5e7E47C2D4b77fc80C88CE9ceF5e2
3407,15627854,21000,10205788303,21000,0,2,3,0xA090e606E30bD747d4E6245a1517EbE430F0057e,0x788E6Ab096b9084095C68a9686A4184d3207A6bC
3408,15627854,21000,10205788303,21000,0,2,3,0xA090e606E30bD747d4E6245a1517EbE430F0057e,0xe0e2D0c081C33196e8AD0E1dafd777Af723Ad73b
3409,15627854,21000,10205788303,21000,0,2,1,0xA090e606E30bD747d4E6245a1517EbE430F0057e,0x95Df4331b6F1373C646886CE380F03BAfD1682e1
3410,15627854,72912,10205788303,71968,944,138,7,0xA0b86991c6218b36c1d19D4a2e9Eb0cE3606eB48,0x7145b7E5460A726329fb0570b78a590c402C1C29
3411,15627854,21000,10205788303,21000,0,2,3,0xA090e606E30bD747d4E6245a1517EbE430F0057e,0x9CA22b238bF84E41E7c69a58ed7189df100667eB
3412,15627854,21000,10205788303,21000,0,2,3,0xA090e606E30bD747d4E6245a1517EbE430F0057e,0xF7528fe35F109F1C08CEd5761818236addAE2023
3413,15627854,21000,10205788303,21000,0,2,3,0xA090e606E30bD747d4E6245a1517EbE430F0057e,0x943AF0FB0707FF8325206c40C825446d339e677e
3414,15627854,21000,10205788303,21000,0,2,3,0xA090e606E30bD747d4E6245a1517EbE430F0057e,0xcDAf5d5997ef2F9C4838534D140Ac4cf560A015D
3415,15627854,21000,10205788303,21000,0,2,3,0xA090e606E30bD747d4E6245a1517EbE430F0057e,0xa6f9f0282f146EedE2E2bd0C4100BEe3Ca6fe72E
3416,15627854,21000,10205788303,21000,0,2,5,0xA090e606E30bD747d4E6245a1517EbE430F0057e,0xC1462E50D75f5CD05A0df6AF854bC167337084aF
3417,15627854,21000,10205788303,21000,0,2,3,0xA090e606E30bD747d4E6245a1517EbE430F0057e,0xDA538128549000dF2bBD38005Ae44383DE35861d
3418,15627854,21000,10205788303,21000,0,2,2,0xA090e606E30bD747d4E6245a1517EbE430F0057e,0xDcb6Ac1e35d570A26D2C38a0f8204dB69F88bBC3
3419,15627854,21000,10205788303,21000,0,2,2,0xA090e606E30bD747d4E6245a1517EbE430F0057e,0x6159A9439A4e7B78967016e037207F36151B5952
3420,15627854,21000,10205788303,21000,0,2,1,0xA090e606E30bD747d4E6245a1517EbE430F0057e,0xAa5772876E1aa09e3C966f298917b61f2CE34a49
3421,15627854,21000,10205788303,21000,0,2,3,0xA090e606E30bD747d4E6245a1517EbE430F0057e,0x6CD51c03aae02B4d6023c97b5848bE4eD4ae830f
3422,15627854,21000,10205788303,21000,0,2,2,0xA090e606E30bD747d4E6245a1517EbE430F0057e,0xC3C43aCE3Af9444F79AC4d08901f57408179d06F
3423,15627854,21000,10205788303,21000,0,2,1,0xA090e606E30bD747d4E6245a1517EbE430F0057e,0x090903FCaf91B1C7E563FaD4ea678B27581fEAF5
3424,15627854,21000,10205788303,21000,0,2,1,0xA090e606E30bD747d4E6245a1517EbE430F0057e,0xa7351546abcEE24c95E7DEf1BE9241946f9C62e5
3425,15627854,21000,10205788303,21000,0,2,2,0xA090e606E30bD747d4E6245a1517EbE430F0057e,0xF76D5434c3d2F66fe371ade46c8c3b28386FEB41
3426,15627854,21000,10205788303,21000,0,2,1,0xA090e606E30bD747d4E6245a1517EbE430F0057e,0x18d23F59B7B9DF11BC36ED33959a45ECAB3320BE
3427,15627854,21000,10205788303,21000,0,2,2,0xA090e606E30bD747d4E6245a1517EbE430F0057e,0x1c472d9cb95B9bfA49d031D02623f5e5f7b43331
3428,15627854,21000,10205788303,21000,0,2,1,0xA090e606E30bD747d4E6245a1517EbE430F0057e,0xAe43eb78B16243E7659F483104cc98cBA1CFcC1D
3429,15627854,21000,10205788303,21000,0,2,1,0xA090e606E30bD747d4E6245a1517EbE430F0057e,0x6cb78402b6b6894cb990f579251833dc752d8d6F
3430,15627854,21000,10205788303,21000,0,2,1,0xA090e606E30bD747d4E6245a1517EbE430F0057e,0xE72232641FE78094B258f826924518EFfFa6D2C1
3431,15627854,21000,10205788303,21000,0,2,3,0xA090e606E30bD747d4E6245a1517EbE430F0057e,0xa8caCc98A52d8a4ac573F266FA86D4658A06914f
3432,15627854,21000,10205788303,21000,0,2,4,0xA090e606E30bD747d4E6245a1517EbE430F0057e,0xB1A314aE4dFe366B18Ac5b2178F3b6328a83e904
3433,15627854,21000,10205788303,21000,0,2,2,0xA090e606E30bD747d4E6245a1517EbE430F0057e,0x375D6617ff9D6aB4305ce97f066f391bBA966dCe
3434,15627854,21000,10205788303,21000,0,2,2,0xA090e606E30bD747d4E6245a1517EbE430F0057e,0xf36876787F153cF0ca38f8DE6885Ce426608fA40
3435,15627854,21000,10205788303,21000,0,2,2,0xA090e606E30bD747d4E6245a1517EbE430F0057e,0x7F4cE22dbac61B2CFb01B7FA476968bc5D63a4a7
3436,15627854,21000,10205788303,21000,0,2,2,0xA090e606E30bD747d4E6245a1517EbE430F0057e,0xD3d7CdB1e8CC767FB407172fd0ea28d4B598B484
3437,15627854,21000,10205788303,21000,0,2,2,0xA090e606E30bD747d4E6245a1517EbE430F0057e,0xc9cc605D5F498885Daf58BCa1b305400Da5c968A
3438,15627854,21000,10205788303,21000,0,2,2,0xA090e606E30bD747d4E6245a1517EbE430F0057e,0xf662b455cB7d38677D1F49508809f09425314DeC
3439,15627854,21000,10205788303,21000,0,2,1,0xA090e606E30bD747d4E6245a1517EbE430F0057e,0xF0e3548a34Cd1262Db93f81A40CC0f2e328194BD
3440,15627854,21000,10205788303,21000,0,2,2,0xA090e606E30bD747d4E6245a1517EbE430F0057e,0xFcCEfA7b8D937FCE675bFf790e4DC0C6E500EFcd
3441,15627854,21000,10205788303,21000,0,2,4,0xA090e606E30bD747d4E6245a1517EbE430F0057e,0xA9F9664e0a13a35620AF9c43D39719bb8B40B095
3442,15627854,21000,10205788303,21000,0,2,1,0xA090e606E30bD747d4E6245a1517EbE430F0057e,0xAeD7B5E706D76D8861f72Da0Ca35b22A3Ec2dfAC
3443,15627854,21000,10205788303,21000,0,2,1,0xA090e606E30bD747d4E6245a1517EbE430F0057e,0xF53ECbE72846C434adD806A39E9FD2D5169862D1
3444,15627854,21000,10205788303,21000,0,2,1,0xA090e606E30bD747d4E6245a1517EbE430F0057e,0x646C896dA627009bdD37b0677b4CE27639f8AaDD
3445,15627854,21000,10205788303,21000,0,2,1,0xA090e606E30bD747d4E6245a1517EbE430F0057e,0x3473869bBbedE21c7D7cdDADae3809443646D9EA
3446,15627854,21000,10205788303,21000,0,2,1,0xA090e606E30bD747d4E6245a1517EbE430F0057e,0x97ecf9E402eA7A9E6aB1ab65e2A83ad34Fee2331
3447,15627854,21000,10205788303,21000,0,2,1,0xA090e606E30bD747d4E6245a1517EbE430F0057e,0x19d4eC9D7609C2936183f87b57f8c83108Ba95F0
3448,15627854,21000,10205788303,21000,0,2,1,0xA090e606E30bD747d4E6245a1517EbE430F0057e,0xA7BFc5F93eAcE14544054D791739fb087CFcADF1
3449,15627854,21000,10205788303,21000,0,2,21,0xA090e606E30bD747d4E6245a1517EbE430F0057e,0x7BB1a1F69DCa3Cd4e8D22dC70705d420B742c403
3450,15627854,21000,10205788303,21000,0,2,1,0xA090e606E30bD747d4E6245a1517EbE430F0057e,0x9617385E0C84A38dD420BB894C2e0310A72137be
3451,15627854,21000,10205788303,21000,0,2,1,0xA090e606E30bD747d4E6245a1517EbE430F0057e,0x29E6d9358fb9edeEe46Eb762b13C79f0F8c4552e
3452,15627854,21000,10205788303,21000,0,2,1,0xA090e606E30bD747d4E6245a1517EbE430F0057e,0xcB75c6De52aB28C4A314EB843A2f9FebE543D87D
3453,15627854,21000,10205788303,21000,0,2,1,0xA090e606E30bD747d4E6245a1517EbE430F0057e,0x3e864e5eC1636AF7DcE3c543c0F044956c76fB41
3454,15627854,38000,10205788303,37344,656,138,0,0xE41d2489571d322189246DaFA5ebDe1F4699F498,0x59055575603638EE7cBDbac792AC93B4966B89A2
3455,15627854,21000,10205788303,21000,0,2,345,0xbaE1439Feae8Fa505ca13F6FcEDB7445F5Db1e1F,0x7798BFb95A25bA83F652a0Ca35de6f14976689AE
3456,15627854,21000,10205788303,21000,0,2,1,0xA090e606E30bD747d4E6245a1517EbE430F0057e,0x54f100FF4EF1271ad45Ae2c83583717bF4fD2336
3457,15627854,21000,10205788303,21000,0,2,2,0xA090e606E30bD747d4E6245a1517EbE430F0057e,0x72BeaD98f7457169d534e029f10d3BB40536395B
3458,15627854,38000,10205788303,37344,656,138,1914,0xE41d2489571d322189246DaFA5ebDe1F4699F498,0x2e3d21e2FD06853aE29c24ec981abD59234a0b9b
3459,15627854,21000,10205788303,21000,0,2,1,0xA090e606E30bD747d4E6245a1517EbE430F0057e,0xCA10eE7B2f1F2d7775255789dBb37958F9203494
3460,15627854,21000,10205788303,21000,0,2,2,0xA090e606E30bD747d4E6245a1517EbE430F0057e,0x94985A51956332C4BB0e9b1F77994B9e7ae95e08
3461,15627854,21000,10205788303,21000,0,2,1,0xA090e606E30bD747d4E6245a1517EbE430F0057e,0x2d09ACAE7e8f43bf55173897B8DC373FB54E43C7
3462,15627854,21000,10205788303,21000,0,2,1,0xA090e606E30bD747d4E6245a1517EbE430F0057e,0xE8588181E9F95a2b450a19980Db81Da6825E13f8
3463,15627854,21000,10205788303,21000,0,2,1,0xA090e606E30bD747d4E6245a1517EbE430F0057e,0x7794f572e80E750dD63862e82cA1EDe1Ae9b00c5
3464,15627854,21000,10205788303,21000,0,2,2,0xA090e606E30bD747d4E6245a1517EbE430F0057e,0x4Bc20435175441161C0D6988eeF0570698438bcD
3465,15627854,21000,10205788303,21000,0,2,1,0xA090e606E30bD747d4E6245a1517EbE430F0057e,0x3db4c5d28053072Cb540e664f00b4a01B3662E32
3466,15627854,21000,10205788303,21000,0,2,1,0xA090e606E30bD747d4E6245a1517EbE430F0057e,0xa37E0beb07BC16e2D58aecA29Aa4205041F8a480
3467,15627854,21000,10205788303,21000,0,2,1,0xA090e606E30bD747d4E6245a1517EbE430F0057e,0xc99d1E4fb4F2AA0decb0232fc9a33886D782f834
3468,15627854,21000,10205788303,21000,0,2,1,0xA090e606E30bD747d4E6245a1517EbE430F0057e,0x4E2D6252b27BFC97CaCdA31dB93d866b1f8c51E2
3469,15627854,21000,10205788303,21000,0,2,15,0xA090e606E30bD747d4E6245a1517EbE430F0057e,0xAb618b78b00335991B01e72B57b925F043C8612C
3470,15627854,21000,10205788303,21000,0,2,6,0xA090e606E30bD747d4E6245a1517EbE430F0057e,0xb366bbCb36f87cEa79a581a00EC79c6816D4F69F
3471,15627854,21000,10205788303,21000,0,2,1,0xA090e606E30bD747d4E6245a1517EbE430F0057e,0x736551099b9Aa811D8AFF0caB012eb82BB4d2365
3472,15627854,342952,9815788303,337036,5916,1682,471,0xDef1C0ded9bec7F1a1670819833240f027b25EfF,0xd8929472A97db29867fE5C6F18922c24F59A7A71
3473,15627854,70000,9797986072,69392,608,138,524,0xdAC17F958D2ee523a2206206994597C13D831ec7,0xf5491f793D47A6Ea22f5e0B9AD3990CF66c4b40B
3474,15627854,21000,9797986072,21000,0,2,214,0xCf7Fcc6a529ceE18f0370F8B3c6065F6C4aB5fa1,0x01f60E81dA2d7E9dA51DB9Cf95FD91828ef1347E
3475,15627854,21000,9706788303,21000,0,2,113041,0x6781483fDDeCf7462b60C60DE599124d68eF8f99,0x6081258689a75d253d87cE902A8de3887239Fe80
3476,15627854,60791,9705788303,53271,7520,2514,2140,0x00000000006c3852cbEf3e08E8dF289169EdE581,0x9C51532Ef51ab720514b5acAf97Fe6C600FbFb54
3477,15627854,21000,9705788303,21000,0,2,29,0xc623483a440A6Fb5C0D41f8E30a9F3dF49a237Ad,0xE37Ef84c47400177dc70c43A59f4740BB0E8ff94
3478,15627854,205888,9705788303,199288,6600,1802,0,0x00000000006c3852cbEf3e08E8dF289169EdE581,0x1c46d3a5382b809daeb0Fea0c236cF0eCFB7e85C
3479,15627854,277872,9705788303,275040,2832,842,865,0x68b3465833fb72A70ecDF485E0e4C7bD8665Fc45,0x04A20c929D09669233e837D14cE7026924ab5CFD
3480,15627854,56803,9705788303,56315,488,138,198,0xc9a0B20D522AeeAC5d8D6ba13146a073A97B326A,0x48Bd243C68ca8E8e5144eA7092831faA48F4a1a8
3481,15627854,41297,9705788303,41021,276,74,33,0x19Db87284563aF276605e04f82D1a41073Bc3Db2,0xA58Df0CCEC971A9049D313535508e29d0C388509
3482,15627854,77373,9705788303,76753,620,138,242,0xC02aaA39b223FE8D0A0e5C4F27eAD9083C756Cc2,0x50bDcADf81D4EE7da76240080DE11Bd4355D57f0
3483,15627854,21000,9705788303,21000,0,2,6,0x960F560D882e89e783F2a5Ece445F8441dD96eC1,0x1E52eCCF1BC95Fb3530C368D3bb4E71B9C972A64
3484,15627854,51352,9705788303,50744,608,138,12,0x083D41d6DD21EE938f0c055CA4fb12268DF0EfaC,0x90C058ccEF37b833A5B271A30192357Ded296DF4
3485,15627854,58143,9705788303,56307,1836,458,5665,0x4976fb03C32e5B8cfe2b6cCB31c09Ba78EBaBa41,0x484eC62385e780f2460fEaC34864A77bA5A18134
3486,15627854,102957,9705788303,101453,1504,394,2,0x5427FEFA711Eff984124bFBB1AB6fbf5E3DA1820,0x0E70D77208D8061aB2185c7884838f41cfe7F291
3487,15627854,46187,9705788303,45615,572,138,137,0x346378C67d0F71343F80299ed8C0407aC2Df05eB,0x36920E436FAe6365Fa495e943C891Fd6Ea64459f
3488,15627854,26620,9705788303,26048,572,138,2317,0x3a70B2C9d86Df638EcaC4053607C4c67b9cccE41,0x87CEF391361A4168148333332fBd5D2C621D3252
3489,15627854,35983,9705788303,35767,216,74,498,0x0c2E57EFddbA8c768147D1fdF9176a0A6EBd5d83,0x27D447C2CAc8050e3716AaE99CE8CA37442B589e
3490,15627854,60000,9705788303,59308,692,138,192,0x1165Ce434377D9E0CafF79F9562B6cFC1C3d8Ea3,0x598E813106c2B87d7985Ad3bb83d4e14c1BF02AD
3491,15627854,43312,9705788303,42368,944,138,582,0x57f1887a8BF19b14fC0dF6Fd9B2acc9Af147eA85,0x62764715edAC8396C76E8704Ae86509b23b523A2
3492,15627854,21000,9705788303,21000,0,2,113813,0x850A79b4473560868c41429a90464D7Cdb1bE8D8,0xd5FBDa4C79F38920159fE5f22DF9655FDe292d47
3493,15627854,110199,9705788303,109623,576,74,18,0xae0Ee0A63A2cE6BaeEFFE56e7714FB4EFE48D419,0xf4472D8760dD37C27530CADF3E1ff7f4C6D6C7eA
3494,15627854,46678,9705788303,46190,488,138,2485,0xe5B4D6B5F37cae9Dc4c7384cd97038CD0573d7D2,0xA17138c0675173B8Ea506Fb1b96FA754BC316cc2
3495,15627854,46187,9705788303,45615,572,138,138,0x346378C67d0F71343F80299ed8C0407aC2Df05eB,0x36920E436FAe6365Fa495e943C891Fd6Ea64459f
3496,15627854,21000,9705788303,21000,0,2,334,0x769a7307378C41BDF43C4AB27d71fE711AA5a83b,0xc82Df81f2549f24F8023936eae26DEb71a87033E
3497,15627854,21000,9705788303,21000,0,2,49,0x685Ec46FC9e369F6883cD40b864F6d54DA75Cc9d,0xC88e45079EDf86afaFE578C24647E1b50D57A898
3498,15627854,21000,9705788303,21000,0,2,19,0x5bAB06Aab8aEcD0E60c8287391233F2285ad7071,0x4205b76aed697f30b07b815C87d8AEC7997f93b7
3499,15627854,21000,9705788303,21000,0,2,74,0x989e00cC00076399c8c4e956E9C6DEb57850a442,0x38a404D2e859572fab457ad9AdF3cd2d4781d718
3500,15627854,204840,9705788303,202020,2820,650,1893231,0xD1669Ac6044269b59Fa12c5822439F609Ca54F41,0xD2C82F2e5FA236E114A81173e375a73664610998
3501,15627854,46103,9705788303,45615,488,138,112,0x34Bc797F40Df0445c8429d485232874B15561728,0x71bb8e288f37192971da01d66030CBcCc75AD6D8
3502,15627854,36003,9705788303,35751,252,74,160,0xC02aaA39b223FE8D0A0e5C4F27eAD9083C756Cc2,0xeAE6c8264249Ca2FE986D99Ac72ffa3ac253D873
3503,15627854,494047,9705788303,491063,2984,906,489,0x000000000000509081d6FCD3ee63e791aD1db763,0x2BE70B7789C51979E98112B32A554b93A213dbe4
3504,15627854,53359,9450999478,52415,944,138,519,0x5Ca381bBfb58f0092df149bD3D243b08B9a8386e,0xB7B10292EE6c5828b20eB0942C8c1275E8344800
3505,15627854,280118,9306788303,277850,2268,650,111459,0xA69babEF1cA67A37Ffaf7a485DfFF3382056e78C,0x065e3DbaFCb2C26A978720f9eB4Bce6aD9D644a1
3506,15627854,429323,9306788303,427699,1624,292,26583,0xC8046263d5B5544F6413a98B4693488499195A46,0xEf5a3745F822f8F83693564c54904d7FF156CFb2
3507,15627854,250000,9205788303,250000,0,2,45337064,0x029b27Cea9442C5e3B0583Ef3daCEc327C828a2e,0xEA674fdDe714fd979de3EdF0F56AA9716B898ec8
3508,15627854,417088,9205788303,382284,34804,12178,18,0x00000000006c3852cbEf3e08E8dF289169EdE581,0xAB82001f9E36d9E316b43d93761219F7b99fa57f
3509,15627854,76335,9205788303,75727,608,138,71326,0x083D41d6DD21EE938f0c055CA4fb12268DF0EfaC,0xeE61F5fB0dB81d3A09392375Ee96f723C0620E07
3510,15627854,69546,9205788303,68602,944,138,6,0xC02aaA39b223FE8D0A0e5C4F27eAD9083C756Cc2,0x5c1BA8e7d71571735d63F9350eaFC05Da31c2B56
3511,15627854,250000,9205788303,250000,0,2,45337065,0x75b5aF578285096D88794297e5D0C048bD70e492,0xEA674fdDe714fd979de3EdF0F56AA9716B898ec8
3512,15627854,250000,9205788303,250000,0,2,45337066,0xb8B980e1bF2e8eD2f750eC3324993B4f7b321b3c,0xEA674fdDe714fd979de3EdF0F56AA9716B898ec8
3513,15627854,250000,9205788303,250000,0,2,45337067,0x112386412D622a573A3Ebc7799b593a698B99c9C,0xEA674fdDe714fd979de3EdF0F56AA9716B898ec8
3514,15627854,250000,9205788303,250000,0,2,45337068,0x39aDe87a373015C57B79d65d55733B4DbFcF69F1,0xEA674fdDe714fd979de3EdF0F56AA9716B898ec8
3515,15627854,250000,9205788303,250000,0,2,45337069,0x59f314248552D6a4Da56B8D92E09355c5Fc93652,0xEA674fdDe714fd979de3EdF0F56AA9716B898ec8
3516,15627854,250000,9205788303,250000,0,2,45337070,0x0DB0024e78408c3A53D1cE921c9A38258EB81caE,0xEA674fdDe714fd979de3EdF0F56AA9716B898ec8
3517,15627854,250000,9205788303,250000,0,2,45337071,0x8191e8128F081bAc0C557b2a3C36E132F772ec1C,0xEA674fdDe714fd979de3EdF0F56AA9716B898ec8
3518,15627854,250000,9205788303,250000,0,2,45337072,0x8B32D28Ad9bECbF5671D5e15EdADfFe7039B33c4,0xEA674fdDe714fd979de3EdF0F56AA9716B898ec8
3519,15627854,250000,9205788303,250000,0,2,45337073,0x565Af2FDC65D10B3226f04a6edC1C59C158D1dD8,0xEA674fdDe714fd979de3EdF0F56AA9716B898ec8
3520,15627854,2000000,9069751489,1997940,2060,522,402,0x7a250d5630B4cF539739dF2C5dAcb4c659F2488D,0xC1604496e206B7ff546c602Fdd5Ab69cF15f3DA7
3521,15627854,147661,8777502239,147445,216,74,170,0x03893669C978033544a160718E3d1a3226845de6,0xCEF557e276AE24293904BA0F2bbbD1FBa8Ef3338
3522,15627854,55978,8735356989,55034,944,138,4281,0xd4cB651749953988647eEE9b51DDB8DB5aeb3410,0x404F5A67F72787a6DBDbF73E5cfEBD17216e9D32
3523,15627854,78769,8295399332,78565,204,74,109,0xC5622f143972A5Da6aaBC5F5379311eE5EB48568,0xCCac7FB773dD35D3d16B95f5ec73C543E052bbb5
3524,15627854,988038,8295399332,979522,8516,1866,162,0x76f4eeD9fE41262669D0250b2A97db79712aD855,0x3C325DfeafaC6F08DB973E7dfD6E25490aE00Af1
3525,15627855,500000,100000000000,498116,1884,458,7506,0x7a250d5630B4cF539739dF2C5dAcb4c659F2488D,0xC5C018EDb7Ec3e4217728C1e1F608b28057Dd507
3526,15627855,1000000,22830010246,998152,1848,458,635,0x7a250d5630B4cF539739dF2C5dAcb4c659F2488D,0x903D13d2BC4D187ab5316a76c45CC971Dda6e226
3527,15627855,82591,14840374600,81935,656,138,911,0x9AAb071B4129B083B01cB5A0Cb513Ce7ecA26fa5,0x451aDe6606AeD956a843235E763208Af0080385E
3528,15627855,21000,14245228626,21000,0,2,59667,0x7808e414a7D8D3605504DDfBD8EB1681BC422Fb5,0x354e9Fa5c6Ee7e6092158a8c1B203CcAc932D66d
3529,15627855,78354,13200000000,77366,988,202,172427,0x7781548754d12C2eA6Fc76bB4f379BE91c84FC7F,0xE052113bd7D7700d623414a0a4585BCaE754E9d5
3530,15627855,21000,12481058646,21000,0,2,22,0x8C759BcE4e8fa80a1A6a3e1058ca2CD7Cf99CB42,0xAb382b666C60168F2088104afD5F254eAA9993D4
3531,15627855,119135,11300000000,115819,3316,1162,27,0x33C98857E10c1514c8f8699DD5c5CEb692098ccD,0x9D36f87b841fbf59Df518F84487260933282F229
3532,15627855,200000,11000000000,199356,644,138,3,0x4a220E6096B25EADb88358cb44068A3248254675,0xD669235EBc44d5DbFE4ED639cB136dEFB0bc4792
3533,15627855,470955,10772250576,459459,11496,3602,41,0xDef1C0ded9bec7F1a1670819833240f027b25EfF,0xD96F023D7182256e3f20A6a149BF5c2BB204aCf0
3534,15627855,21000,10681317669,21000,0,2,8,0xCBD6832Ebc203e49E2B771897067fce3c58575ac,0x1D057697c4EBA93578f83FbE83999270D5F620c9
3535,15627855,94813,10669311605,94205,608,138,12,0xdAC17F958D2ee523a2206206994597C13D831ec7,0x66761997CAF75e46fdb889268072cc83c42B2A83
3536,15627855,55000,10472254000,55000,0,2,1120721,0xb8d8621594FBeDE898d2eAb3Da0cEc8dFC8D7b6D,0x416299AAde6443e6F6e8ab67126e65a7F606eeF5
3537,15627855,55000,10472254000,55000,0,2,1120722,0x81Cd2e351b361D66848B507ba5dca8aABB3D18dE,0x416299AAde6443e6F6e8ab67126e65a7F606eeF5
3538,15627855,84000,10330010246,83468,532,202,22,0x98030D0DF32c20ACDFb7E79Ca5563AAB08Ec8884,0x4258507E0aE133b65Fb19AF12DA1B9aB321E7dFd
3539,15627855,128272,10330010246,128208,64,10,1599,0x112536829069dDF8868De6F8283eA7C3cD3E6743,0x21935251e90364885d59750D17F1c132ad1Bcacb
3540,15627855,75808,10000000000,75200,608,138,333,0xdAC17F958D2ee523a2206206994597C13D831ec7,0xb36eF8156Ba46448427cE98Ac1d29Be91Da554ae
3541,15627855,21000,9972569200,21000,0,2,95308,0x0a885dc33A3A7F1B967446cBB1443BF5a6E59f1c,0xdB0E89a9B003A28A4055ef772E345E8089987bfd
3542,15627855,21000,9878375184,21000,0,2,21,0xBa691db7c8a93A1dE6d305351c2E3F84192bE91c,0xe8964A300ba8c5Ca28d18c0314544e7498D9d81A
3543,15627855,21000,9830010246,21000,0,2,1,0xA090e606E30bD747d4E6245a1517EbE430F0057e,0xBCef9005A55C8F6f64C4f9ac0FD481f9Cce5c26b
3544,15627855,21000,9830010246,21000,0,2,3,0xA090e606E30bD747d4E6245a1517EbE430F0057e,0xd3897383F18Ef825d46A7276C3Acb684C500d978
3545,15627855,21000,9830010246,21000,0,2,1,0xA090e606E30bD747d4E6245a1517EbE430F0057e,0x26dAcd59993144F6b13cE3B896f2c438A75CD735
3546,15627855,232793,9830010246,227729,5064,1292,23,0x881D40237659C251811CEC9c364ef91dC08D300C,0x73748aa5Ad28631f2F7A880e96Ede7a4E6fFe803
3547,15627855,21000,9830010246,21000,0,2,1,0xA090e606E30bD747d4E6245a1517EbE430F0057e,0xb36530c87A2aD6a76d912ab5fa32FaDaD295F59a
3548,15627855,21000,9830010246,21000,0,2,1,0xA090e606E30bD747d4E6245a1517EbE430F0057e,0x490b4e17eaFF8aD3c5A76a197525D2ac5eC6468B
3549,15627855,21000,9830010246,21000,0,2,1,0xA090e606E30bD747d4E6245a1517EbE430F0057e,0x95F832801e3FA1D63401A7f5ee0217780F1Bd3Ad
3550,15627855,21000,9830010246,21000,0,2,1,0xA090e606E30bD747d4E6245a1517EbE430F0057e,0xE1e08023CF4C82B2d36f47d3baDAe4A1559DF9b5
3551,15627855,689733,9830010246,689389,344,138,507,0x657E383EdB9A7407E468acBCc9Fe4C9730c7C275,0x0cE32775570AC566Ce1A4C20DeDFE854710E5412
3552,15627855,21000,9830010246,21000,0,2,2,0xA090e606E30bD747d4E6245a1517EbE430F0057e,0x53A05690CaF9070f4D6e3c820626363bB3322E93
3553,15627855,21000,9830010246,21000,0,2,2,0xA090e606E30bD747d4E6245a1517EbE430F0057e,0xeb94068893Ad526C28795033a860105F3ffb4597
3554,15627855,21000,9830010246,21000,0,2,1,0xA090e606E30bD747d4E6245a1517EbE430F0057e,0x1282b07dF39a88551849f49C836C056785300b2a
3555,15627855,21000,9830010246,21000,0,2,2,0xA090e606E30bD747d4E6245a1517EbE430F0057e,0x5E570e56Fae1Ab9642Ce8Db1dDE35AC99EC45143
3556,15627855,21000,9830010246,21000,0,2,1,0xA090e606E30bD747d4E6245a1517EbE430F0057e,0x68Bfd9C8DbB6C3634C257D68d3FfD9F38eced4a7
3557,15627855,21000,9830010246,21000,0,2,2,0xA090e606E30bD747d4E6245a1517EbE430F0057e,0x30F791330Be349E930d4B36e2B076a49C285C0a1
3558,15627855,21000,9830010246,21000,0,2,2,0xA090e606E30bD747d4E6245a1517EbE430F0057e,0x911662F1A235111d14330A8572d6817052263ceF
3559,15627855,21000,9830010246,21000,0,2,2,0xA090e606E30bD747d4E6245a1517EbE430F0057e,0x33A9F0ddc399E65f14B77E3B8D14a59BFfd5F0DB
3560,15627855,21000,9830010246,21000,0,2,2,0xA090e606E30bD747d4E6245a1517EbE430F0057e,0x3D864f9FdA55D75D89f27be0229221186aFDD4F1
3561,15627855,21000,9830010246,21000,0,2,1,0xA090e606E30bD747d4E6245a1517EbE430F0057e,0xa11C042696335b894026cD5fB758e64cC718B7B8
3562,15627855,21000,9830010246,21000,0,2,2,0xA090e606E30bD747d4E6245a1517EbE430F0057e,0xdC4c286BcA169A8c4F24F78FfC6056fA1FB6151C
3563,15627855,21000,9830010246,21000,0,2,1,0xA090e606E30bD747d4E6245a1517EbE430F0057e,0x4007308E635F083DCf6D173221A8d9003bba2955
3564,15627855,42000,9830010246,42000,0,2,329523,0x22b02634630Cfc527e6971407d114685D9239723,0x9430801EBAf509Ad49202aaBC5F5Bc6fd8A3dAf8
3565,15627855,21000,9830010246,21000,0,2,2,0xA090e606E30bD747d4E6245a1517EbE430F0057e,0x3b95476016ABf32eA8ca25ED8919b851b697223B
3566,15627855,21000,9830010246,21000,0,2,2,0xA090e606E30bD747d4E6245a1517EbE430F0057e,0xFA0111ec21768A342f881AE55042Cb6dB21dBDE1
3567,15627855,21000,9830010246,21000,0,2,2,0xA090e606E30bD747d4E6245a1517EbE430F0057e,0xf45092a83ACf1eB53fd81b4246ea46d2FF5167DF
3568,15627855,21000,9830010246,21000,0,2,2,0xA090e606E30bD747d4E6245a1517EbE430F0057e,0x1382977342c14d6665246dC1B4236361e5CDDeb2
3569,15627855,21000,9830010246,21000,0,2,2,0xA090e606E30bD747d4E6245a1517EbE430F0057e,0x975a258E9d379a5f6d19BcDC2C8ca5Da55E2853c
3570,15627855,21000,9830010246,21000,0,2,2,0xA090e606E30bD747d4E6245a1517EbE430F0057e,0xEcbcD478280Dc34fFdEF04a03aC55e588F090869
3571,15627855,21000,9830010246,21000,0,2,2,0xA090e606E30bD747d4E6245a1517EbE430F0057e,0x82eB3E2bC9fD774574D6c74144e1F36e6CD00255
3572,15627855,21000,9830010246,21000,0,2,2,0xA090e606E30bD747d4E6245a1517EbE430F0057e,0x189F321E3692adCBeA52C15985d3544426179c0C
3573,15627855,21000,9830010246,21000,0,2,1,0xA090e606E30bD747d4E6245a1517EbE430F0057e,0x1Dae64b1c31740fC44cD0f2D9bF02f0c6Fa394F9
3574,15627855,56659,9830010246,55715,944,138,2952,0x9431DE2DFE10BDB30995bd3791dE03a6c9570054,0x15Ea1b7C5402126435B2b02fc1AB6c556998B004
3575,15627855,21000,9830010246,21000,0,2,2,0xA090e606E30bD747d4E6245a1517EbE430F0057e,0x973dC9e94a2FbF5e572F9A25f8569540674E8dBb
3576,15627855,21000,9830010246,21000,0,2,1,0xA090e606E30bD747d4E6245a1517EbE430F0057e,0x195CeBDC7256CA789561E2D4c0f6B3D2c6FA5cc7
3577,15627855,21000,9830010246,21000,0,2,2,0xA090e606E30bD747d4E6245a1517EbE430F0057e,0xBE6191342618e5dB33388247Cd3a953040A0fe96
3578,15627855,21000,9830010246,21000,0,2,2,0xA090e606E30bD747d4E6245a1517EbE430F0057e,0x902DBDBfb8a987B5c848763204582f23C7C44322
3579,15627855,21000,9830010246,21000,0,2,2,0xA090e606E30bD747d4E6245a1517EbE430F0057e,0xe9c9249A30E38C533A288EAdD5262910ACda2903
3580,15627855,21000,9830010246,21000,0,2,2,0xA090e606E30bD747d4E6245a1517EbE430F0057e,0x7921857b64986FC7A3202411e8aC269F6DAaF4b4
3581,15627855,21000,9830010246,21000,0,2,1,0xA090e606E30bD747d4E6245a1517EbE430F0057e,0x09d9d91a096B3E0ce5aD856db93267530fac236C
3582,15627855,21000,9830010246,21000,0,2,2,0xA090e606E30bD747d4E6245a1517EbE430F0057e,0xF938f8d28C81e233ae76955231f6C69B11D49039
3583,15627855,21000,9830010246,21000,0,2,2,0xA090e606E30bD747d4E6245a1517EbE430F0057e,0xC914411936D7cc87B40c1c300AEf76F5044B1A53
3584,15627855,21000,9830010246,21000,0,2,1,0xA090e606E30bD747d4E6245a1517EbE430F0057e,0xf316311581B43ccC2E620157e68eC2e4391CdB19
3585,15627855,21000,9830010246,21000,0,2,1,0xA090e606E30bD747d4E6245a1517EbE430F0057e,0x69e7194Ecc71c3193c1f91eaD5B08f10e3dD2fEc
3586,15627855,21000,9830010246,21000,0,2,1,0xA090e606E30bD747d4E6245a1517EbE430F0057e,0xC403f98046f0dacAD7cB391D44AeE2A590880C5b
3587,15627855,21000,9830010246,21000,0,2,1,0xA090e606E30bD747d4E6245a1517EbE430F0057e,0x8Bd3C11B6FA481b5fdB2fc6fe88eD99bAF4463eC
3588,15627855,21000,9830010246,21000,0,2,1,0xA090e606E30bD747d4E6245a1517EbE430F0057e,0xF8DA2e0328f30761F565498AEB298c8BF00d09f2
3589,15627855,21000,9830010246,21000,0,2,1,0xA090e606E30bD747d4E6245a1517EbE430F0057e,0x7644F57D86d10434aFB4fE0676C88139E512D7Ed
3590,15627855,21000,9830010246,21000,0,2,1,0xA090e606E30bD747d4E6245a1517EbE430F0057e,0xa51D2E49832f4CC29FAaaC54750E81924CA06b91
3591,15627855,21000,9830010246,21000,0,2,1,0xA090e606E30bD747d4E6245a1517EbE430F0057e,0x180f38B797CFF0B71755441126d508F963D5c058
3592,15627855,21000,9830010246,21000,0,2,1,0xA090e606E30bD747d4E6245a1517EbE430F0057e,0x1EC6ef77672613276e9D8BA8A5A0aB718BB6C73c
3593,15627855,21000,9830010246,21000,0,2,2,0xA090e606E30bD747d4E6245a1517EbE430F0057e,0x4d8dEC7dF3CaD307906907d6E321033F1BD245D8
3594,15627855,21000,9830010246,21000,0,2,2,0xA090e606E30bD747d4E6245a1517EbE430F0057e,0xa27fc8C84DDBcbD2EEdBe86D9B0C7A641162948C
3595,15627855,21000,9830010246,21000,0,2,0,0xA090e606E30bD747d4E6245a1517EbE430F0057e,0xD2B63f38FeD36bAAca2b6c18b8F14283fF68c637
3596,15627855,21000,9830010246,21000,0,2,4,0xA090e606E30bD747d4E6245a1517EbE430F0057e,0x1e4B7234262269E21B41A3Bf6097f318e8Fa3b15
3597,15627855,21000,9830010246,21000,0,2,2,0xA090e606E30bD747d4E6245a1517EbE430F0057e,0x356AECF4ebA3EF07BC89afe8887F59f8C859fD12
3598,15627855,21000,9830010246,21000,0,2,2,0xA090e606E30bD747d4E6245a1517EbE430F0057e,0x7a5b86eE5467608aBB47C95735f23F60F2485ee2
3599,15627855,21000,9830010246,21000,0,2,2,0xA090e606E30bD747d4E6245a1517EbE430F0057e,0x24264adf49749cb1A4bFF95828B42A954eef15dD
3600,15627855,21000,9830010246,21000,0,2,2,0xA090e606E30bD747d4E6245a1517EbE430F0057e,0x23E060FDB32aE6CfcDC3820a7a13992EAa6d7Fc5
3601,15627855,500000,9830010246,499356,644,138,3637,0x4a220E6096B25EADb88358cb44068A3248254675,0x10593a64B7b7BB0Ea29B8c01F1619ca8fF294b2F
3602,15627855,21000,9830010246,21000,0,2,0,0xA090e606E30bD747d4E6245a1517EbE430F0057e,0x6576d7BcC50AFc76ef70Bb45AF79d5b08c676498
3603,15627855,21000,9830010246,21000,0,2,2,0xA090e606E30bD747d4E6245a1517EbE430F0057e,0x301D55E264f1BF9684705F2A8c46B5380E538a07
3604,15627855,21000,9830010246,21000,0,2,1,0xA090e606E30bD747d4E6245a1517EbE430F0057e,0x2fca126Ff8297A0De7884f80597793fFfEa99678
3605,15627855,21000,9830010246,21000,0,2,2,0xA090e606E30bD747d4E6245a1517EbE430F0057e,0x3d62dd7503bDfffC83db293Ce5A57eB9Ce0154bc
3606,15627855,21000,9830010246,21000,0,2,2,0xA090e606E30bD747d4E6245a1517EbE430F0057e,0x790a146B291Ae6E5cbDc480f19e13b7e80CD5A85
3607,15627855,21000,9830010246,21000,0,2,1,0xA090e606E30bD747d4E6245a1517EbE430F0057e,0x220008FA05F3E7e99E34B0ef0a25CF0A29F1482B
3608,15627855,21000,9830010246,21000,0,2,2,0xA090e606E30bD747d4E6245a1517EbE430F0057e,0x39b5199574A672903D5C895d248869e60BC1e9Db
3609,15627855,21000,9830010246,21000,0,2,1,0xA090e606E30bD747d4E6245a1517EbE430F0057e,0x86D44A51837423e461AdD228608A7B774F1B77eb
3610,15627855,21000,9830010246,21000,0,2,1,0xA090e606E30bD747d4E6245a1517EbE430F0057e,0xDFFbf77cC7923Ce9530D33508DFca4A965a96D43
3611,15627855,21000,9830010246,21000,0,2,2,0xA090e606E30bD747d4E6245a1517EbE430F0057e,0x8eBE2e6C966BF08356dcBa0b40bDEe2A782f20c4
3612,15627855,21000,9830010246,21000,0,2,1,0xA090e606E30bD747d4E6245a1517EbE430F0057e,0x8AEFa520c1a38E0A8890E575F1A149Bd3c8854E0
3613,15627855,21000,9830010246,21000,0,2,1,0xA090e606E30bD747d4E6245a1517EbE430F0057e,0x9b691A0f78183B3Fc309FeF7c9Dc2312c5c2E838
3614,15627855,21000,9830010246,21000,0,2,1,0xA090e606E30bD747d4E6245a1517EbE430F0057e,0x6E1059d4015b6AFafc16F7626ec065E03B4b53Df
3615,15627855,21000,9830010246,21000,0,2,10,0xA090e606E30bD747d4E6245a1517EbE430F0057e,0x2DF3D0bc82f1B53101fecC013c2Eb09C96C8EE01
3616,15627855,21000,9830010246,21000,0,2,1,0xA090e606E30bD747d4E6245a1517EbE430F0057e,0x1f320F63D700087C0620963637C3076Aa01f827f
3617,15627855,21000,9830010246,21000,0,2,2,0xA090e606E30bD747d4E6245a1517EbE430F0057e,0x1027D0586e070f42C12adDeBDef9541DdF5E6228
3618,15627855,21000,9830010246,21000,0,2,2,0xA090e606E30bD747d4E6245a1517EbE430F0057e,0x4796E80bD5a332D35C103bE5ef815D617C3Ec789
3619,15627855,21000,9830010246,21000,0,2,24,0xab1d377fD6693642107Bf1d4C99216A3c55B3804,0xd9347A60174Fc9650331F61E16a5C3853d8F7642
3620,15627855,21000,9830010246,21000,0,2,2,0xA090e606E30bD747d4E6245a1517EbE430F0057e,0x0725bF6E5e345A9af55386Ae05b069C0A2C5Fe26
3621,15627855,21000,9830010246,21000,0,2,1,0xA090e606E30bD747d4E6245a1517EbE430F0057e,0x5C8010792859C22b6d704E22D5d23F0824D4a15f
3622,15627855,21000,9830010246,21000,0,2,2,0xA090e606E30bD747d4E6245a1517EbE430F0057e,0x63756E94A8aCcB8ab38007DD34b8A98a58891564
3623,15627855,21000,9830010246,21000,0,2,1,0xA090e606E30bD747d4E6245a1517EbE430F0057e,0xB2Ca9edaAef1eE4Fd9566feFAc556B5320C198De
3624,15627855,21000,9830010246,21000,0,2,2,0xA090e606E30bD747d4E6245a1517EbE430F0057e,0xa000936DD69A2b53fE78B8C1cDd752974d374c5c
3625,15627855,21000,9830010246,21000,0,2,1,0xA090e606E30bD747d4E6245a1517EbE430F0057e,0xEE379Bd80c6788a02bE37b789A1e40D99Eddbc69
3626,15627855,21000,9830010246,21000,0,2,1,0xA090e606E30bD747d4E6245a1517EbE430F0057e,0x7Ac088BF8EB2798171F8E82429FB177b120E4866
3627,15627855,21000,9830010246,21000,0,2,1,0xA090e606E30bD747d4E6245a1517EbE430F0057e,0x276008FF6dD2C9F84A26D004d3AC42D32963456E
3628,15627855,21000,9830010246,21000,0,2,2,0xA090e606E30bD747d4E6245a1517EbE430F0057e,0xEB195914FDaA65FC62DfF1701269F9F0d1676Ac1
3629,15627855,21000,9830010246,21000,0,2,1,0xA090e606E30bD747d4E6245a1517EbE430F0057e,0x49FAc8323D661A07AB95D2314cE44725B641B14f
3630,15627855,21000,9830010246,21000,0,2,4,0xA090e606E30bD747d4E6245a1517EbE430F0057e,0xB37Ce2B49E2C9269F5a1872ee1F42A777CED4e2d
3631,15627855,21000,9830010246,21000,0,2,1,0xA090e606E30bD747d4E6245a1517EbE430F0057e,0xc37E8Ce8A426F8eDc33DAdb368b8bdc3929c39d1
3632,15627855,21000,9830010246,21000,0,2,1,0xA090e606E30bD747d4E6245a1517EbE430F0057e,0x06DdF86b2a18ab273Ff2FC9e8A24407A0CAc6138
3633,15627855,21000,9830010246,21000,0,2,1,0xA090e606E30bD747d4E6245a1517EbE430F0057e,0x4bFA2d277075336d19b44eF887154ADf176708dD
3634,15627855,21000,9830010246,21000,0,2,1,0xA090e606E30bD747d4E6245a1517EbE430F0057e,0xA8595a1265A6d27bb32BaD311fe8eA6975F0CcCD
3635,15627855,21000,9830010246,21000,0,2,2,0xA090e606E30bD747d4E6245a1517EbE430F0057e,0x184f5Bdc3438653894a15e2e0D85e26e3d015871
3636,15627855,21000,9830010246,21000,0,2,2,0xA090e606E30bD747d4E6245a1517EbE430F0057e,0x24d13D89f4E7049Fd5D58B83F3B715359F476968
3637,15627855,21000,9830010246,21000,0,2,2,0xA090e606E30bD747d4E6245a1517EbE430F0057e,0x5306580c16F3493Ce487C546a98bA07D5c936045
3638,15627855,21000,9830010246,21000,0,2,2,0xA090e606E30bD747d4E6245a1517EbE430F0057e,0xD44A35A01990918234E60B06B9aB32727b3cAC11
3639,15627855,21000,9830010246,21000,0,2,1,0xA090e606E30bD747d4E6245a1517EbE430F0057e,0xfe66DCa529C0C89a1609cFEb4f9F42311cF7fe30
3640,15627855,21000,9830010246,21000,0,2,0,0xA090e606E30bD747d4E6245a1517EbE430F0057e,0xfc36bFC31F9B90E18a8eF7A50b5aD75189bdaD93
3641,15627855,21000,9830010246,21000,0,2,1,0xA090e606E30bD747d4E6245a1517EbE430F0057e,0xF0A47B74A2190134618D0e26144Cc05059eFb117
3642,15627855,21000,9830010246,21000,0,2,1,0xA090e606E30bD747d4E6245a1517EbE430F0057e,0x143f2538eA2d2658781579FD3D167F9f634C2f69
3643,15627855,21000,9830010246,21000,0,2,1,0xA090e606E30bD747d4E6245a1517EbE430F0057e,0xE8649764F8d50308Cf155199e168f78a636326ED
3644,15627855,21000,9830010246,21000,0,2,1,0xA090e606E30bD747d4E6245a1517EbE430F0057e,0x8f4Cd3F7C7Fd9139Ac6A8d06B8e845aec5304407
3645,15627855,21000,9830010246,21000,0,2,2,0xA090e606E30bD747d4E6245a1517EbE430F0057e,0xd1b3f29EA64F90865110Ff32AfED54Aa803c923a
3646,15627855,21000,9830010246,21000,0,2,1,0xA090e606E30bD747d4E6245a1517EbE430F0057e,0x81c0231A27942e8F785E9C21B5a0382003F62A9b
3647,15627855,21000,9830010246,21000,0,2,1,0xA090e606E30bD747d4E6245a1517EbE430F0057e,0xDE54c84C76dbE3e98514d277707ee0c0591e8357
3648,15627855,21000,9830010246,21000,0,2,2,0xA090e606E30bD747d4E6245a1517EbE430F0057e,0xbB19A8d3b1996107c27894f4419B3e1895E95eA0
3649,15627855,21000,9830010246,21000,0,2,2,0xA090e606E30bD747d4E6245a1517EbE430F0057e,0x08a5293ee41c3d018E02248D064f5B8787927a09
3650,15627855,21000,9830010246,21000,0,2,2,0xA090e606E30bD747d4E6245a1517EbE430F0057e,0x286834f468E1c538d477F97531CA4ee67503F64C
3651,15627855,21000,9830010246,21000,0,2,2,0xA090e606E30bD747d4E6245a1517EbE430F0057e,0xf494B76BC5AE98cA574dE615E6103fAf5Aa71D30
3652,15627855,21000,9830010246,21000,0,2,1,0xA090e606E30bD747d4E6245a1517EbE430F0057e,0x2fA0646590B96B0E69d756178a75BcF617589Ff2
3653,15627855,21000,9830010246,21000,0,2,1,0xA090e606E30bD747d4E6245a1517EbE430F0057e,0xfe28618FDd7FC76E0B79B45b479d0E45501A66b0
3654,15627855,21000,9830010246,21000,0,2,2,0xA090e606E30bD747d4E6245a1517EbE430F0057e,0x035a8a65A0943D0C708Dcac26F758A630F948292
3655,15627855,21000,9830010246,21000,0,2,5,0xA090e606E30bD747d4E6245a1517EbE430F0057e,0x887aC41c57378C0f6E7c209B764F33cE427CaAd1
3656,15627855,21000,9830010246,21000,0,2,0,0xA090e606E30bD747d4E6245a1517EbE430F0057e,0x6BB657461DcE972366f049a86cc1758CDBEf0650
3657,15627855,21000,9830010246,21000,0,2,1,0xA090e606E30bD747d4E6245a1517EbE430F0057e,0xF244442A01BD3de6814c251bE8235C970ad5A74b
3658,15627855,21000,9830010246,21000,0,2,2,0xA090e606E30bD747d4E6245a1517EbE430F0057e,0x823ab53D09ab19e376a5e7f235372538b66DE47E
3659,15627855,21000,9830010246,21000,0,2,8,0xA090e606E30bD747d4E6245a1517EbE430F0057e,0xE09724BaDe1667a93Eeb598Afbe9903D08ab9158
3660,15627855,21000,9830010246,21000,0,2,2,0xA090e606E30bD747d4E6245a1517EbE430F0057e,0xca990cD91F5D31E309f59696146CA5591104963A
3661,15627855,21000,9830010246,21000,0,2,1,0xA090e606E30bD747d4E6245a1517EbE430F0057e,0xD8943d33452c60775C8ad2e71786a1A2D6fD9553
3662,15627855,30732,9830010246,30668,64,10,837,0xC02aaA39b223FE8D0A0e5C4F27eAD9083C756Cc2,0x35fD1a27e82962C9E9e59E40bdd3cAd527079f0f
3663,15627855,21000,9830010246,21000,0,2,4,0xA090e606E30bD747d4E6245a1517EbE430F0057e,0x87c7Fdb430174F49df3F38a8C0B33286340c77B8
3664,15627855,5490929,9830010246,5290577,200352,26018,0,,0xCCA6815482a886227eA5f751445505fbA516215a
3665,15627855,207128,9830010246,206532,596,138,4708695,0xdAC17F958D2ee523a2206206994597C13D831ec7,0x28C6c06298d514Db089934071355E5743bf21d60
3666,15627855,207128,9830010246,207128,0,2,4468940,0x7CadfbA12a2764656B2EE2Ba13cBf221D0099A84,0x21a31Ee1afC51d94C2eFcCAa2092aD1028285549
3667,15627855,207128,9830010246,207128,0,2,1679524,0x886b25394642918A8946335a382d8122Cf2d07c4,0x4976A4A02f38326660D17bf34b431dC6e2eb2327
3668,15627855,207128,9830010246,206520,608,138,4232330,0xdAC17F958D2ee523a2206206994597C13D831ec7,0xDFd5293D8e347dFe59E90eFd55b2956a1343963d
3669,15627855,207128,9830010246,207128,0,2,3199172,0x472258c3F3eE37f05941fd147cBA19010eB2281c,0x9696f59E4d72E237BE84fFD425DCaD154Bf96976
3670,15627855,207128,9830010246,206520,608,138,3492274,0xdAC17F958D2ee523a2206206994597C13D831ec7,0x56Eddb7aa87536c09CCc2793473599fD21A8b17F
3671,15627855,207128,9830010246,207128,0,2,4708696,0x1132D9B04E8b2Acc46125a35CB51dc3d40476cc2,0x28C6c06298d514Db089934071355E5743bf21d60
3672,15627855,21000,9797986072,21000,0,2,87,0x5aB9faB4a21791e230153f1b9ADB85f08E6d704f,0x231E825CC48A641d61D9a3116A199FAA764634aD
3673,15627855,50000,9354000000,49332,668,138,0,0xdAC17F958D2ee523a2206206994597C13D831ec7,0x6f964Abb38ECC1c45a8a6c283CF7bb29fd93c81f
3674,15627855,46083,9330010246,45595,488,138,197,0x7E6Bc952d4b4bD814853301bEe48E99891424de0,0x0b9e99e938AaB21618AA2bf543C60C167967BBC4
3675,15627855,115427,9330010246,115363,64,10,46,0x12DEb1Cb5732E40Dd55B89aBB6D5C31dF13A6e38,0x9aCE182C0d1f30E6A8b90650659DE6f29DF6Af23
3676,15627855,46113,9330010246,45625,488,138,106,0x6FD053BfF10512d743Fa36C859e49351a4920df6,0xFA5F446a75CFcF5D68857d7Fc3B9Cf3AD9efdedB
3677,15627855,219502,9330010246,216766,2736,650,1893232,0xD1669Ac6044269b59Fa12c5822439F609Ca54F41,0xD2C82F2e5FA236E114A81173e375a73664610998
3678,15627855,21000,9330010246,21000,0,2,193,0x6946CEc9D3A0960CC3EF5Ee099Dd07FD7a729922,0x013A5DD0E59963Fc5A09C1FD6c4FcEe478366110
3679,15627855,79572,9330010246,79168,404,138,23,0x2b591e99afE9f32eAA6214f7B7629768c40Eeb39,0xA6331fEADd1d11E2F0d4577b90A85FD4F22Fb6e1
3680,15627855,625924,9330010246,622332,3592,1162,351,0x68b3465833fb72A70ecDF485E0e4C7bD8665Fc45,0x2f978993Ca781B6904Cd4f30d137bA821FfF8Dc1
3681,15627855,261279,9330010246,238655,22624,7522,602,0x00000000006c3852cbEf3e08E8dF289169EdE581,0xb7626B33Bd569BB023875348C347feAEb768f099
3682,15627855,284982,9330010246,270514,14468,4746,798,0x83C8F28c26bF6aaca652Df1DbBE0e1b56F8baBa2,0x5741359BBC889a768D54d2F97A6cb18dee1Ec341
3683,15627855,21000,9330010246,21000,0,2,253,0x76B36fa9B4bC0fD574f8aBED7815F6968122c44F,0xB15B7508129d6F888F27573e1ea32577e95430A1
3684,15627855,21000,9330010246,21000,0,2,181,0x76B36fa9B4bC0fD574f8aBED7815F6968122c44F,0xc10ed3DB1317eF94973D175B622459c7382A0eA9
3685,15627855,46563,9330010246,45619,944,138,251,0xa71d0588EAf47f12B13cF8eC750430d21DF04974,0xD631Bc52b1b69Bd79151be24B7d004e0Bc33f8aB
3686,15627855,283912,9330010246,269916,13996,4618,654,0x83C8F28c26bF6aaca652Df1DbBE0e1b56F8baBa2,0xCc7FBaB2a9702dF21D36C1F8aE9a4B00aF39DBAb
3687,15627855,55836,9330010246,54892,944,138,7,0x9813037ee2218799597d83D4a5B6F3b6778218d9,0x4270cd21614B026D7c6106d4E54893980da2BF7a
3688,15627855,21000,9330010246,21000,0,2,165,0x76B36fa9B4bC0fD574f8aBED7815F6968122c44F,0xAd7aECf27fCA2Bb9fc37e0D6A63cf59FF90527d2
3689,15627855,21000,9330010246,21000,0,2,149,0x76B36fa9B4bC0fD574f8aBED7815F6968122c44F,0x0bf91ce8F96516492518F08D00e2956078fFdDAc
3690,15627855,100569,9330010246,100517,52,10,138,0x1F78bF06b1b14aaF29833Efa371fC090e11D1420,0xFF2C00c056Af3bF2dad57400C8249DEf4744AF7A
3691,15627855,21000,9330010246,21000,0,2,127,0x76B36fa9B4bC0fD574f8aBED7815F6968122c44F,0x8e7a08002c90E80Fc25A7b09Cc06c5E0149a9Fe3
3692,15627855,46157,9330010246,45669,488,138,24,0x69d4584080EdC5d058D5C51Ac61ec0c14E417E70,0x814444012a50A540bA3d1C80a05227F0d06C8b7A
3693,15627855,48558,9330010246,47926,632,138,0,0x7D1AfA7B718fb893dB30A3aBc0Cfc608AaCfeBB0,0x561E2F8bb1CfE6fbDe820D56C964dF00FAFcFaBE
3694,15627855,46267,9330010246,45691,576,74,346,0x283Af0B28c62C092C9727F1Ee09c02CA627EB7F5,0xd3AfEA7C924cBbFe8C3B514cefb6dbd505788Fa3
3695,15627855,21000,9330010246,21000,0,2,136,0x76B36fa9B4bC0fD574f8aBED7815F6968122c44F,0x9f64785EA3f4CFf5dB47633f02b92526Aa2cDee7
3696,15627855,21000,9330010246,21000,0,2,524,0x666eC0ad1770783309bC86a3e2CB31DDD4Cd4aE4,0x55C9B965F09D51A73B23A55CfCC595a95c41965C
3697,15627855,79372,9330010246,78144,1228,202,12,0x5FDCCA53617f4d2b9134B29090C87D01058e27e9,0xC9327e6AfB1c18a6526D4A784524F1B7a70d5cb5
3698,15627855,21000,9330010246,21000,0,2,108,0x76B36fa9B4bC0fD574f8aBED7815F6968122c44F,0xa38D781b1bf5A05fF9c0869dEefA17E4b7b6885E
3699,15627855,310642,9330010246,309042,1600,394,2,0x7a250d5630B4cF539739dF2C5dAcb4c659F2488D,0x7D35286C7d6864Cf6A61b4EC90F3d2FB6F8C7935
3700,15627855,900000,9330010246,898224,1776,458,510,0x7a250d5630B4cF539739dF2C5dAcb4c659F2488D,0x1de23D0B427d764BDbABE7AE8a1735a6F2492bD3
3701,15627855,850000,9330010246,847068,2932,778,165,0x2C6dCb1904CD4fA56cf48CBA970ebd3864Ee949E,0x87744492262a905fe1ABf9927330A09F1311CBb0
3702,15627855,850000,9330010246,847068,2932,778,277,0x2C6dCb1904CD4fA56cf48CBA970ebd3864Ee949E,0x7F0F1FB6409443087a6f3c8ca03BC1e5760cf52F
3703,15627855,750000,9330010246,747880,2120,522,3970,0x860c75b0b752A5714949ab1f748F6362445cdA2e,0x1027925dC139722d4C62B17081e4bc632229435A
3704,15627855,850000,9330010246,847068,2932,778,259,0x2C6dCb1904CD4fA56cf48CBA970ebd3864Ee949E,0xCf45b85C3C294Dcd77d1b22C881DB17A22ba1147
3705,15627855,850000,9330010246,847068,2932,778,173,0x2C6dCb1904CD4fA56cf48CBA970ebd3864Ee949E,0x08b523017e3677E053A0e9f20bA73EB46f71671d
3706,15627855,444444,9330010246,442668,1776,458,630,0x7a250d5630B4cF539739dF2C5dAcb4c659F2488D,0xC784a500392c80cA41DAfBdF8fE104CbC453d5EE
3707,15627855,750000,9330010246,747680,2320,586,249,0x9bC6369a2D947BdfAEdd74207d3589dbaFc48b52,0x17CDDeb2757Db0292ee94f74c50a67D89C548dd5
3708,15627855,750000,9330010246,747680,2320,586,3087,0x9bC6369a2D947BdfAEdd74207d3589dbaFc48b52,0x5BD8aCcB6d624bA8e0a9c017E02785144c0606Ac
3709,15627855,750000,9330010246,747680,2320,586,279,0x9bC6369a2D947BdfAEdd74207d3589dbaFc48b52,0x4854C973f7DE13d8503a0133133F03Ee7FddA425
3710,15627855,21000,9000000000,21000,0,2,4,0x70C48F3Ec8Be53867D9584DCD087FBe2aAB3122A,0x9C3F4CE9FAE3bd42c070122fAaC548d03Ad975A6
3711,15627855,175110,8830010246,173546,1564,394,296,0x1Fa8559e873f698292766790AeCf8080A66433F6,0xfA8d363194EDf1bd081b30C46d98e4b39fACC774
3712,15627855,138960,8830010246,138756,204,74,308,0x5D004ddB5D92938dAF8448b9eac1CaA593cd26Ca,0x45Cb8F8692c1AA326F7aAE6e7aFfecDBF11B28A5
3713,15627855,297198,8830010246,293898,3300,1034,488,0x68b3465833fb72A70ecDF485E0e4C7bD8665Fc45,0x7862958ee0797a7ABD33A65030fC608a656febB7
3714,15627855,260956,8830010246,258700,2256,650,96398,0xA69babEF1cA67A37Ffaf7a485DfFF3382056e78C,0xBbAD96336943A36E3e292D973B3382dd0bA4D1EF
3715,15627855,60691,8000000000,53271,7420,2506,71,0x00000000006c3852cbEf3e08E8dF289169EdE581,0x8Dc1E4Abf18e18a5aF832a2f895BEad3fcC0c7cF
3716,15627855,241210,8000000000,237834,3376,970,1,0x362fA9D0bCa5D19f743Db50738345ce2b40eC99f,0xAB10B65949bE68F060857C8c42bff2AE27890A1B
3717,15627855,2193429,7969073189,2076057,117372,19658,668,0x86E4Dc95c7FBdBf52e33D563BbDB00823894C287,0xeC20607aa654D823DD01BEB8780a44863c57Ed07
3718,15627855,191113,7969073189,190189,924,266,413,0xd588b586D61C826A0e87919b3D1a239206d58bf2,0xd7188770a2962C73CCBc8A451455a29bD38FD965
3719,15627855,51988,7969073189,51044,944,138,22,0x72B169AD8aF6c4FB53056b6a2A85602Ad6863864,0x8519515e4Baf9bf2766438B01f34b1BC26fb5dd6
3720,15627855,51352,7969073189,50744,608,138,0,0x083D41d6DD21EE938f0c055CA4fb12268DF0EfaC,0xD2A6a490aE99C8e3bb08d74987065CE37ff1CA7F
3721,15627856,250784,7958334261,248600,2184,650,106623,0xA69babEF1cA67A37Ffaf7a485DfFF3382056e78C,0x9AAb3F81604c683a1a0D14019FBfe15bef7aA1ee
3722,15627856,425123,9168336461,418779,6344,1740,54,0x881D40237659C251811CEC9c364ef91dC08D300C,0x24dfa3F06e7833F10847f6c8cB1952C0A77e0c1a
3723,15627856,46530,9568851581,45586,944,138,98,0x66a0f676479Cee1d7373f3DC2e2952778BfF5bd6,0xd33cF84d29c08ad72B90344362b008416D92d1f6
3724,15627856,426396,9568851581,416756,9640,2764,99,0x881D40237659C251811CEC9c364ef91dC08D300C,0xd33cF84d29c08ad72B90344362b008416D92d1f6
3725,15627856,500000,100000000000,499056,944,138,7507,0xd4cB651749953988647eEE9b51DDB8DB5aeb3410,0xC5C018EDb7Ec3e4217728C1e1F608b28057Dd507
3726,15627856,700000,47958334261,698516,1484,330,1161,0x95B05Bc8f6c59847E7d2D484E8542363D422e341,0x47ec31abc6b86e49933dC7B2969EBEbE3De662cA
3727,15627856,21000,45000000000,21000,0,2,0,0xD86e3A116Bc98A354253dea47ffd36E86b1A1BC2,0x5B9Ce75CA02A6d72138072d04BEfB18c55E07c7f
3728,15627856,444444,25000000000,443500,944,138,631,0x011b0beAe3eC5953B4805b064cC78f6F892A99cC,0xC784a500392c80cA41DAfBdF8fE104CbC453d5EE
3729,15627856,1000000,22958334261,999056,944,138,636,0xD309A8d0498Cc73f53481e46094DC0d3aaB0d9dd,0x903D13d2BC4D187ab5316a76c45CC971Dda6e226
3730,15627856,5049496,17000000000,5042372,7124,1098,282,0x0a39DA505DfB5E0BBc6bd84428281A8ba1bC7753,0x495E889d1A6cEB447a57dcc1C68410299392380c
3731,15627856,70000,15000000000,69368,632,138,0,0x6B175474E89094C44Da98b954EedeAC495271d0F,0x7F424Dd46760a4Da4026135D20221aA59f2755bd
3732,15627856,900000,12958334261,899056,944,138,511,0x011b0beAe3eC5953B4805b064cC78f6F892A99cC,0x1de23D0B427d764BDbABE7AE8a1735a6F2492bD3
3733,15627856,222222,12000000000,220658,1564,394,295,0x1Fa8559e873f698292766790AeCf8080A66433F6,0x60700A65112De211ca9B89FaBD73C5f3b3971Dfb
3734,15627856,500000,11958334261,498716,1284,266,34376,0x3666f603Cc164936C1b87e207F36BEBa4AC5f18a,0xa6a688F107851131F0E1dce493EbBebFAf99203e
3735,15627856,21000,11708334261,21000,0,2,251469,0xE3b85e4f261e9E54ecfA83E53E460Ea37CbE9471,0x151B381058f91cF871E7eA1eE83c45326F61e96D
3736,15627856,136617,11681170690,136617,0,2,2710050,0x9a350f42f7f3c10BaF208a8bd804b34fe0174CBF,0xC098B2a3Aa256D2140208C3de6543aAEf5cd3A94
3737,15627856,76207,11681170690,75231,976,202,355148,0xdAC17F958D2ee523a2206206994597C13D831ec7,0x7abE0cE388281d2aCF297Cb089caef3819b13448
3738,15627856,84261,11681170690,83297,964,202,355149,0xA0b86991c6218b36c1d19D4a2e9Eb0cE3606eB48,0x7abE0cE388281d2aCF297Cb089caef3819b13448
3739,15627856,76192,11676041789,75228,964,202,4709911,0xdAC17F958D2ee523a2206206994597C13D831ec7,0x2FAF487A4414Fe77e2327F0bf4AE2a264a776AD2
3740,15627856,84290,11676041789,83302,988,202,4709912,0xA0b86991c6218b36c1d19D4a2e9Eb0cE3606eB48,0x2FAF487A4414Fe77e2327F0bf4AE2a264a776AD2
3741,15627856,69836,11676041789,68812,1024,202,4709913,0x3506424F91fD33084466F402d5D97f05F8e3b4AF,0x2FAF487A4414Fe77e2327F0bf4AE2a264a776AD2
3742,15627856,84290,11676041789,83302,988,202,4709914,0xA0b86991c6218b36c1d19D4a2e9Eb0cE3606eB48,0x2FAF487A4414Fe77e2327F0bf4AE2a264a776AD2
3743,15627856,93836,11676041789,93240,596,138,4709915,0xdAC17F958D2ee523a2206206994597C13D831ec7,0x2FAF487A4414Fe77e2327F0bf4AE2a264a776AD2
3744,15627856,21000,11000000000,21000,0,2,14,0x586D15b13b07B6DE57bA2f3EE224ca84CCdeebCF,0x5a0cADd8eEB39263B5C954848857939198cA24b5
3745,15627856,21000,11000000000,21000,0,2,7,0xdD59ece9bE82aa2e910b609286CEF0dd320E405d,0x1A7fC4FFcd2B2D0236bD235E6F6c186F93c0d3F1
3746,15627856,21000,11000000000,21000,0,2,12,0x3348D99d14359DC9C2e978560aFAEd3Be953e6F1,0xba430C1a5c8d0A70Bdc68F1E01A66035208bAD42
3747,15627856,21000,11000000000,21000,0,2,17,0x389505f098a29a994A3ed0e674f07cd451dde42C,0x3BCbcA1e2633089dbAC584Ba68FA106E881650b1
3748,15627856,21000,11000000000,21000,0,2,39,0x075ecF7c0C5eb58E42616fC007855a03714f541B,0x1798d782384aB1fA52aEE380109e4dA0386ED841
3749,15627856,55926,10958334261,54982,944,138,3971,0x011b0beAe3eC5953B4805b064cC78f6F892A99cC,0x1027925dC139722d4C62B17081e4bc632229435A
3750,15627856,55926,10958334261,54982,944,138,280,0x011b0beAe3eC5953B4805b064cC78f6F892A99cC,0x4854C973f7DE13d8503a0133133F03Ee7FddA425
3751,15627856,55926,10958334261,54982,944,138,250,0x011b0beAe3eC5953B4805b064cC78f6F892A99cC,0x17CDDeb2757Db0292ee94f74c50a67D89C548dd5
3752,15627856,55926,10958334261,54982,944,138,3088,0x011b0beAe3eC5953B4805b064cC78f6F892A99cC,0x5BD8aCcB6d624bA8e0a9c017E02785144c0606Ac
3753,15627856,50000,10911234435,50000,0,2,464123,0x3507ED1BD251E3Bf55E0841B3716a2ADbFeBf752,0x3B794929566e3Ba0f25e4263e1987828b5c87161
3754,15627856,21000,10846945963,21000,0,2,32,0x040676D5FaF92939E32b399dD920C7D894119419,0x9738F949AC39a2883e0176F561b8c32139Ee33d5
3755,15627856,21000,10718797213,21000,0,2,1210286,0x89F8AFb76bda495653aA8Db079a73A41d68c50cc,0x912fD21d7a69678227fE6d08C64222Db41477bA0
3756,15627856,100000,10662934929,99392,608,138,1050382,0x8Fc8f8269ebca376D046Ce292dC7eaC40c8D358A,0xf16E9B0D03470827A95CDfd0Cb8a8A3b46969B91
3757,15627856,100000,10662934929,99344,656,138,1050383,0x7D1AfA7B718fb893dB30A3aBc0Cfc608AaCfeBB0,0xf16E9B0D03470827A95CDfd0Cb8a8A3b46969B91
3758,15627856,200000,10662934929,199344,656,138,1050384,0x2Ab6Bb8408ca3199B8Fa6C92d5b455F820Af03c4,0xf16E9B0D03470827A95CDfd0Cb8a8A3b46969B91
3759,15627856,100000,10662934929,99392,608,138,368497,0xdAC17F958D2ee523a2206206994597C13D831ec7,0xeC30d02f10353f8EFC9601371f56e808751f396F
3760,15627856,100000,10662934929,99404,596,138,368498,0xdAC17F958D2ee523a2206206994597C13D831ec7,0xeC30d02f10353f8EFC9601371f56e808751f396F
3761,15627856,100000,10662934929,99392,608,138,368499,0xdAC17F958D2ee523a2206206994597C13D831ec7,0xeC30d02f10353f8EFC9601371f56e808751f396F
3762,15627856,21000,10638055621,21000,0,2,0,0xCBD6832Ebc203e49E2B771897067fce3c58575ac,0xaB9cd3Fd067bF077B60E6f87b6C64852dAb253e7
3763,15627856,21000,10638055621,21000,0,2,14,0xCBD6832Ebc203e49E2B771897067fce3c58575ac,0xf9926fBdCD621b9f8D7a312CB374A7aee13ba0f3
3764,15627856,21000,10500000000,21000,0,2,29,0x6dfc34609a05bC22319fA4Cce1d1E2929548c0D7,0x8D438Fc9C0C4c0f01F32943810b6955bb39B9AE0
3765,15627856,21000,10500000000,21000,0,2,8,0x6dfc34609a05bC22319fA4Cce1d1E2929548c0D7,0xf3668384B49c015b9D47524d5AFfb1559a206776
3766,15627856,5000000,10458334261,4999368,632,138,4,0x41B5b2eAe85b7920806D19595AaF7Ae9B53687Dc,0x5c37D7eDdB52c1572e6511739529865e14D16300
3767,15627856,43027,10458334261,42751,276,74,1513,0x538d1a534547ba60FF4D4Fa0b4cb73906a9b511f,0x518201899E316bf98c957C73e1326b77672Fe52b
3768,15627856,675376,10458334261,674924,452,138,89,0x8332717a53B73ADb5897F473F54384956787A978,0x5f82b0e5cE654700d66Acf1E366A7f06C6ad866a
3769,15627856,675376,10458334261,674924,452,138,90,0x8332717a53B73ADb5897F473F54384956787A978,0x5f82b0e5cE654700d66Acf1E366A7f06C6ad866a
3770,15627856,675340,10458334261,674912,428,138,91,0x8332717a53B73ADb5897F473F54384956787A978,0x5f82b0e5cE654700d66Acf1E366A7f06C6ad866a
3771,15627856,675340,10458334261,674912,428,138,92,0x8332717a53B73ADb5897F473F54384956787A978,0x5f82b0e5cE654700d66Acf1E366A7f06C6ad866a
3772,15627856,675340,10458334261,674912,428,138,93,0x8332717a53B73ADb5897F473F54384956787A978,0x5f82b0e5cE654700d66Acf1E366A7f06C6ad866a
3773,15627856,675340,10458334261,674912,428,138,94,0x8332717a53B73ADb5897F473F54384956787A978,0x5f82b0e5cE654700d66Acf1E366A7f06C6ad866a
3774,15627856,100000,10100000000,99024,976,202,259898,0xdAC17F958D2ee523a2206206994597C13D831ec7,0x292f04a44506c2fd49Bac032E1ca148C35A478c8
3775,15627856,100000,10100000000,99024,976,202,705873,0xdAC17F958D2ee523a2206206994597C13D831ec7,0x6dfc34609a05bC22319fA4Cce1d1E2929548c0D7
3776,15627856,21000,10080000000,21000,0,2,654,0x292f04a44506c2fd49Bac032E1ca148C35A478c8,0x7992Ae3F68887a46c76832a0ddBdF1E15BdC1Cf6
3777,15627856,21000,10056009542,21000,0,2,2,0x9b309e82478fE2974BC05c9C541dbFbDF395b4e1,0xfb2A3e7aEdC2297A8E00A23Ed0f0c09b71E648e8
3778,15627856,21000,10030000000,21000,0,2,0,0x6dfc34609a05bC22319fA4Cce1d1E2929548c0D7,0xc93ABCE5639a9B874955D539618be63782a14703
3779,15627856,21000,10001672600,21000,0,2,17372,0x53816484DcD7E40F4F919DE167b6A59248dD34A9,0x07EF60deCa209Ea0F3f3f08C1aD21a6DB5EF9D33
3780,15627856,207128,9958334261,206532,596,138,3199173,0xdAC17F958D2ee523a2206206994597C13D831ec7,0x9696f59E4d72E237BE84fFD425DCaD154Bf96976
3781,15627856,111168,9958334261,110964,204,74,135,0x5D004ddB5D92938dAF8448b9eac1CaA593cd26Ca,0x7Caa7cb787a9DBb15e23a67aFCE8bc411CBc74c4
3782,15627856,207128,9958334261,206520,608,138,4468941,0xdAC17F958D2ee523a2206206994597C13D831ec7,0x21a31Ee1afC51d94C2eFcCAa2092aD1028285549
3783,15627856,207128,9958334261,206460,668,138,4468942,0x25f8087EAD173b73D6e8B84329989A8eEA16CF73,0x21a31Ee1afC51d94C2eFcCAa2092aD1028285549
3784,15627856,141983,9958334261,136051,5932,1738,59,0xDef1C0ded9bec7F1a1670819833240f027b25EfF,0xcc8992DcA072330ACC2E0DCC13d67edf27ddCf32
3785,15627856,28554,9958334261,28490,64,10,6,0x19A4e33581c3b0ded84E6ce3Ba8515a4D45b5001,0xFE4E1E81081d7A351C3617626476cE571d10764E
3786,15627856,47875,9958334261,47267,608,138,65,0x2260FAC5E5542a773Aa44fBCfeDf7C193bc2C599,0xc8E063FF9881781156D550b304c79C3A4867CB7d
3787,15627856,39603,9958334261,39351,252,74,123,0xC02aaA39b223FE8D0A0e5C4F27eAD9083C756Cc2,0xB733162a2C281B85274Fa634cD21EC4D86dD583c
3788,15627856,55978,9958334261,55034,944,138,2253,0xd4cB651749953988647eEE9b51DDB8DB5aeb3410,0x06Fd390060Ab47e6962eFD54aa51819FaE164878
3789,15627856,140088,9958334261,138524,1564,394,1317,0x1Fa8559e873f698292766790AeCf8080A66433F6,0x4642D9D9A434134CB005222eA1422e1820508d7B
3790,15627856,207128,9958334261,206520,608,138,1312152,0xA0b86991c6218b36c1d19D4a2e9Eb0cE3606eB48,0xf60c2Ea62EDBfE808163751DD0d8693DCb30019c
3791,15627856,39603,9958334261,39351,252,74,48,0xC02aaA39b223FE8D0A0e5C4F27eAD9083C756Cc2,0x0565df3f5aad5a45D340B98D1e95F255e238cDc3
3792,15627856,21000,9958334261,21000,0,2,72342,0xC4dA28888949268A08Ea4441D65D7E49ea8F22cd,0xab97925eB84fe0260779F58B7cb08d77dcB1ee2B
3793,15627856,140088,9958334261,138524,1564,394,85,0x1Fa8559e873f698292766790AeCf8080A66433F6,0x56E88FFdBd822DB2E85F97C70835Ca6Df2928a53
3794,15627856,140088,9958334261,138524,1564,394,116,0x1Fa8559e873f698292766790AeCf8080A66433F6,0x0A3A97128b69A2bb1cF7213C146807B416d7184B
3795,15627856,140088,9958334261,138524,1564,394,129,0x1Fa8559e873f698292766790AeCf8080A66433F6,0x18f52F45A11F8209dcEe5516853D586e2Fd17AB9
3796,15627856,55897,9958334261,54953,944,138,64,0x4da08a1Bff50BE96bdeD5C7019227164b49C2bFc,0xE170dA9eA20A5D01ae045ad7C77958Efc63f977b
3797,15627856,140088,9958334261,138524,1564,394,129,0x1Fa8559e873f698292766790AeCf8080A66433F6,0xbA8aF0EfD302912F3C0b86F1515ff6c0e8DC1c5e
3798,15627856,140088,9958334261,138524,1564,394,184,0x1Fa8559e873f698292766790AeCf8080A66433F6,0x97778A9765Afd22628492d3CEd63F315a90b08FA
3799,15627856,140088,9958334261,138524,1564,394,82,0x1Fa8559e873f698292766790AeCf8080A66433F6,0x9A77e4300bc214F8172Eb6A1e45DE8f7f837130f
3800,15627856,140088,9958334261,138524,1564,394,38,0x1Fa8559e873f698292766790AeCf8080A66433F6,0x49046cFDfBb7db6F0153Ae35244C84C812559B6A
3801,15627856,140088,9958334261,138524,1564,394,56,0x1Fa8559e873f698292766790AeCf8080A66433F6,0xeC11A96D31f4A94D944db9E5a184de02033f3B5b
3802,15627856,140088,9958334261,138524,1564,394,37,0x1Fa8559e873f698292766790AeCf8080A66433F6,0xc89777565E8E2E47148428351C25F3341d6D95ac
3803,15627856,140073,9958334261,138521,1552,394,102,0x1Fa8559e873f698292766790AeCf8080A66433F6,0x51AdF810b64CAeF8863C4E193AD2f22c285F9700
3804,15627856,140088,9958334261,138524,1564,394,63,0x1Fa8559e873f698292766790AeCf8080A66433F6,0xf35de8A66c78e260e7CAFaEf199Eddd1523168f1
3805,15627856,140088,9958334261,138524,1564,394,34,0x1Fa8559e873f698292766790AeCf8080A66433F6,0x5025aa046E1b92bA78A53E4b2D88DFCA273d71bb
3806,15627856,21000,9958334261,21000,0,2,9,0x38caC02fa366bA22de30A375696b1f35850A3EfC,0x1F3fd161f3730aF8410E1258ff804D7913C6f7C2
3807,15627856,140088,9958334261,138524,1564,394,42,0x1Fa8559e873f698292766790AeCf8080A66433F6,0x1D9cb883c3b9083fa4Ad71828824cC56e2d5a69d
3808,15627856,140073,9958334261,138521,1552,394,120,0x1Fa8559e873f698292766790AeCf8080A66433F6,0xbD85b2C2eaFDBe27027C47B9ce3433dC05Bdd2A8
3809,15627856,140088,9958334261,138524,1564,394,37,0x1Fa8559e873f698292766790AeCf8080A66433F6,0x91974Ba06274AEE0D38d2ba92a29AE395980E442
3810,15627856,140088,9958334261,138524,1564,394,38,0x1Fa8559e873f698292766790AeCf8080A66433F6,0x5A6D34D9bb93208cB81557cd68F8Ffc27A8Dcd56
3811,15627856,140088,9958334261,138524,1564,394,37,0x1Fa8559e873f698292766790AeCf8080A66433F6,0x16F767e7E86F74C0A51e78CD90ed0244fd96FD07
3812,15627856,140088,9958334261,138524,1564,394,36,0x1Fa8559e873f698292766790AeCf8080A66433F6,0x37845bc99d6C52EBb7b2CB4d82b5ea48EF8E912A
3813,15627856,140088,9958334261,138524,1564,394,66,0x1Fa8559e873f698292766790AeCf8080A66433F6,0x0131073B768F34b197B1C6DcB03A50A261859F91
3814,15627856,140088,9958334261,138524,1564,394,26,0x1Fa8559e873f698292766790AeCf8080A66433F6,0x95374F65F3D140673Bf4A116e5C87C966D5126dA
3815,15627856,140073,9958334261,138521,1552,394,34,0x1Fa8559e873f698292766790AeCf8080A66433F6,0x41158b5b055Ca84Fc592EB245a38bECd2A7641fB
3816,15627856,140088,9958334261,138524,1564,394,71,0x1Fa8559e873f698292766790AeCf8080A66433F6,0xC75c47EFE37bB48Eb5e470f28806DB7921E26Cc8
3817,15627856,48764,9958334261,47820,944,138,12,0x7D1AfA7B718fb893dB30A3aBc0Cfc608AaCfeBB0,0xC85cD10Df97Ab6Bff0debcD8ff080c12A5c53EC5
3818,15627856,253227,9958334261,248007,5220,1484,13,0x881D40237659C251811CEC9c364ef91dC08D300C,0xC85cD10Df97Ab6Bff0debcD8ff080c12A5c53EC5
3819,15627856,131198,9958334261,125114,6084,1682,417,0x00000000006c3852cbEf3e08E8dF289169EdE581,0x6A03fd28637846fdaB46c72e656987e5b923C7aB
3820,15627856,68864,9958334261,68528,336,74,70,0xB4a81261b16b92af0B9F7C4a83f1E885132D81e4,0x5012e2f6b9d81e96622BFA2F2764fcB406d8e6C1
3821,15627856,21000,9958334261,21000,0,2,15,0xB93CB628fA1fcb9D3C66abf70cB03a55607b8A93,0x73292DD3555F4b4aEB2Db7BfBb068F041a1bf704
3822,15627856,81429,9958334261,80485,944,138,50,0x7Fc66500c84A76Ad7e9c93437bFc5Ac33E2DDaE9,0x91478211Cf25a6a7C07435Df12b7b1CF9f8DcbD7
3823,15627856,410052,9958334261,406448,3604,1162,938,0x68b3465833fb72A70ecDF485E0e4C7bD8665Fc45,0x0ba08fd9bB14114e64EAeCb9371D149727C884d4
3824,15627856,46382,9958334261,45726,656,138,94,0xC631bE100F6Cf9A7012C23De5a6ccb990EAFC133,0xbbc75Ae41faB1A88bFC4BD17F77fdCDDf099c2Ac
3825,15627856,580850,9958334261,572210,8640,2186,51,0xe66B31678d6C16E9ebf358268a790B763C133750,0x91478211Cf25a6a7C07435Df12b7b1CF9f8DcbD7
3826,15627856,42000,9958334261,42000,0,2,329524,0xf28c95B49e297D2040055B152E9D6c855F5A7fB8,0x9430801EBAf509Ad49202aaBC5F5Bc6fd8A3dAf8
3827,15627856,178834,9924336310,176846,1988,522,48,0x53e0e51b5Ed9202110D7Ecd637A4581db8b9879F,0xB7acc40f65f259d3396E8DaCa57b2ccab2c5e770
3828,15627856,21000,9878375184,21000,0,2,5,0x01FA80E365BBd3c7c73274df7318dd86506505CB,0x4867DdB1b498D89f97763ed5Ff07d4f52Aad8223
3829,15627856,56500,9851986553,53568,2932,586,12,0x52dE8D3fEbd3a06d3c627f59D56e6892B80DCf12,0x3070e6bDeC0922f7C2511a63291Fdb616C78e89B
3830,15627856,70000,9797986072,69380,620,138,525,0xdAC17F958D2ee523a2206206994597C13D831ec7,0xf5491f793D47A6Ea22f5e0B9AD3990CF66c4b40B
3831,15627856,750000,9608334261,747680,2320,586,2149,0x9bC6369a2D947BdfAEdd74207d3589dbaFc48b52,0x1c1D80d30F6f96cD288d9fD3E267f253220fD7C7
3832,15627856,100000,9490217376,99380,620,138,45195,0xdAC17F958D2ee523a2206206994597C13D831ec7,0xa7fB5cA286Fc3FD67525629048a4de3bA24Cba2E
3833,15627856,1800000,9458334261,1798212,1788,458,217,0x7a250d5630B4cF539739dF2C5dAcb4c659F2488D,0xceB7Bc1098138e850195698F4Ff2726031CDe545
3834,15627856,1800000,9608334261,1798212,1788,458,218,0x7a250d5630B4cF539739dF2C5dAcb4c659F2488D,0xceB7Bc1098138e850195698F4Ff2726031CDe545
3835,15627856,1400000,9758334261,1399236,764,138,219,0x011b0beAe3eC5953B4805b064cC78f6F892A99cC,0xceB7Bc1098138e850195698F4Ff2726031CDe545
3836,15627856,1400000,9938334261,1399236,764,138,220,0x011b0beAe3eC5953B4805b064cC78f6F892A99cC,0xceB7Bc1098138e850195698F4Ff2726031CDe545
3837,15627856,21000,9458334261,21000,0,2,114,0x76B36fa9B4bC0fD574f8aBED7815F6968122c44F,0x0351b2FcC2458389dC88BE06EFb8560F72fC5255
3838,15627856,134862,9458334261,128298,6564,1802,71,0x00000000006c3852cbEf3e08E8dF289169EdE581,0x90FEdB809d30520C46977b55be9D1ef87C611EAB
3839,15627856,21000,9458334261,21000,0,2,64,0x76B36fa9B4bC0fD574f8aBED7815F6968122c44F,0x3d443A943be5D013b8da79A10d6Cd4273837C7c9
3840,15627856,21000,9458334261,21000,0,2,97,0x76B36fa9B4bC0fD574f8aBED7815F6968122c44F,0x4DbbC9278e589C5F0a975216F3E4CD51abE6385d
3841,15627856,21000,9458334261,21000,0,2,71,0x76B36fa9B4bC0fD574f8aBED7815F6968122c44F,0x7Df6281e95d28bfa988b87035691e4189523A3fa
3842,15627856,21000,9458334261,21000,0,2,81,0x76B36fa9B4bC0fD574f8aBED7815F6968122c44F,0x935a07601ecBA0ccFC07e2d3818b5fafecea53e2
3843,15627856,299359,9458334261,296159,3200,906,230,0x68b3465833fb72A70ecDF485E0e4C7bD8665Fc45,0xa7C1d32B4bB7155Ad5e9e53F472b9CE61BB37ddc
3844,15627856,21000,9458334261,21000,0,2,80,0x76B36fa9B4bC0fD574f8aBED7815F6968122c44F,0xE6142eab80A8409773E45d5D1b00daAeb5187b97
3845,15627856,46791,9458334261,46219,572,138,0,0x62cDAf466511888792c8C413239bAa70f57f1654,0x5482D76AAbaf54FBF18d82e0a3Fc447B0Dd005D6
3846,15627856,21000,9458334261,21000,0,2,1022,0x606bAec343eE305701844901e8952Eb32Efa7617,0xde52fF09ECac44BA59E652635059A3a307c33c9F
3847,15627856,163824,9458334261,157208,6616,1810,80,0x00000000006c3852cbEf3e08E8dF289169EdE581,0xAaa50E31aB7f23CeD16881430BF1f343E9C15ed2
3848,15627856,21000,9458334261,21000,0,2,75,0x05DaDf0dcC549C0ab2D16248E08cB397287638E4,0x38a404D2e859572fab457ad9AdF3cd2d4781d718
3849,15627856,151662,9458334261,145010,6652,1810,132,0x00000000006c3852cbEf3e08E8dF289169EdE581,0xDDF89eea7DC3393C76a8D6957DC15caCf59e2524
3850,15627856,21000,9458334261,21000,0,2,64,0x76B36fa9B4bC0fD574f8aBED7815F6968122c44F,0xFc13D653C3788c09DaaC02592cf78583DfE6FB06
3851,15627856,21000,9458334261,21000,0,2,29,0xc623483a440A6Fb5C0D41f8E30a9F3dF49a237Ad,0xEF230BfBCC182dA029Bb4867c323E171741eAbf9
3852,15627856,21000,9458334261,21000,0,2,78,0x76B36fa9B4bC0fD574f8aBED7815F6968122c44F,0x55B3f5ea72e626324A4D02aB5306b5E81B4bF04D
3853,15627856,21000,9458334261,21000,0,2,209,0x76B36fa9B4bC0fD574f8aBED7815F6968122c44F,0x58D90f249ee09f7f8F282B83bE30f84F56F8663e
3854,15627856,273853,9458334261,266985,6868,1810,617,0x00000000006c3852cbEf3e08E8dF289169EdE581,0x44CbDb1979FbC26Fc72156959191f322005E8F37
3855,15627856,21000,9458334261,21000,0,2,72,0x76B36fa9B4bC0fD574f8aBED7815F6968122c44F,0x3063afA2e6115313b95E78A75911fb68D1F5a0b0
3856,15627856,102226,9458334261,102010,216,74,717,0x64Ad353BC90A04361c4810Ae7b3701f3bEb48D7e,0xC7b72Bb1aCDcE3eB45f9B38F43cD31e4927C725b
3857,15627856,21000,9458334261,21000,0,2,66,0x76B36fa9B4bC0fD574f8aBED7815F6968122c44F,0x1Ef81542D453a6C6347b94f42a01aE15156187e7
3858,15627856,93806,9458334261,91710,2096,906,193,0x726E1d384124e0A0c65602c350d581f2318228b8,0x24BcC4F72B185C4a344AC8Dd7B9ae0f57D677C53
3859,15627856,21000,9458334261,21000,0,2,62,0x76B36fa9B4bC0fD574f8aBED7815F6968122c44F,0xA00C45cA3A73673d10542C9a15CFD138715eDA24
3860,15627856,46157,9458334261,45669,488,138,1,0xEb4e856F69158052aC0AaF7Dc26f63DCb1ee067F,0x99D210b7cE59afB714a873FaE654DFC3511cfE2A
3861,15627856,213601,9458334261,209985,3616,1162,196,0x68b3465833fb72A70ecDF485E0e4C7bD8665Fc45,0x3dE360223Ee281E7baEA41CB9BaAc4DdE16eD157
3862,15627856,21000,9458334261,21000,0,2,39,0x9F96c987f70aa929118e6B333e36a06742785806,0x450423ddFf2125B52EC524c8ec35B46552054aBc
3863,15627856,77745,9458334261,77089,656,138,9,0x6B175474E89094C44Da98b954EedeAC495271d0F,0xE7949D6E52b3E49Bb3D15F8e93600585FCbD8E15
3864,15627856,21000,9458334261,21000,0,2,44,0x76B36fa9B4bC0fD574f8aBED7815F6968122c44F,0xc14351FCEC96B5D0C56bF428879f62E5a0f789af
3865,15627856,166082,9458334261,164034,2048,522,18,0xd9e1cE17f2641f24aE83637ab66a2cca9C378B9F,0x1E759C0af530cc66D0E0283Aa0748a79Dc9228DF
3866,15627856,21000,9458334261,21000,0,2,47,0x76B36fa9B4bC0fD574f8aBED7815F6968122c44F,0x71DD37118A798469a4FCc6b648De62dda5964Dcb
3867,15627856,21000,9458334261,21000,0,2,41,0x76B36fa9B4bC0fD574f8aBED7815F6968122c44F,0x660f144201B5592EB114F3aC32004C4D934BDdCa
3868,15627856,689781,9458334261,686141,3640,1162,1456,0x68b3465833fb72A70ecDF485E0e4C7bD8665Fc45,0x43C1Bf1a33506d2d3f023a1F354e608e7784aC46
3869,15627856,46061,9458334261,45573,488,138,239,0xa44572bc8A17f1d838781A251E709D4489D96d58,0x8694918FFA878B8b53c54c11DF41f7BC574Fb2fd
3870,15627856,21000,9458334261,21000,0,2,44,0x76B36fa9B4bC0fD574f8aBED7815F6968122c44F,0xC3B344e907FAb6a2E12264F5f8CbCD7B550ad4c8
3871,15627856,21000,9458334261,21000,0,2,161,0x0cE67E3f5B9378525fEBEcE5A9fB8E57BEF118D4,0xd3864619f41126760A213da2499cc55A25020683
3872,15627856,46193,9458334261,45621,572,138,247,0xF7b8aabC98D169020b9EE716FC55541cF3e8B55B,0xE426a520d0Cbee2C76098fD9cdAf20036C20D0A7
3873,15627856,203619,9458334261,197055,6564,1802,15,0x00000000006c3852cbEf3e08E8dF289169EdE581,0x49cdDbB3802BE89E6a115aC29117125aC25A2fBb
3874,15627856,146738,9458334261,140174,6564,1802,585,0x00000000006c3852cbEf3e08E8dF289169EdE581,0x43cBefC7b3e000Dc7B01C958B26daBf9D3B67198
3875,15627856,41145,9458334261,33725,7420,2506,430,0x00000000006c3852cbEf3e08E8dF289169EdE581,0x6Bc5A51d2335F8f86Cc1065Cf58E4273eb9D6A87
3876,15627856,150805,9458334261,144153,6652,1810,67,0x00000000006c3852cbEf3e08E8dF289169EdE581,0xacA2630e13FA29336D1833b53a030Eb685E237D3
3877,15627856,21000,9458334261,21000,0,2,44,0x76B36fa9B4bC0fD574f8aBED7815F6968122c44F,0x018FBA7700a9Be07bFC146f9B7E3dB2332bFd962
3878,15627856,21000,9458334261,21000,0,2,44,0x76B36fa9B4bC0fD574f8aBED7815F6968122c44F,0xa56aC0F0AAf05B5ded4835D896064252bc809535
3879,15627856,21000,9458334261,21000,0,2,42,0x76B36fa9B4bC0fD574f8aBED7815F6968122c44F,0x4C0F00F51d8387570451046197ecc87182244Ab4
3880,15627856,21000,9458334261,21000,0,2,46,0x76B36fa9B4bC0fD574f8aBED7815F6968122c44F,0xC5e76028Dd2Cc70C46310AA58426489a3Db3e03b
3881,15627856,73188,9458334261,72580,608,138,179,0xA0b86991c6218b36c1d19D4a2e9Eb0cE3606eB48,0xC2606254E1c3bD456B19650c9488F031823a8c77
3882,15627856,21000,9458334261,21000,0,2,42,0x76B36fa9B4bC0fD574f8aBED7815F6968122c44F,0x218698cBf5F9f2227F2C3f8Bc7B4bF70003B8D38
3883,15627856,21000,9458334261,21000,0,2,1223,0xC8201d8675471478EDebfF5a6df0EEc9F36d3eBe,0x82E013B3c3c678B0A7141894D336a819FDe9d974
3884,15627856,232580,9458334261,228976,3604,1162,12,0x68b3465833fb72A70ecDF485E0e4C7bD8665Fc45,0xd8Efe6bc32371e3a8166c1360B9af675d05b0fd0
3885,15627856,393085,9458334261,381737,11348,2058,2549,0x23E79722Bb8B55a0d04f3AFbCFC34eb771526Adb,0x9b1acD4336EBF7656f49224d14A892566fd48e68
3886,15627856,21000,9458334261,21000,0,2,94,0xF68fED943a3FB3df7E8837fd2E3264Db0b777dFC,0xe585F35eA9AA561CBa85b40f3B4bAeCC1Df6315E
3887,15627856,72878,9458334261,71006,1872,458,159,0xFbdDaDD80fe7bda00B901FbAf73803F2238Ae655,0xB78F8440a21a3128439BE04ac257703EE549a41E
3888,15627856,21000,9458334261,21000,0,2,41,0x76B36fa9B4bC0fD574f8aBED7815F6968122c44F,0x5A6F2a16A2CCC60A1399C79bd9377ddFeA894C7E
3889,15627856,46158,9458334261,45670,488,138,257,0x517e643F53EB3622Fd2c3A12C6BFde5E7Bc8D5ca,0xeEfbADa5539f9ae2c87C1151Cdb2057398383342
3890,15627856,179593,9458334261,178625,968,330,489,0x5ebFD58C5eAd1025755F7490e510cCf2C0b4a444,0x478877398f91919892842928DED5Ce1D73649046
3891,15627856,237621,9458334261,234825,2796,842,818,0x68b3465833fb72A70ecDF485E0e4C7bD8665Fc45,0xBE1773e5d8b16a86a6c99d7833359C835Be9E4F5
3892,15627856,65329,9458334261,64377,952,202,20,0x61CEcE14E222385D5aC83f3d0cbd518f5fEB3559,0x5630bab8549Aaaf78435023c389c586aA0c356Ae
3893,15627856,84961,9458334261,84757,204,74,201,0x55f1C36Bb7aE0d7D6caE97902E30A2306686Ec73,0x5bAB06Aab8aEcD0E60c8287391233F2285ad7071
3894,15627856,348870,9458334261,343042,5828,1674,3546,0x59728544B08AB483533076417FbBB2fD0B17CE3a,0xa53496B67eec749ac41B4666d63228A0fb0409cf
3895,15627856,181476,9458334261,179912,1564,394,496,0x1Fa8559e873f698292766790AeCf8080A66433F6,0xd582a0530a1E5AEE63052a68aa745657A8471504
3896,15627856,400000,9458334261,377372,22628,7818,139,0x00000000006c3852cbEf3e08E8dF289169EdE581,0xe7212b0A006B52b1b0Bf3f8e7BAe55c2Cd678e35
3897,15627856,118165,9458334261,117713,452,138,343,0x0000000000085d4780B73119b644AE5ecd22b376,0x5912e6c2A1d9FB496a80e77a7c6926f8Aa919cb4
3898,15627856,159906,9458334261,153254,6652,1810,442,0x00000000006c3852cbEf3e08E8dF289169EdE581,0x3aF30A90973f099479da40AC52ECc39B76e376CF
3899,15627856,21000,9458334261,21000,0,2,2,0x32bc4c243Fd95d286Ef477B7bD7463DED7f836F6,0x1D8CaE026c77dE3620daD360a61959f2875C8Bd4
3900,15627856,21000,9458334261,21000,0,2,76,0x205F7F4c423EF775DA69f79af2907c5faAe3263E,0x38a404D2e859572fab457ad9AdF3cd2d4781d718
3901,15627856,46267,9458334261,45691,576,74,44,0x283Af0B28c62C092C9727F1Ee09c02CA627EB7F5,0x80626F32C252EB332C1963F21836969f6c03629E
3902,15627856,207811,9458334261,207339,472,202,23,0xC549d87E9CEA28961927436a2B7D6944f7CA86eb,0x389d96a6eE133EdA37138d63b10EB7Cf614AD6e5
3903,15627856,689796,9458334261,686144,3652,1162,3071,0x68b3465833fb72A70ecDF485E0e4C7bD8665Fc45,0xFcaE89f3319C760d4F481A522aa717AF81e93E77
3904,15627856,21000,9458334261,21000,0,2,219,0x55684b89adF372CC3091975633bD7128da3a46Bc,0x25Db358bC61676E099F2F432e6eDe38194171Df6
3905,15627856,535062,9458334261,531922,3140,906,21,0x68b3465833fb72A70ecDF485E0e4C7bD8665Fc45,0xB715cdB77806d154D4cEf39B7374f98054Bcc298
3906,15627856,52906,9458334261,52250,656,138,10,0x12b6893cE26Ea6341919FE289212ef77e51688c8,0x9afEf63384A707f8ba9AC4F09638267C6135091F
3907,15627856,21000,9458334261,21000,0,2,164,0x284BcE1836454341186056F8DBd424238Fc5a537,0x5E14f28F217cA7e20A4108e08C91686fBdd912D5
3908,15627856,21000,9458334261,21000,0,2,646,0xf6a7c1D8dF3B2f32775a9886EA496f3B54E75436,0x103246339988c3A3eC32086A179d6D6b8dE34c4F
3909,15627856,21000,9458334261,21000,0,2,150,0x30DCe637FeEDe6dB6Dd10aBef708eb012b7eEbBB,0x2c86e7762EF9B084Bf0dE15CD094F1311397dAC9
3910,15627856,207705,9458334261,190753,16952,4362,417,0x00000000006c3852cbEf3e08E8dF289169EdE581,0xB8ef7f2082a0783aef1a8F85ecf89f06CD94F812
3911,15627856,187909,9458334261,181209,6700,1810,143,0x00000000006c3852cbEf3e08E8dF289169EdE581,0xd99881A272e14666a5b4394f9deeb383fa05F38B
3912,15627856,52180,9458334261,51536,644,138,217,0xC0B376f1887b00b66De12cD0741618FCaAA6D47d,0xA57f1e4d7f08E5F4880E293A51d8bF3BdaFb44e2
3913,15627856,276189,9458334261,256649,19540,4690,235,0x00000000006c3852cbEf3e08E8dF289169EdE581,0x790878D7167cff1c27cb5Fd59d708359be57bFf6
3914,15627856,46744,9458334261,46172,572,138,92,0xC86664e7d2608f881f796ee8E24FA9d4d7598406,0x79d59e047b163C40d6A842ccE6D9F0BfCb91c69F
3915,15627856,589742,9458334261,586066,3676,1162,829,0x68b3465833fb72A70ecDF485E0e4C7bD8665Fc45,0xb19AD65C65C6c12C6dCe444F740449714A488A7F
3916,15627856,69256,9458334261,68312,944,138,402,0x70fc957eb90E37Af82ACDbd12675699797745F68,0x1CeD4e3900c73A54eD775ef2740a4e38aC5b54e2
3917,15627856,95864,9458334261,95660,204,74,963,0x7F9306FC1978938d5C1C57Bf6044dc67E07eeB8a,0x5A776Ea5e89d6F4504b208A6BD459D912A2ee22e
3918,15627856,55978,9458334261,55034,944,138,44,0xd4cB651749953988647eEE9b51DDB8DB5aeb3410,0xc9E9768cC2b993a5D3707c5Dc569C5A92157F115
3919,15627856,41297,9458334261,41021,276,74,34,0x19Db87284563aF276605e04f82D1a41073Bc3Db2,0xA58Df0CCEC971A9049D313535508e29d0C388509
3920,15627856,91918,9458334261,90490,1428,458,164,0x5FeC546f8040dF6F09b6035cEF489e4E3E89AB41,0x4372131C82b5771E40c5be2aff671D5de349BF16
3921,15627856,21000,9360000000,21000,0,2,2,0x850Eb0195a28e202fDEc9aDe2cc6511c69d6142D,0x3A7542E7AC843539D8E17765a06C168d8113043e
3922,15627856,62303,9260000000,61611,692,138,1,0x95aD61b0a150d79219dCF64E1E6Cc01f0B64C4cE,0x2374057422373710830Bacd7DE101DAa19160dfa
3923,15627856,65000,9248346556,64392,608,138,646167,0xdAC17F958D2ee523a2206206994597C13D831ec7,0x29D5527CaA78f1946a409FA6aCaf14A0a4A0274b
3924,15627856,353720,9176882468,335264,18456,5906,520,0x1111111254fb6c44bAC0beD2854e76F90643097d,0xB7B10292EE6c5828b20eB0942C8c1275E8344800
3925,15627856,58676,9101334261,57732,944,138,865,0xdAC17F958D2ee523a2206206994597C13D831ec7,0xA5D62640081d2a1bc5deD398F2AA5aC6e463746b
3926,15627856,100000,9000000000,100000,0,2,270668,0x02253696Fb57D3142D8f30616BD29afa407Da232,0x23f4569002a5A07f0Ecf688142eEB6bcD883eeF8
3927,15627856,65084,8960000000,64440,644,138,5,0x0F5D2fB29fb7d3CFeE444a200298f468908cC942,0x3e3Fd307Ee520Ad5896D1603D21BF5fc2dd94F5A
3928,15627856,21000,8958334261,21000,0,2,113042,0xf19E2011cA4BD89251CdF5AA8BD7E6b1C562b077,0x6081258689a75d253d87cE902A8de3887239Fe80
3929,15627856,175110,8958334261,173546,1564,394,69,0x1Fa8559e873f698292766790AeCf8080A66433F6,0xBCC483aA03FCb5C6F7c70983978bA9ADCD883B35
3930,15627856,135730,8958334261,135526,204,74,118,0x4556561740B7B5F858967A6a4E54e506609704Bd,0x47223d981080040f5eDB7145AC8Ed5901dfe1822
3931,15627856,295084,8958334261,289468,5616,1802,160,0x68b3465833fb72A70ecDF485E0e4C7bD8665Fc45,0xb46474ED447403367b6fB561B353C1C5995f059F
3932,15627856,186874,8958334261,183258,3616,1162,7,0x68b3465833fb72A70ecDF485E0e4C7bD8665Fc45,0xEe2439BF2434bB3849B3c86357CD493BaECdd39d
3933,15627856,181476,8958334261,179912,1564,394,2202,0x1Fa8559e873f698292766790AeCf8080A66433F6,0xfaf9f55E72d088f68cc01B2fF505ABc11f6597b9
3934,15627856,920028,8958334261,863152,56876,8778,1147,0x5ebFD58C5eAd1025755F7490e510cCf2C0b4a444,0x76dAf1C2F327c81fe4d32F3231d27b4A4B9EAe2c
3935,15627856,21000,8958334261,21000,0,2,113043,0x88C8aC55FBC5180AA5cBf069686AAf36c066744d,0x6081258689a75d253d87cE902A8de3887239Fe80
3936,15627856,181476,8958334261,179912,1564,394,3607,0x1Fa8559e873f698292766790AeCf8080A66433F6,0x9308c261Dc19178a8b81C07b80CaaDe0fF057f6e
3937,15627856,21000,8958334261,21000,0,2,414,0xD710c25b900C6827352001c98aDFf4E702533eFC,0x3E4735EDb07bB9Ab63eC9aF56E480AdF20d0125e
3938,15627856,69400,8958334261,68824,576,74,105,0x283Af0B28c62C092C9727F1Ee09c02CA627EB7F5,0xc40456ee3Ce933b81D9be4D68d964Eeb1F684298
3939,15627856,232483,8958334261,231495,988,202,1490,0x88ad09518695c6c3712AC10a214bE5109a655671,0xbae6F47Ec72AA3c8B09F442b35f981E587796666
3940,15627856,181476,8958334261,179912,1564,394,247,0x1Fa8559e873f698292766790AeCf8080A66433F6,0x7538246BF734d841b28664D8f135B96aE435Cd45
3941,15627856,181476,8958334261,179912,1564,394,7094,0x1Fa8559e873f698292766790AeCf8080A66433F6,0x0457bDD7d70c82f4cb1C850bd49064a544630978
3942,15627856,30109,8900000000,30109,0,2,3,0xfabe3fcF983B6A2A063e0e5466d4B02513325279,0x68286F847071a768672C5BE7DfB4985303344A9c
3943,15627856,261531,8895679036,260167,1364,402,90,0x1111111254fb6c44bAC0beD2854e76F90643097d,0xBdA4BeeB477F9505404760661A1C9016460a8C83
3944,15627856,21000,8800000000,21000,0,2,0,0xFD037C57aEc63C5c3EcAe12b5539Ea76eCaCA808,0x66630274cc89E7ADDa02238dd5Ca55242287930E
3945,15627856,48506,8393257258,47530,976,202,890827,0xdAC17F958D2ee523a2206206994597C13D831ec7,0x340d693ED55d7bA167D184ea76Ea2Fd092a35BDc
3946,15627856,21000,10245679439,21000,0,2,890828,0x62E490CBBc2Df70163385642497043f20F5dAA9e,0x340d693ED55d7bA167D184ea76Ea2Fd092a35BDc
3947,15627856,80000,8393257258,79056,944,138,0,0x4Fabb145d64652a948d72533023f6E7A623C7C53,0x52E454866C33B56e7D085cfD3a9Efbb23d85e735
3948,15627856,191113,8393257258,190189,924,266,414,0xd588b586D61C826A0e87919b3D1a239206d58bf2,0xd7188770a2962C73CCBc8A451455a29bD38FD965
3949,15627856,80000,8393257258,79056,944,138,0,0xA0b86991c6218b36c1d19D4a2e9Eb0cE3606eB48,0xeD522c3B01052703bCdbCFe56105d6569b217Fa0
3950,15627856,102513,8393257258,100157,2356,586,590,0x75cdA57917E9F73705dc8BCF8A6B2f99AdBdc5a5,0x2EEE62f7501A9b4Fd0ef6bbDAa27E6444F3A81d4
3951,15627856,21000,8393257258,21000,0,2,63,0x171c225874db90212c4C6ea887CA3ce11a92dD6D,0xAb792a852B9f849849aB11711FF97eaF9b9C29f7
3952,15627856,90000,8245228626,89404,596,138,119,0xA0b86991c6218b36c1d19D4a2e9Eb0cE3606eB48,0x870402B7f7363Efb4CCAC3471346cF748374d3C6
3953,15627856,21000,8245228626,21000,0,2,1,0xBCBc13214819A352014b6070FfE6A8733Bcca2A9,0xF5409E2F40Be0E97751377d6EbDd8747fe04F94a
3954,15627856,69163,8167397840,68555,608,138,64,0xdAC17F958D2ee523a2206206994597C13D831ec7,0x632F0f2AB8d792D8aFF9D9594BA3549C0c8724B4
3955,15627856,261434,8167397840,257782,3652,1162,47,0x68b3465833fb72A70ecDF485E0e4C7bD8665Fc45,0x8c7E6789d265F6B972d8dA5022885F4dd54bbC11
3956,15627856,94813,8167397840,94205,608,138,0,0xdAC17F958D2ee523a2206206994597C13D831ec7,0xA8F124991a745C87e2B60a9992Ac18677007E3fC
3957,15627856,150756,8167397840,150692,64,10,4,0x65c2e54a4c75ff6da7b6B32369c1677250075fb2,0xE9122386877627436E423a00A9C7F9D3B1664078
3958,15627856,349951,8145803216,164687,185264,23376,183244,0x5E4e65926BA27467555EB562121fac00D24E9dD2,0x6887246668a3b87F54DeB3b94Ba47a6f63F32985
3959,15627856,80000,8017479201,79056,944,138,0,0x95aD61b0a150d79219dCF64E1E6Cc01f0B64C4cE,0xE68d26776c20c968e3693903A477B2B7187322f1
3960,15627856,66836,7969073189,65892,944,138,15,0xA0b86991c6218b36c1d19D4a2e9Eb0cE3606eB48,0xE71814755D42816716097a6a2EEC5573Aab76768
3961,15627856,30000,7958334261,30000,0,2,3670,0x301407427168FB51bcc927b9FB76DCd88Fe45681,0xF2f5C73fa04406b1995e397B55c24aB1f3eA726C
3962,15627857,186044,8510880082,185280,764,138,123118,0x000000000035B5e5ad9019092C665357240f594e,0x38563699560e4512c7574C8cC5Cf89fd43923BcA
3963,15627857,876813,8767355021,829133,47680,14866,762,0x1111111254fb6c44bAC0beD2854e76F90643097d,0x41647a74673C90F4a13884bee4f8A89034FB85E8
3964,15627857,177401,760492781973,176257,1144,202,123119,0x000000000035B5e5ad9019092C665357240f594e,0x38563699560e4512c7574C8cC5Cf89fd43923BcA
3965,15627857,5049304,17000000000,5042216,7088,1098,283,0x0a39DA505DfB5E0BBc6bd84428281A8ba1bC7753,0x495E889d1A6cEB447a57dcc1C68410299392380c
3966,15627857,30000,14510880082,30000,0,2,626254,0x5F198f0Ec53627650fD1Abc1d4Fed31cAC63DfD9,0xB01cb49fe0D6D6E47EDf3A072d15dfe73155331C
3967,15627857,1500000,13510880082,1499056,944,138,1848,0x011b0beAe3eC5953B4805b064cC78f6F892A99cC,0x5666ba60D132EDf7341166eDB2e733d79B4BCDE2
3968,15627857,1500000,13510880082,1499056,944,138,1208,0x011b0beAe3eC5953B4805b064cC78f6F892A99cC,0x9EaD5FBDB0855C8993693bBFf3e61f0cD3a1e614
3969,15627857,1500000,13510880082,1499056,944,138,953,0x011b0beAe3eC5953B4805b064cC78f6F892A99cC,0x47919F5C115358caBBb989b09DEB55520dEF2702
3970,15627857,131662,8510880082,131062,600,80,5184,0x00000000A991C429eE2Ec6df19d40fe0c80088B8,0x77ad3a15b78101883AF36aD4A875e17c86AC65d1
3971,15627857,186060,8895679036,182796,3264,1034,130,0x68b3465833fb72A70ecDF485E0e4C7bD8665Fc45,0xC730d85a7CeB1a1a865D4f6235078e4Be3EcaCc8
3972,15627857,99236,26141239398,98316,920,120,5185,0x00000000A991C429eE2Ec6df19d40fe0c80088B8,0x77ad3a15b78101883AF36aD4A875e17c86AC65d1
3973,15627857,191041,13000000000,190165,876,266,1389,0xd588b586D61C826A0e87919b3D1a239206d58bf2,0xC22d03e13B888Dabb33A1575e4F6542f0e996622
3974,15627857,350000,12367842939,350000,0,2,6925039,0x4eBf7489301FC3298B372164046AD3f7B0A0cC69,0x46340b20830761efd32832A74d7169B29FEB9758
3975,15627857,350000,12026218802,349392,608,138,6925040,0xdAC17F958D2ee523a2206206994597C13D831ec7,0x46340b20830761efd32832A74d7169B29FEB9758
3976,15627857,350000,12026218802,350000,0,2,6925041,0x1e720251f62CB8A60C4503fbb9fBeDFEAFF97E32,0x46340b20830761efd32832A74d7169B29FEB9758
3977,15627857,350000,12026218802,349320,680,138,6925042,0x95aD61b0a150d79219dCF64E1E6Cc01f0B64C4cE,0x46340b20830761efd32832A74d7169B29FEB9758
3978,15627857,350000,12026218802,349344,656,138,6925043,0xd26114cd6EE289AccF82350c8d8487fedB8A0C07,0x46340b20830761efd32832A74d7169B29FEB9758
3979,15627857,350000,12026218802,350000,0,2,6925044,0x2687Ef59900D46CcbC4DA0A426CA3e3B1e69Ed80,0x46340b20830761efd32832A74d7169B29FEB9758
3980,15627857,350000,12026218802,350000,0,2,6925045,0x3A6D4c682E5f23c5782a5a8444Bc6f716e91b528,0x46340b20830761efd32832A74d7169B29FEB9758
3981,15627857,222222,12000000000,220658,1564,394,253,0x1Fa8559e873f698292766790AeCf8080A66433F6,0xc367979143697bCBde8B1Cedee33DB248721a93b
3982,15627857,21000,12000000000,21000,0,2,5,0x58C674c766426569a46796b90C4254Aff035D7C4,0xE27bec7682787985DC085E19c0Da1f4d569fEB64
3983,15627857,55926,11510880082,54982,944,138,2150,0x011b0beAe3eC5953B4805b064cC78f6F892A99cC,0x1c1D80d30F6f96cD288d9fD3E267f253220fD7C7
3984,15627857,21000,11224302431,21000,0,2,1569057,0x7Fc63D968908d1DAE98B22C86Ec39774e470be4e,0xAe45a8240147E6179ec7c9f92c5A18F9a97B3fCA
3985,15627857,21000,11224302431,21000,0,2,1569058,0x1845f2Ed09A6703BB012bCEb1Cac594D37E6C412,0xAe45a8240147E6179ec7c9f92c5A18F9a97B3fCA
3986,15627857,21000,11224302431,21000,0,2,1569059,0x9D4A2F18FeAfd33A1253b2Ea576BDcd7E64CF38C,0xAe45a8240147E6179ec7c9f92c5A18F9a97B3fCA
3987,15627857,675340,11010880082,674912,428,138,95,0x8332717a53B73ADb5897F473F54384956787A978,0x5f82b0e5cE654700d66Acf1E366A7f06C6ad866a
3988,15627857,675322,11010880082,674906,416,138,96,0x8332717a53B73ADb5897F473F54384956787A978,0x5f82b0e5cE654700d66Acf1E366A7f06C6ad866a
3989,15627857,675322,11010880082,674906,416,138,97,0x8332717a53B73ADb5897F473F54384956787A978,0x5f82b0e5cE654700d66Acf1E366A7f06C6ad866a
3990,15627857,675322,11010880082,674906,416,138,98,0x8332717a53B73ADb5897F473F54384956787A978,0x5f82b0e5cE654700d66Acf1E366A7f06C6ad866a
3991,15627857,675322,11010880082,674906,416,138,99,0x8332717a53B73ADb5897F473F54384956787A978,0x5f82b0e5cE654700d66Acf1E366A7f06C6ad866a
3992,15627857,200000,11010880082,199748,252,74,1357,0x4ed9C0dCa0479bC64d8f4EB3007126D5791f7851,0x06082441dBc4F3dEdec7E5C53507c28BDE682dD7
3993,15627857,675322,11010880082,674906,416,138,100,0x8332717a53B73ADb5897F473F54384956787A978,0x5f82b0e5cE654700d66Acf1E366A7f06C6ad866a
3994,15627857,800000,11010880082,796564,3436,1162,568,0x68b3465833fb72A70ecDF485E0e4C7bD8665Fc45,0x388F449450363dB5e169CCC9882C28539847aa8a
3995,15627857,146784,11010880082,146580,204,74,258,0x7F9306FC1978938d5C1C57Bf6044dc67E07eeB8a,0x7137fCC077A157946c26248a4ebB78732E38a447
3996,15627857,21000,11000000000,21000,0,2,68,0x389505f098a29a994A3ed0e674f07cd451dde42C,0x623b2f61D31ffEc4E598dd5eE565A22b3Bea7157
3997,15627857,21000,11000000000,21000,0,2,4,0x389505f098a29a994A3ed0e674f07cd451dde42C,0x6022F5Df2e72179C0A5D0ffB3886209299E9Cdd4
3998,15627857,21000,11000000000,21000,0,2,0,0x389505f098a29a994A3ed0e674f07cd451dde42C,0x20953420B2ca5C1BbbE72cd1d456FD277e4Fe79b
3999,15627857,21000,11000000000,21000,0,2,1,0x389505f098a29a994A3ed0e674f07cd451dde42C,0x07e9950161985e1594B1Ef69c9838B2089924bC3
4000,15627857,50000,11000000000,50000,0,2,718999,0x8ca51499937A5eDf04c7A9ab782274BaecCcbFe7,0xA4e5961B58DBE487639929643dCB1Dc3848dAF5E
4001,15627857,21000,11000000000,21000,0,2,93,0x389505f098a29a994A3ed0e674f07cd451dde42C,0xe5059db3F71aD7FEf95A0d7356fea3d638383c69
4002,15627857,21000,11000000000,21000,0,2,1,0x389505f098a29a994A3ed0e674f07cd451dde42C,0x7aAF34726e4739A40208982B96D67457d6E162C5
4003,15627857,21000,11000000000,21000,0,2,15,0x389505f098a29a994A3ed0e674f07cd451dde42C,0xf4A19f2fDF6FDAaD0F322ae3F9847BC05A1cd70A
4004,15627857,21000,11000000000,21000,0,2,51,0x389505f098a29a994A3ed0e674f07cd451dde42C,0x0bF00ceCDee690d52AF2ae311fD51a5dD049335D
4005,15627857,21000,11000000000,21000,0,2,9,0x56A7cf0AFc154a4c185a88Faee49357d1852E65B,0xE7116C50Bc64c1587B31236116D2FA692b6Ed520
4006,15627857,21000,11000000000,21000,0,2,4,0x389505f098a29a994A3ed0e674f07cd451dde42C,0x28cB5E44Fe9C47872041d7ae2Ab6b83BF6cE4caA
4007,15627857,21000,11000000000,21000,0,2,18,0x02dEC412310e7c019A73C7d7659470708FD81775,0x1F940B8fACeBE89fF2DC228CC9cBCC60Cdb079B1
4008,15627857,21000,11000000000,21000,0,2,36,0x552a85026f8114B46d270456CC00335160C44F1b,0x8Fb51D303C18fB6AB59a9781e98B213E1b8D4735
4009,15627857,21000,11000000000,21000,0,2,0,0x389505f098a29a994A3ed0e674f07cd451dde42C,0x9AB023674BE9eC5ca1E3451C975773f956945Eef
4010,15627857,49800,11000000000,49192,608,138,38,0xA0b86991c6218b36c1d19D4a2e9Eb0cE3606eB48,0xDA0821c6348E506b2056D7289e0E804D61094577
4011,15627857,49800,11000000000,49192,608,138,6,0xA0b86991c6218b36c1d19D4a2e9Eb0cE3606eB48,0x5E5B6D8704d5Fcf1915cAAe354A87455B19A45df
4012,15627857,21000,11000000000,21000,0,2,15,0x389505f098a29a994A3ed0e674f07cd451dde42C,0x5a0cADd8eEB39263B5C954848857939198cA24b5
4013,15627857,21000,11000000000,21000,0,2,8,0x389505f098a29a994A3ed0e674f07cd451dde42C,0x1A7fC4FFcd2B2D0236bD235E6F6c186F93c0d3F1
4014,15627857,242856,10613056098,240500,2356,586,28,0x53e0e51b5Ed9202110D7Ecd637A4581db8b9879F,0xBd65fF2AeE16f5ec6Fc8b5A164EE50c7B0e4d8a9
4015,15627857,146758,10510880082,140146,6612,1802,44,0x00000000006c3852cbEf3e08E8dF289169EdE581,0x78644036dd87DEF9fe66a95f58fB9D33f172454d
4016,15627857,21000,10510880082,21000,0,2,90,0xbaE1439Feae8Fa505ca13F6FcEDB7445F5Db1e1F,0x182Fdc233b94E3ADDA5F789D17ef2db774aE229c
4017,15627857,90000,10510880082,90000,0,2,93925,0xa1C802FBE6F9583d32e753134Fb4169005D09642,0xf89d7b9c864f589bbF53a82105107622B35EaA40
4018,15627857,234248,10510880082,231008,3240,1034,325,0x68b3465833fb72A70ecDF485E0e4C7bD8665Fc45,0xeD1B143fc65287ba9Fd10C4B5f09E32D1706526b
4019,15627857,255953,10510880082,251029,4924,1420,3,0x881D40237659C251811CEC9c364ef91dC08D300C,0x5aBFF9d99c04AAc50059aAEA2ef8CB4A9896F951
4020,15627857,21000,10510880082,21000,0,2,2759938,0xeD28992dAC78C5ee60b2447BfAB6F93150A99eF8,0x267be1C1D684F78cb4F6a176C4911b741E4Ffdc0
4021,15627857,42000,10510880082,42000,0,2,329525,0x0F8c1f8D25c7a577b08D83f5a225fb22Fe25b65B,0x9430801EBAf509Ad49202aaBC5F5Bc6fd8A3dAf8
4022,15627857,21000,10510880082,21000,0,2,4,0xED01c1a2B93749dD3d204D019986daBC2a36aFA7,0xD55A67937aE87b2cBff31fb56570fDD1d30c939f
4023,15627857,207128,10510880082,207128,0,2,4708697,0x7853fc7f9ED978d60b47Fae021CFf9Bc142983C4,0x28C6c06298d514Db089934071355E5743bf21d60
4024,15627857,207128,10510880082,207128,0,2,1679525,0xc5b4e6572287160669DA93098Cf9ce4d8dEA0830,0x4976A4A02f38326660D17bf34b431dC6e2eb2327
4025,15627857,207128,10510880082,206472,656,138,4468943,0x320623b8E4fF03373931769A31Fc52A4E78B5d70,0x21a31Ee1afC51d94C2eFcCAa2092aD1028285549
4026,15627857,207128,10510880082,206496,632,138,4232331,0x88dF592F8eb5D7Bd38bFeF7dEb0fBc02cf3778a0,0xDFd5293D8e347dFe59E90eFd55b2956a1343963d
4027,15627857,55978,10510880082,55034,944,138,1629,0xd4cB651749953988647eEE9b51DDB8DB5aeb3410,0x3ed83cc4C2fA5a66de778ca4C8A77FE66c42193E
4028,15627857,207128,10510880082,206460,668,138,4708698,0x320623b8E4fF03373931769A31Fc52A4E78B5d70,0x28C6c06298d514Db089934071355E5743bf21d60
4029,15627857,207128,10510880082,207128,0,2,4468944,0x54C3E7E0eA7faF2A6b909Dc2A98360B36fc6F145,0x21a31Ee1afC51d94C2eFcCAa2092aD1028285549
4030,15627857,753324,10510880082,744664,8660,2442,4103,0x68b3465833fb72A70ecDF485E0e4C7bD8665Fc45,0xaAa313393E79ea3454939e843E0AA8DEC66A9949
4031,15627857,207128,10510880082,206520,608,138,4232332,0xdAC17F958D2ee523a2206206994597C13D831ec7,0xDFd5293D8e347dFe59E90eFd55b2956a1343963d
4032,15627857,159498,10510880082,151946,7552,1162,48148,0x271682DEB8C4E0901D1a1550aD2e64D568E69909,0xd13b46290f61dB3E6638bE2746e88F0c04AB883F
4033,15627857,207128,10510880082,207128,0,2,3492275,0x9F3c6eE18275bD115A525500c16c2053866f9dC3,0x56Eddb7aa87536c09CCc2793473599fD21A8b17F
4034,15627857,207128,10510880082,207128,0,2,4232333,0xFc30c771c795b4d23A44B861d91A542365f21e33,0xDFd5293D8e347dFe59E90eFd55b2956a1343963d
4035,15627857,207128,10510880082,206532,596,138,4708699,0xdAC17F958D2ee523a2206206994597C13D831ec7,0x28C6c06298d514Db089934071355E5743bf21d60
4036,15627857,140926,10510880082,133374,7552,1162,48149,0x271682DEB8C4E0901D1a1550aD2e64D568E69909,0xd13b46290f61dB3E6638bE2746e88F0c04AB883F
4037,15627857,181476,10510880082,179912,1564,394,709,0x1Fa8559e873f698292766790AeCf8080A66433F6,0x646ef8b85fd521ab48f214330C563B7B3a15dAE4
4038,15627857,21000,10502756813,21000,0,2,1,0x54e301D503684e37fc48Dc2B2CD3CbB4C23f339d,0x6b8ba1A5F1F139Af4c5c1fEcb423987Aaff923e5
4039,15627857,367977,10340880082,360521,7456,2314,292,0xDEF171Fe48CF0115B1d80b88dc8eAB59176FEe57,0x17D065070486Ca0fC8b4B382b946BE79Fb4fF10D
4040,15627857,21000,10190000000,21000,0,2,705874,0xC150Efc715941acdf3458adB8a43ae0fD6f09ac2,0x6dfc34609a05bC22319fA4Cce1d1E2929548c0D7
4041,15627857,338841,10060880082,335653,3188,906,27,0x68b3465833fb72A70ecDF485E0e4C7bD8665Fc45,0x2d90Fa49f5BEFfE4Ce9Ba7e461B2D53E911FAEE6
4042,15627857,168480,10060728656,166748,1732,256,10684,0x30a123cBF79FdB6Ac10556B20531545DE0dA652B,0xB28eBE0eD76E01825483A723d21A6Ab29743cdDC
4043,15627857,328581,10021849001,319853,8728,2578,0,0x1111111254fb6c44bAC0beD2854e76F90643097d,0x88c762eE649C680325731b1899d022f0e37d34F8
4044,15627857,1000000,10010880082,998036,1964,522,10,0x7a250d5630B4cF539739dF2C5dAcb4c659F2488D,0x152619812C4fd6da35Ff18881d3123bFb0172653
4045,15627857,46859,10010880082,46371,488,138,42,0x197492CCB4B1acaAAcd43432657A17832E36AB49,0x1f90BCBCeb79c0E363990CFF6d8E1Fcaa1ACdc6E
4046,15627857,21000,10010880082,21000,0,2,2,0xb8c511dC5d5aB1Fc51Fa7a4b521f0F3DA0746c28,0x350D7e9d924434A1b63a60cc97589C83FA8ac517
4047,15627857,174526,10010880082,172466,2060,522,23,0xd9e1cE17f2641f24aE83637ab66a2cca9C378B9F,0x9a2BBc3a1b644Df5AD1E47D810A6Ce7397497115
4048,15627857,21000,10010880082,21000,0,2,0,0xD6D87Eeb421eEeb50bFF52f6aB35350C48B876Ed,0xec83D11BD8b6dc7d367347e3e86C49c88706e441
4049,15627857,46547,10010880082,46059,488,138,1718,0xaE351b8Ae55B69A5007618E598dDe89d0a092c37,0x6742DC28e16Fe31189EB111B1Ab6Bb953561b6B0
4050,15627857,146718,10010880082,140130,6588,1802,480,0x00000000006c3852cbEf3e08E8dF289169EdE581,0x263fd42F241E7ab5C2c03D1C01fcb90dc437bA2A
4051,15627857,257524,10010880082,238060,19464,4682,107,0x00000000006c3852cbEf3e08E8dF289169EdE581,0xFA5F446a75CFcF5D68857d7Fc3B9Cf3AD9efdedB
4052,15627857,92151,10010880082,92087,64,10,2,0x4Dbd4fc535Ac27206064B68FfCf827b0A60BAB3f,0xd0be1103772a529f050952422d32cCD2A3B564Be
4053,15627857,21000,10010880082,21000,0,2,28,0xc623483a440A6Fb5C0D41f8E30a9F3dF49a237Ad,0x1474C211e4c987037B4b6C8121Df40d60aa9186d
4054,15627857,163876,10010880082,157288,6588,1802,28,0x00000000006c3852cbEf3e08E8dF289169EdE581,0x56Aa3fe61A40d8D8d476253C47E488a26b507B36
4055,15627857,76136,10010880082,74780,1356,266,308,0x000000000000509081d6FCD3ee63e791aD1db763,0x8F1ce698746D93B06152066ED8DBE359245AbA65
4056,15627857,139466,10010880082,138654,812,330,237,0xb9D11c726cC183b5e08819BD5195Fe365F37C749,0xd8fd0ae6076B3D643543B7C7D386d5425bb48284
4057,15627857,55951,10010880082,55007,944,138,0,0x4764C1FdbfF66c62027Eb3f643c0BE27A1E84cd5,0xd95D30fd3e089816d14972B15d4dC4E2DF9D0cb4
4058,15627857,56659,10010880082,55715,944,138,2,0xAD13C2a8d418d01F3236F4d8b9d724575a4e9d24,0x93BeC5fBA7d947D3872827C451a73b05E4f17346
4059,15627857,594234,10010880082,590806,3428,1098,273,0x000000000000509081d6FCD3ee63e791aD1db763,0xc609ED8bD4384b0822267c9fE4Ac04F768FEE0Ca
4060,15627857,21000,10010880082,21000,0,2,77,0xCD798C208CE7b42E7bf07389f590CcCd68b9a5BA,0x38a404D2e859572fab457ad9AdF3cd2d4781d718
4061,15627857,159981,10010880082,153349,6632,1674,25,0x00000000006c3852cbEf3e08E8dF289169EdE581,0xbcAa229d43f03dAe91C9F106ecad643bAACb6616
4062,15627857,21000,10010880082,21000,0,2,2,0xd3864619f41126760A213da2499cc55A25020683,0x0cE67E3f5B9378525fEBEcE5A9fB8E57BEF118D4
4063,15627857,405260,10010880082,401644,3616,1162,1354,0x68b3465833fb72A70ecDF485E0e4C7bD8665Fc45,0xF8FD771c7Bc7139269Ae006e4FaC6FD02c830A3c
4064,15627857,21000,10010880082,21000,0,2,56,0x1A644dFABF4A3ca29E0fC476770fA3CE9eE9248C,0x1c1732dfaeaF667B99cE9630181aFd853B119Fc6
4065,15627857,21000,10010880082,21000,0,2,534,0x3485Ca538e61753a6b887ef41b7439b5bA2CE795,0x081F8bed874817a7B6C3aAE58B22f6B55ca61DE0
4066,15627857,51793,10010880082,51161,632,138,859,0x2b591e99afE9f32eAA6214f7B7629768c40Eeb39,0xD9186E34aE6197236E6cB9290b1D2F60aD7a9102
4067,15627857,21000,10010880082,21000,0,2,558,0x8d7992739cEf228656A1c50F54878e9CE9b0B293,0xBc86dA04ab1A0926bAA23e0C1F49F75A31EAeCd1
4068,15627857,21000,10010880082,21000,0,2,2,0x764aB2911607F6E14497cEC5434687CAaD5E0cAE,0x0C7337c62a61d031e8DA71a419887Ea77a10f51e
4069,15627857,21000,10010880082,21000,0,2,114,0x6d082a1d39CEfF8a5A21c6166D7ea495835e07A0,0x8C0d700DB746c2d3Ea51D30eCBbf74a379DB416A
4070,15627857,213029,10010880082,210977,2052,650,1,0x72Ce9c846789fdB6fC1f34aC4AD25Dd9ef7031ef,0x9045E9e22f30DC39256F5acA803931c2236D73Fc
4071,15627857,191275,10010880082,184687,6588,1802,32,0x00000000006c3852cbEf3e08E8dF289169EdE581,0x24EE547a325B60Ba76e27Db2B58C454c98b470D2
4072,15627857,21000,10010880082,21000,0,2,2,0xf77f8e6dceE2B45642D757462aECAE95C18b1516,0x303fC75dBFc136f808ebdC137C7dB3aBfe9C31be
4073,15627857,158978,10010880082,152314,6664,1810,776,0x00000000006c3852cbEf3e08E8dF289169EdE581,0xea79b1f6EA30a2DccB7C066Da6204fBf4131BD2C
4074,15627857,290305,10010880082,287861,2444,522,278,0x283Af0B28c62C092C9727F1Ee09c02CA627EB7F5,0xdb934F70848B0a1e124B508BCD6932dE5ada5A2f
4075,15627857,69163,10010880082,68223,940,202,158,0xD97c7C5c30FEba950790D3A6F72d98509499112c,0x5549d4cf0b009D524fe40F101560DFa5400A5faC
4076,15627857,46656,10010880082,46168,488,138,1,0xAd55931611cB687aEae4fDc5fBf3b2fb8b9cd42e,0x2f254CBaA340Bf1C33EA0d206BB727DDcC7C0BA9
4077,15627857,223536,10010880082,220776,2760,842,282,0x68b3465833fb72A70ecDF485E0e4C7bD8665Fc45,0xf74e644D030D378Ce753FC45A5d4b0aF06E5d0E5
4078,15627857,159024,10010880082,152508,6516,1802,22,0x00000000006c3852cbEf3e08E8dF289169EdE581,0x99cdb33Df8726F1952af7f60a02e70436241d499
4079,15627857,750000,10010880082,719244,30756,5450,14136,0xA0c68C638235ee32657e8f720a23ceC1bFc77C77,0xD54e4f8A55247487dd7C8c59f14EE5c0c2889477
4080,15627857,51559,10010880082,51071,488,138,25,0x609feaeDF3BE3b015587400B7Fcece83725d4890,0x814444012a50A540bA3d1C80a05227F0d06C8b7A
4081,15627857,146705,10010880082,140117,6588,1802,114,0x00000000006c3852cbEf3e08E8dF289169EdE581,0x2809E0e1188aD3edAA37aEE7e71847093179c918
4082,15627857,347864,10010880082,344224,3640,1162,211,0x68b3465833fb72A70ecDF485E0e4C7bD8665Fc45,0x25991B064289F1341b0eEDCF536f3688100c3790
4083,15627857,677252,10010880082,636756,40496,13770,971,0x83C8F28c26bF6aaca652Df1DbBE0e1b56F8baBa2,0xb32bD383A8565D8F8eD0DB0dFF4e9f1F7A6Dcd49
4084,15627857,350000,10010880082,347024,2976,650,1107,0xdfb57B6E16DDB97Aeb8847386989f4DCA7202146,0x8D3bea823f22FBfe058577cA01E9a88160E2dd3A
4085,15627857,46533,10010880082,45589,944,138,76,0xE52CDD17FF7b633cb3144DB3038f0ED29A1717cA,0x5E96591aA52BDcD1C0d2ba2566e2d9490055dAcF
4086,15627857,55923,10010880082,54979,944,138,4211,0xD309A8d0498Cc73f53481e46094DC0d3aaB0d9dd,0x4Ed952edDB2DF5EcB924Cab763cC926f10F3F070
4087,15627857,55938,10010880082,54994,944,138,0,0x84FA8f52E437Ac04107EC1768764B2b39287CB3e,0x8710eDC10C2fc16eE9D00bA65f2359B5F61fd92B
4088,15627857,261619,10010880082,255699,5920,1738,66,0x68b3465833fb72A70ecDF485E0e4C7bD8665Fc45,0x30379F151e4FE4C50a3Fa15F797A34Db6374b10B
4089,15627857,362467,10000000000,362263,204,74,565,0x55f1C36Bb7aE0d7D6caE97902E30A2306686Ec73,0x98e0b03e9a722B57CE97EEB0eb2930C6FeC55584
4090,15627857,362467,10000000000,362263,204,74,168,0x55f1C36Bb7aE0d7D6caE97902E30A2306686Ec73,0x4D1bBc97f58218643F84f9897c63c6d95Dedec7D
4091,15627857,362467,10000000000,362263,204,74,125,0x55f1C36Bb7aE0d7D6caE97902E30A2306686Ec73,0x283199f827904B6906ACABE794090979DCC21304
4092,15627857,362467,10000000000,362263,204,74,166,0x55f1C36Bb7aE0d7D6caE97902E30A2306686Ec73,0x09332aA9F9731ca9C92d518feDcd9daaB7648c25
4093,15627857,362467,10000000000,362263,204,74,163,0x55f1C36Bb7aE0d7D6caE97902E30A2306686Ec73,0xF6871a914070C96888c5aD2696ad4c2E4aD905fb
4094,15627857,362467,10000000000,362263,204,74,167,0x55f1C36Bb7aE0d7D6caE97902E30A2306686Ec73,0x1C57500c0cC61A6297131C02F477bE9402e3Db25
4095,15627857,362467,10000000000,362263,204,74,179,0x55f1C36Bb7aE0d7D6caE97902E30A2306686Ec73,0x27Cf4979F7a305EA2669753F850E2d281eD74151
4096,15627857,362467,10000000000,362263,204,74,156,0x55f1C36Bb7aE0d7D6caE97902E30A2306686Ec73,0x64Ddfeb9D193788498800D99064e70e0Cc8d441E
4097,15627857,362467,10000000000,362263,204,74,173,0x55f1C36Bb7aE0d7D6caE97902E30A2306686Ec73,0x448dc453D4c1ADaD588D80C8352360C99C6567ef
4098,15627857,362467,10000000000,362263,204,74,192,0x55f1C36Bb7aE0d7D6caE97902E30A2306686Ec73,0x4BB7ff1658d9DcC1e636b4dcc3F44B048c3DFA9c
4099,15627857,362467,10000000000,362263,204,74,166,0x55f1C36Bb7aE0d7D6caE97902E30A2306686Ec73,0xd6A80aCc07FCADAB407E9DEad9D221D3c0f71245
4100,15627857,53077,9610881082,52133,944,138,38,0x362bc847A3a9637d3af6624EeC853618a43ed7D2,0x1f10F11365C571a921096Ade4b740593158BDFd0
4101,15627857,84000,9510880082,83392,608,138,0,0xA0b86991c6218b36c1d19D4a2e9Eb0cE3606eB48,0x3c83757f447A21a1320dbb27e77a4330951b05eb
4102,15627857,21000,9510880082,21000,0,2,113044,0x79491902D911C16d8837be98DB8aB39Cb764a41e,0x6081258689a75d253d87cE902A8de3887239Fe80
4103,15627857,21000,9510880082,21000,0,2,72,0xBcb958331862BeD5e3aF56695583F9ec2C6C7ff9,0xC9FAfff9DE5Dd71A3bb93F6E9F4297A1C929b7B7
4104,15627857,150756,9510880082,150692,64,10,1,0x65c2e54a4c75ff6da7b6B32369c1677250075fb2,0x186Bb6e7549569D2507822fC535e4d05d0CC9f66
4105,15627857,21000,9510880082,21000,0,2,102636,0x30552112bFACA7F262a851168f29Cf81Df89Fe55,0x2Db1D8CdF1Abe8C70b531a790CDf2FF38aecF652
4106,15627857,181476,9510880082,179912,1564,394,404,0x1Fa8559e873f698292766790AeCf8080A66433F6,0x0e8CF84cb1eB4D7aE149014437b12c54f782c148
4107,15627857,175110,9510880082,173546,1564,394,77,0x1Fa8559e873f698292766790AeCf8080A66433F6,0xcC6E6f78ad32C0f0d8400f9f59B1e9e6eb8e6973
4108,15627857,181476,9510880082,179912,1564,394,3816,0x1Fa8559e873f698292766790AeCf8080A66433F6,0x3D889b6391506032F9e9380a8f5cD3199661fB72
4109,15627857,21000,9470880082,21000,0,2,176,0xc60381d826139435681b6797843aC2749E0b0e33,0x4733ca9dA171E55aBc361c79586AFc3B48F1D3F5
4110,15627857,21000,9360000000,21000,0,2,56,0x9204d9Fc324e232A2DBD7652d31B0921D1E4Bc98,0x1C4df134826E6b8E7Aa499BDEbE8381fa29a74FD
4111,15627857,21000,9145803216,21000,0,2,7,0x03476A65eFD691bD32CDa69EA320a5BadDeAD777,0x9610DeA9B960416671350a5c17dddb60b71acD38
4112,15627857,475531,9143133078,450247,25284,7634,107,0x1111111254fb6c44bAC0beD2854e76F90643097d,0x6780ac060FdcBA20AE02A6197c84Bdc70CF8716B
4113,15627857,41209,9000000000,33725,7484,2514,72,0x00000000006c3852cbEf3e08E8dF289169EdE581,0x8Dc1E4Abf18e18a5aF832a2f895BEad3fcC0c7cF
4114,15627857,150000,8854199719,149404,596,138,638777,0xA0b86991c6218b36c1d19D4a2e9Eb0cE3606eB48,0x55FE002aefF02F77364de339a1292923A15844B8
4115,15627857,150000,8766000000,149116,884,330,891,0x556697Ca91476B811f37A851dD2e53ae4c6024dB,0x207b8aF4f163e40400aC8e4a172CEE888D043B99
4116,15627857,74274,8719943661,73618,656,138,363,0x4Fabb145d64652a948d72533023f6E7A623C7C53,0x287544938d9011394634B48e9Fc1d8192EAc3e19
4117,15627857,55117,8719943661,55117,0,2,1813,0x1fCDB799d0187825c8df82C7f28A19a00FE6cBaf,0x729AAC9048Dd6c07d30E589087360EF1934B3a2C
4118,15627857,150756,8719943661,150692,64,10,31,0x65c2e54a4c75ff6da7b6B32369c1677250075fb2,0x12810A2aa8234b45bd317D66b9f0bAC6915cb8B3
4119,15627857,356150,8682653241,341410,14740,4426,15392,0x9008D19f58AAbD9eD0D60971565AA8510560ab41,0x149d0f9282333681Ee41D30589824b2798E9fb47
4120,15627857,26000,8510880082,26000,0,2,12023,0xfFd22b84fB1d46ef74Ed6530b2635BE61340f347,0xDAFEA492D9c6733ae3d56b7Ed1ADB60692c98Bc5
4121,15627858,120000,63000000000,119344,656,138,100,0xfF20817765cB7f73d4bde2e66e067E58D11095C2,0xB627C4ff128009F748e125d9F7e33d2F8475489f
4122,15627858,81616,14492625729,81008,608,138,2188226,0x2260FAC5E5542a773Aa44fBCfeDf7C193bc2C599,0x75e89d5979E4f6Fba9F97c104c2F0AFB3F1dcB88
4123,15627858,77610,14492625729,76954,656,138,2188227,0x9d71CE49ab8A0E6D2a1e7BFB89374C9392FD6804,0x75e89d5979E4f6Fba9F97c104c2F0AFB3F1dcB88
4124,15627858,77356,14492625729,76736,620,138,2188228,0x467719aD09025FcC6cF6F8311755809d45a5E5f3,0x75e89d5979E4f6Fba9F97c104c2F0AFB3F1dcB88
4125,15627858,50000,14492625729,50000,0,2,2188229,0x9914dE54EE3FfE6e09333DB0b3E2Cae72DbaE6f1,0x75e89d5979E4f6Fba9F97c104c2F0AFB3F1dcB88
4126,15627858,21000,14145803216,21000,0,2,59668,0xC1b2B79e9C3D4869D3B2a7c7927fe8D788283198,0x354e9Fa5c6Ee7e6092158a8c1B203CcAc932D66d
4127,15627858,63000,12510489448,63000,0,2,2710051,0x4dD02eaC7ba28122404C79D5f87E478d792bBb9d,0xC098B2a3Aa256D2140208C3de6543aAEf5cd3A94
4128,15627858,211394,11792781920,209546,1848,458,1287,0x7a250d5630B4cF539739dF2C5dAcb4c659F2488D,0x1DC26ff48AbEf2d01c2A572b74117D7a19a2cD02
4129,15627858,60000,11224302431,59404,596,138,6,0xdAC17F958D2ee523a2206206994597C13D831ec7,0x3C7FEe7899065c70602eE13544343Ae1C6C5EfEd
4130,15627858,21000,11224302431,21000,0,2,1569060,0x1c00b0Eeb45a385fF0e317041d015b1963b000E5,0xAe45a8240147E6179ec7c9f92c5A18F9a97B3fCA
4131,15627858,21000,11000000000,21000,0,2,13,0x389505f098a29a994A3ed0e674f07cd451dde42C,0xba430C1a5c8d0A70Bdc68F1E01A66035208bAD42
4132,15627858,21000,11000000000,21000,0,2,40,0x389505f098a29a994A3ed0e674f07cd451dde42C,0x1798d782384aB1fA52aEE380109e4dA0386ED841
4133,15627858,50000,10792781920,49056,944,138,0,0xdAC17F958D2ee523a2206206994597C13D831ec7,0x71De0264475Cb3db664BA1Fb5C9F3f1879991d3F
4134,15627858,2000000,10792781920,1992616,7384,1738,171040,0xA9D1e08C7793af67e9d92fe308d5697FB81d3E43,0x7830c87C02e56AFf27FA8Ab1241711331FA86F43
4135,15627858,21000,10792781920,21000,0,2,8265749,0xE8F34a25F9BFD22D440a256743e319b744e4C975,0xb5d85CBf7cB3EE0D56b3bB207D5Fc4B82f43F511
4136,15627858,60727,10292781920,53271,7456,2506,2141,0x00000000006c3852cbEf3e08E8dF289169EdE581,0x9C51532Ef51ab720514b5acAf97Fe6C600FbFb54
4137,15627858,65963,10292781920,64651,1312,202,5,0x57f1887a8BF19b14fC0dF6Fd9B2acc9Af147eA85,0x03f14D5930fB58107CDb2fe9DE6E7d4B2a1b2E5F
4138,15627858,173506,10292781920,166854,6652,1810,397,0x00000000006c3852cbEf3e08E8dF289169EdE581,0x7C44120fDFcc8c8F9f87c013C14e4D5fe014Ae02
4139,15627858,21000,10292781920,21000,0,2,8,0x7E7A1325a05A4c656f703368fAB2cc4AA387C780,0xd14742645B79B212c0B29119Dd61e0dDAB0F6ae4
4140,15627858,21000,10292781920,21000,0,2,78,0x8d680b3E67DAab79c7bC0F2AAcA616C70B431D85,0x38a404D2e859572fab457ad9AdF3cd2d4781d718
4141,15627858,234670,9792781920,233034,1636,394,765,0x7a250d5630B4cF539739dF2C5dAcb4c659F2488D,0xB4cEF3CA34db5A5ea3116dcd924d318bCbD7Ad17
4142,15627858,21000,9792781920,21000,0,2,113045,0x08d128F29dB0D6350c10596A46b90A9221faA37A,0x6081258689a75d253d87cE902A8de3887239Fe80
4143,15627858,175110,9792781920,173546,1564,394,200,0x1Fa8559e873f698292766790AeCf8080A66433F6,0xF4cDb2232A080BC4ADf8FC1Ca09A17C2E7CFe318
4144,15627859,125045,7797283961,124333,712,130,10551,0xE8c060F8052E07423f71D445277c61AC5138A2e5,0xb8feFFAC830C45b4Cd210ECDAAB9D11995D338ee
4145,15627859,422757,9297283961,421005,1752,458,7992,0x7a250d5630B4cF539739dF2C5dAcb4c659F2488D,0x11191bcfe30c6aE7bBEF74c6De97c8D52FF957F9
4146,15627859,370641,9447283961,368889,1752,458,7993,0x7a250d5630B4cF539739dF2C5dAcb4c659F2488D,0x11191bcfe30c6aE7bBEF74c6De97c8D52FF957F9
4147,15627859,96989,133450664330,95957,1032,170,10552,0xE8c060F8052E07423f71D445277c61AC5138A2e5,0xb8feFFAC830C45b4Cd210ECDAAB9D11995D338ee
4148,15627859,337111,9128287591,331295,5816,1548,39,0x881D40237659C251811CEC9c364ef91dC08D300C,0x1f10F11365C571a921096Ade4b740593158BDFd0
4149,15627859,69163,45000000000,68555,608,138,15,0xdAC17F958D2ee523a2206206994597C13D831ec7,0x9d9c807180F6863c726A6D48C989C7e407293207
4150,15627859,69163,45000000000,68555,608,138,8,0xdAC17F958D2ee523a2206206994597C13D831ec7,0x6d98817ACf447293A32661EeAB599b78Ec4Ea12A
4151,15627859,53646,32797283961,52702,944,138,25,0xd4cB651749953988647eEE9b51DDB8DB5aeb3410,0xC1e4f8Dca5D91DE30d8427Af68aA2D45C6bcFCE1
4152,15627859,625230,22345573934,623134,2096,522,97,0x7a250d5630B4cF539739dF2C5dAcb4c659F2488D,0xa72775d7359422BB9292C9FC3FC8758eC0D28940
4153,15627859,625230,21708302904,623134,2096,522,98,0x7a250d5630B4cF539739dF2C5dAcb4c659F2488D,0x56157B796BEf83dA422860Dde69cd0921A3CA95d
4154,15627859,625230,21562635724,623134,2096,522,101,0x7a250d5630B4cF539739dF2C5dAcb4c659F2488D,0x3B5e05c1470B6907aF37Ec8C86E0fD86dbED6Ce2
4155,15627859,5049560,17000000000,5042424,7136,1098,284,0x0a39DA505DfB5E0BBc6bd84428281A8ba1bC7753,0x495E889d1A6cEB447a57dcc1C68410299392380c
4156,15627859,298225,15000000000,295429,2796,842,54,0x68b3465833fb72A70ecDF485E0e4C7bD8665Fc45,0x0f9bcc9A6A53aC3B0Dd792A355D9c64c4EA34848
4157,15627859,300014,14883527974,298794,1220,330,224456,0x98C3d3183C4b8A650614ad179A1a98be0a8d6B8E,0x91aaE0aAfd9D2d730111b395c6871f248d7Bd728
4158,15627859,900000,12797283961,898000,2000,522,512,0x7a250d5630B4cF539739dF2C5dAcb4c659F2488D,0x1de23D0B427d764BDbABE7AE8a1735a6F2492bD3
4159,15627859,1500000,12797283961,1498000,2000,522,1209,0x7a250d5630B4cF539739dF2C5dAcb4c659F2488D,0x9EaD5FBDB0855C8993693bBFf3e61f0cD3a1e614
4160,15627859,1500000,12797283961,1498000,2000,522,1849,0x7a250d5630B4cF539739dF2C5dAcb4c659F2488D,0x5666ba60D132EDf7341166eDB2e733d79B4BCDE2
4161,15627859,270855,12797283961,268927,1928,522,568,0x7a250d5630B4cF539739dF2C5dAcb4c659F2488D,0x121Ef52DEf328Ec4f82410acEd31f8e8F1BfA4C9
4162,15627859,181476,12797283961,179912,1564,394,174,0x1Fa8559e873f698292766790AeCf8080A66433F6,0xE5adeB0A710822f1A1efE670775C96f0c639bA70
4163,15627859,73206,12000000000,72598,608,138,1461,0xA0b86991c6218b36c1d19D4a2e9Eb0cE3606eB48,0xe9E72a28240D255697cBa14eD7dBed1BE641d80B
4164,15627859,55816,12000000000,55172,644,138,0,0xcD74Cf66c43e45Abd5703f3642F73d0675D6AFF7,0x166A46e344D0BB0fa2fDd5ED61AA8a9F5076f4F2
4165,15627859,222222,12000000000,220658,1564,394,224,0x1Fa8559e873f698292766790AeCf8080A66433F6,0x0695453D0Ec3F7c622fb13Bf622a0b7eE83912db
4166,15627859,1000000,11674326137,992584,7416,2186,3,0xf18aCC02628009231d7BAAF9a7a24C0860Dda6cb,0xc5b27a5f60bCb24c4030adCE4B98fc24D75A749B
4167,15627859,50000,11674326137,50000,0,2,464124,0xEd0f4e8A17578E44865B47BDA3D1eEB411A7635E,0x3B794929566e3Ba0f25e4263e1987828b5c87161
4168,15627859,21000,11000000000,21000,0,2,5,0x84DB7c2937A75e6544Fa8a032271E831A419F1cb,0x6022F5Df2e72179C0A5D0ffB3886209299E9Cdd4
4169,15627859,21000,11000000000,21000,0,2,16,0xB8ed33257A0EF6D294FC6579b23Bdc1A30AA8195,0xf4A19f2fDF6FDAaD0F322ae3F9847BC05A1cd70A
4170,15627859,21000,11000000000,21000,0,2,94,0xDb343e339E092DDd76eC4e5Cc424CBd2011e9Bad,0xe5059db3F71aD7FEf95A0d7356fea3d638383c69
4171,15627859,21000,11000000000,21000,0,2,69,0xCc0d405E7f076cb6261DC4DB504682211C1765a7,0x623b2f61D31ffEc4E598dd5eE565A22b3Bea7157
4172,15627859,21000,11000000000,21000,0,2,10,0x389505f098a29a994A3ed0e674f07cd451dde42C,0xE7116C50Bc64c1587B31236116D2FA692b6Ed520
4173,15627859,21000,11000000000,21000,0,2,37,0x389505f098a29a994A3ed0e674f07cd451dde42C,0x8Fb51D303C18fB6AB59a9781e98B213E1b8D4735
4174,15627859,21000,11000000000,21000,0,2,19,0x389505f098a29a994A3ed0e674f07cd451dde42C,0x1F940B8fACeBE89fF2DC228CC9cBCC60Cdb079B1
4175,15627859,21000,11000000000,21000,0,2,3,0x489773AC60B915F9809011cf3f544F18A4441627,0x9C63dd64c6b6c575e53E4a55B456CA39Ebc695dc
4176,15627859,21000,10872936296,21000,0,2,2,0x10E006dFa6Ff6fe194c5717FE945258522d0BE18,0xEF2d9cE90ba7C6dDf5dee12664f423b7E3bEDB32
4177,15627859,100000,10800000000,99024,976,202,259899,0xdAC17F958D2ee523a2206206994597C13D831ec7,0x292f04a44506c2fd49Bac032E1ca148C35A478c8
4178,15627859,21000,10799283961,21000,0,2,196175,0xee1593fADbaD6A7c012453e7307a0bB2317AEc0D,0xd108FD0E8c8E71552a167E7a44FF1d345D233BA6
4179,15627859,1000000,10797283961,996180,3820,970,4806,0x3CACa7b48D0573D793d3b0279b5F0029180E83b6,0x160694f252B907CDf3862922950142a5f1Fd161a
4180,15627859,78966,10797283961,75690,3276,1034,51,0x0000000000c2d145a2526bD8C716263bFeBe1A72,0xf3B9b918D3567A3A698F13fD12f036aCF4bCAC11
4181,15627859,346751,10797283961,344999,1752,458,0,0xEfF92A263d31888d860bD50809A8D171709b7b1c,0x89b1e7e50aa3692261897882C80cE1EC37Ec8641
4182,15627859,69881,10797283961,68937,944,138,1288,0x011b0beAe3eC5953B4805b064cC78f6F892A99cC,0x1DC26ff48AbEf2d01c2A572b74117D7a19a2cD02
4183,15627859,165298,10797283961,160518,4780,970,55,0x9d763Cca6A8551283478CeC44071d72Ec3FD58Cb,0x04B63973Ee7640264B2FaD75ad3c7D0654598A7b
4184,15627859,50000,10589544180,50000,0,2,476119,0x404D9ebD1FaB68C1c6610c171d3B5e2b6a9AbF1f,0x4d846dA8257BB0Ebd164EFf513DfF0F0c2C3c0ba
4185,15627859,21000,10531850980,21000,0,2,0,0xCBD6832Ebc203e49E2B771897067fce3c58575ac,0x606bAec343eE305701844901e8952Eb32Efa7617
4186,15627859,21000,10531850980,21000,0,2,34,0xCBD6832Ebc203e49E2B771897067fce3c58575ac,0xC8201d8675471478EDebfF5a6df0EEc9F36d3eBe
4187,15627859,250000,10500000000,249404,596,138,10954,0xdAC17F958D2ee523a2206206994597C13D831ec7,0x53Eb3Ea47643E87e8f25dd997A37B3b5260e7336
4188,15627859,21000,10495347521,21000,0,2,0,0xCBD6832Ebc203e49E2B771897067fce3c58575ac,0x535Fb412D4fd92c6883F35190Fdaa539F78549F9
4189,15627859,126535,10297283961,125963,572,138,4,0x1748B24faf9780B74E5A9f3Feb41553E712E94aa,0xd2E5F4de50e25FA7Bb7C40aA0f104f4210a6CDC6
4190,15627859,117738,10297283961,117534,204,74,164,0x7F9306FC1978938d5C1C57Bf6044dc67E07eeB8a,0x375Dae8e3F7c60AdfFa7db18590Dcdf6F0de2223
4191,15627859,652887,10000000000,649615,3272,714,60,0xC36442b4a4522E871399CD717aBDD847Ab11FE88,0x680CfEA894cD0Bd8491c348795fa791F7386d235
4192,15627859,191041,10000000000,190165,876,266,1390,0xd588b586D61C826A0e87919b3D1a239206d58bf2,0xC22d03e13B888Dabb33A1575e4F6542f0e996622
4193,15627859,21000,9980250875,21000,0,2,66,0x03476A65eFD691bD32CDa69EA320a5BadDeAD777,0x93b6fB23d7F40c4cf0E596f269DF8488BA1F5383
4194,15627859,21000,9980250875,21000,0,2,7,0x03476A65eFD691bD32CDa69EA320a5BadDeAD777,0xF7cb671b6503c7a0347398Ef93FE39Ba6c4d831C
4195,15627859,21000,9797283961,21000,0,2,469161,0x9E4410Eb95cdCD868dF41c7E6c16B83Cd3ad13B3,0xb739D0895772DBB71A89A3754A160269068f0D45
4196,15627859,2000000,9797283961,1991188,8812,1930,171041,0xA9D1e08C7793af67e9d92fe308d5697FB81d3E43,0x7830c87C02e56AFf27FA8Ab1241711331FA86F43
4197,15627859,260059,9797283961,256395,3664,1162,2248,0x68b3465833fb72A70ecDF485E0e4C7bD8665Fc45,0x74eEf19f8712aBbCFe9D79c7D3e4e2d434fbB1F1
4198,15627859,42000,9797283961,42000,0,2,329526,0x7B29dC23A4148a45Dc19162095b27bb220F8D3b3,0x9430801EBAf509Ad49202aaBC5F5Bc6fd8A3dAf8
4199,15627859,21000,9797283961,21000,0,2,469162,0xe6aE8dEDD01Ef96A0E0958E669CbC0C66E0bff25,0xb739D0895772DBB71A89A3754A160269068f0D45
4200,15627859,21000,9797283961,21000,0,2,469163,0x80451a67fb53c0A181e2A425A594f1274Bb71AfD,0xb739D0895772DBB71A89A3754A160269068f0D45
4201,15627859,36015,9797283961,35751,264,74,120,0xC02aaA39b223FE8D0A0e5C4F27eAD9083C756Cc2,0xb11a9DE71426a4D598749741459f7661732E757D
4202,15627859,399934,9797283961,396294,3640,1162,65,0x68b3465833fb72A70ecDF485E0e4C7bD8665Fc45,0xE170dA9eA20A5D01ae045ad7C77958Efc63f977b
4203,15627859,49542,9797283961,49478,64,10,215,0xC02aaA39b223FE8D0A0e5C4F27eAD9083C756Cc2,0xe367c5C826A79109C85a930a48CfC3A3E970CE70
4204,15627859,21000,9797283961,21000,0,2,1,0x20166A7206C7908706c53D01d7D6932CD63F80f9,0x8D51229DF7FcE9fA1686b62349528d99dE5f309C
4205,15627859,175957,9797283961,173197,2760,842,382,0x68b3465833fb72A70ecDF485E0e4C7bD8665Fc45,0xce45DbC50E99c5e17Cb3C439CCB96fBac3fc270d
4206,15627859,231442,9797283961,231110,332,138,76,0x94235659cF8b805B2c658f9ea2D6d6DDbb17C8d7,0xfCDc25ba0D9D9C16A40506802a50C6c0870d5BC6
4207,15627859,21000,9797283961,21000,0,2,2405,0xAc77e1fE8Be71A467C3CBD61381011B9e0DE23f7,0xC47b858a10Ef879e33F40b4b7322E677A7EAC52d
4208,15627859,47204,9797283961,46272,932,138,350,0xb12494C8824fc069757F47d177E666c571Cd49aE,0xB82e84aA632c101e924C7b0B8faAad0322822010
4209,15627859,46016,9797283961,45528,488,138,3,0x495f947276749Ce646f68AC8c248420045cb7b5e,0x6914F86c18F1186a0287A9c2dE4cB26D8c069905
4210,15627859,70000,9797283961,69392,608,138,11,0xA0b86991c6218b36c1d19D4a2e9Eb0cE3606eB48,0xA686e91b3164CF14B9bF7E6E48B5f1847f978167
4211,15627859,274055,9797283961,273031,1024,202,95,0x429CA183C5f4B43F09D70580C5365a6D21ccCd47,0xbbc75Ae41faB1A88bFC4BD17F77fdCDDf099c2Ac
4212,15627859,21000,9797283961,21000,0,2,19,0x85523d93E99d17fD1249e779Ba1Aa5852eCDc93a,0xF03DE339C9BE4128e11DFf28a05083527df4b814
4213,15627859,49542,9797283961,49478,64,10,822,0xC02aaA39b223FE8D0A0e5C4F27eAD9083C756Cc2,0x274a53a58Ba4aA0DECEeDbd122916c38CdA3767B
4214,15627859,181476,9797283961,179912,1564,394,383,0x1Fa8559e873f698292766790AeCf8080A66433F6,0xBb6F57d9736e845A133F8164CD46A833699E65aA
4215,15627859,174932,9797283961,171256,3676,1162,1221,0x68b3465833fb72A70ecDF485E0e4C7bD8665Fc45,0x9cA213288C3cFb4f7be4dD66Bde1E025a4c8c856
4216,15627859,181476,9797283961,179912,1564,394,241,0x1Fa8559e873f698292766790AeCf8080A66433F6,0x1AeE7B80aD212C9810952aA75Bb66535291AC6e3
4217,15627859,51458,9797283961,50970,488,138,994,0x7F9306FC1978938d5C1C57Bf6044dc67E07eeB8a,0xb4b6cB2789BAD42A9907493068996c358e1E5e0e
4218,15627859,30732,9797283961,30668,64,10,23,0xC02aaA39b223FE8D0A0e5C4F27eAD9083C756Cc2,0x9bC640984d89A1d994946f768339a216C8C511BF
4219,15627859,70000,9797283961,69404,596,138,526,0xdAC17F958D2ee523a2206206994597C13D831ec7,0xf5491f793D47A6Ea22f5e0B9AD3990CF66c4b40B
4220,15627859,243733,9797283961,240925,2808,842,777,0x68b3465833fb72A70ecDF485E0e4C7bD8665Fc45,0x22789f0FB37023FFbe09E8F6cbf577612e65FDA7
4221,15627859,99244,9797283961,98636,608,138,25,0xA0b86991c6218b36c1d19D4a2e9Eb0cE3606eB48,0xB21a5Df68A5862AFA709f230F559BBA78734499f
4222,15627859,350220,9797283961,348656,1564,394,15,0x1Fa8559e873f698292766790AeCf8080A66433F6,0xcEed181101c4DC2650E851aD5298aFd94d5588cb
4223,15627859,350220,9797283961,348656,1564,394,15,0x1Fa8559e873f698292766790AeCf8080A66433F6,0xd45D5f697ED05231B2B6Db4342ABBDffa1622711
4224,15627859,350220,9797283961,348656,1564,394,14,0x1Fa8559e873f698292766790AeCf8080A66433F6,0xB476c72DA06E4041Dd9fd38999C284D054D2BF2c
4225,15627859,350184,9797283961,348632,1552,394,29,0x1Fa8559e873f698292766790AeCf8080A66433F6,0x9a2Bfb29c9712881C0C7B0FB67B879Ca65230064
4226,15627859,350220,9797283961,348656,1564,394,18,0x1Fa8559e873f698292766790AeCf8080A66433F6,0x8D6e334a3f4B90Ad3E20FE08E27aEE62DA5aFDEb
4227,15627859,350220,9797283961,348656,1564,394,33,0x1Fa8559e873f698292766790AeCf8080A66433F6,0xdb06770752040459e1c7365b1d85dbF7E96526Be
4228,15627859,350220,9797283961,348656,1564,394,31,0x1Fa8559e873f698292766790AeCf8080A66433F6,0x4D2058Dab7487aE1325DA066C6B5e1af0E3FC3aa
4229,15627859,350220,9797283961,348656,1564,394,33,0x1Fa8559e873f698292766790AeCf8080A66433F6,0x8A3ce5DC27E7D8a6af80104eF325826C425F1ff2
4230,15627859,350220,9797283961,348656,1564,394,37,0x1Fa8559e873f698292766790AeCf8080A66433F6,0x1fC0ecd17F36db636bf324D25139adc82f489368
4231,15627859,350220,9797283961,348656,1564,394,30,0x1Fa8559e873f698292766790AeCf8080A66433F6,0x7EF8652A2d0D75A8B36D583592CFfFD616A90223
4232,15627859,350220,9797283961,348656,1564,394,29,0x1Fa8559e873f698292766790AeCf8080A66433F6,0x13a1DB382Bb9A87e61298f492B8aA9bA885B0567
4233,15627859,350220,9797283961,348656,1564,394,31,0x1Fa8559e873f698292766790AeCf8080A66433F6,0xa8dDE3CD7DF4d5a5F3756a4122d80851Da4169C2
4234,15627859,350220,9797283961,348656,1564,394,15,0x1Fa8559e873f698292766790AeCf8080A66433F6,0xc5A65ffDBbacD39034eA9F0Fe1F6C43B05ab6fDB
4235,15627859,350220,9797283961,348656,1564,394,17,0x1Fa8559e873f698292766790AeCf8080A66433F6,0xb3618CF08b3aA9051f3E80abfbf0493187ac52Ce
4236,15627859,350220,9797283961,348656,1564,394,30,0x1Fa8559e873f698292766790AeCf8080A66433F6,0x4ebc3aD8b7C3766B44590747104693e53d4B7b1E
4237,15627859,350220,9797283961,348656,1564,394,16,0x1Fa8559e873f698292766790AeCf8080A66433F6,0x5B639debf5E78EcF601DA52D295048d2d5f66429
4238,15627859,350220,9797283961,348656,1564,394,15,0x1Fa8559e873f698292766790AeCf8080A66433F6,0x9011B9De3edC14F38df0773B9FB28BE4e4f68E63
4239,15627859,350220,9797283961,348656,1564,394,17,0x1Fa8559e873f698292766790AeCf8080A66433F6,0xfC47a55013F18F358B130785DfFA91e28753c64c
4240,15627859,350220,9797283961,348656,1564,394,15,0x1Fa8559e873f698292766790AeCf8080A66433F6,0x862b3867036cBCf16026BDeA6cf37257881b9630
4241,15627859,350184,9797283961,348632,1552,394,30,0x1Fa8559e873f698292766790AeCf8080A66433F6,0xDa521C799A72f1dAe89C53B6eDc8A05ef907E33c
4242,15627859,350220,9797283961,348656,1564,394,18,0x1Fa8559e873f698292766790AeCf8080A66433F6,0x460FFafc04BD07A1679A9C6B811Ad897B420667C
4243,15627859,350220,9797283961,348656,1564,394,18,0x1Fa8559e873f698292766790AeCf8080A66433F6,0x3b7F3734Eaa5e9584eA9Cc34b7574BE62CbD93Ca
4244,15627859,350220,9797283961,348656,1564,394,30,0x1Fa8559e873f698292766790AeCf8080A66433F6,0x8FdA8f9481020F8cA8dAc0B855775c92aEf8C8b5
4245,15627859,21000,9797283961,21000,0,2,0,0xD51190254904Eda89bc7C4324802F786780b4cCd,0xBc80aDFf89d9bf10ee1D6233942E0DF42F4622b4
4246,15627859,350184,9797283961,348632,1552,394,33,0x1Fa8559e873f698292766790AeCf8080A66433F6,0x113446Eb33f7AC3c1ccE0c2f5A4a02e61F111365
4247,15627859,350220,9797283961,348656,1564,394,34,0x1Fa8559e873f698292766790AeCf8080A66433F6,0x38D83bbA6826aEA065A7C5686ce39998E5F780b0
4248,15627859,350184,9797283961,348632,1552,394,30,0x1Fa8559e873f698292766790AeCf8080A66433F6,0x524B000aa05BF49e509B8F3713A887D097446F2C
4249,15627859,350220,9797283961,348656,1564,394,17,0x1Fa8559e873f698292766790AeCf8080A66433F6,0x714f4ca50e2b122672275e2a735bA6fC96AC4e44
4250,15627859,350184,9797283961,348632,1552,394,17,0x1Fa8559e873f698292766790AeCf8080A66433F6,0xcf45a07A39b6FfA93Cd406D2dBB8d44599B6b22A
4251,15627859,350220,9797283961,348656,1564,394,16,0x1Fa8559e873f698292766790AeCf8080A66433F6,0x7f6515566781cBa2B16e5Fa9CFd5C0b2826748D6
4252,15627859,350148,9797283961,348608,1540,394,29,0x1Fa8559e873f698292766790AeCf8080A66433F6,0xc2c7BBCbe5e578b3a3A0464e53FA569BFb6Fbc00
4253,15627859,60691,9797283961,53271,7420,2506,148,0x00000000006c3852cbEf3e08E8dF289169EdE581,0x8C7cCE1F0ed5cF36D24cB8aBa73749a0e0eCb995
4254,15627859,21000,9560000000,21000,0,2,57,0x7959f2D37DfbAf5FBf355899217d5Fb8b344BE08,0x1C4df134826E6b8E7Aa499BDEbE8381fa29a74FD
4255,15627859,21000,9446553581,21000,0,2,1,0x52A258ED593C793251a89bfd36caE158EE9fC4F8,0xb14c2Bb1d1Bd17761371FCec0abd90F431Ed4824
4256,15627859,21000,9347283961,21000,0,2,2,0xEc9e85445048ad43fCBd96eEdb1c324334d04379,0x775A3677Ea9fD697eecfEE9cB944792Aea9a6182
4257,15627859,21000,9297283961,21000,0,2,2,0xCD8962D2526a7cC234518D9F92938f473cC75039,0x6eF314FE7C08Cb78D58Df1995dE6CdF2060435F9
4258,15627859,21000,9297283961,21000,0,2,282,0x4133bBff811C66Ab84b45B9582e2D1c5bE8677cC,0x3e8D20198AB61c62066C4A463F0cAa8879d29474
4259,15627859,49259,9297283961,48687,572,138,161,0xD27dcbcC8778a8AB33AAc529Df36a634567Be325,0xe83366A625F1E7374Bd76E631010207EDBc6d194
4260,15627859,312816,9297283961,312320,496,202,21,0x8F7d8b15086bBeCeCBA4807934e189629ca2363a,0xa07583a6A69FAaB10917a3fA9DC0f931E970B339
4261,15627859,21000,9297283961,21000,0,2,596,0x76B36fa9B4bC0fD574f8aBED7815F6968122c44F,0x6FB3FE8b8A9e5A3396b5Fce9f61cAe179a8D1e2b
4262,15627859,219958,9297283961,217174,2784,842,64,0x68b3465833fb72A70ecDF485E0e4C7bD8665Fc45,0xE3b85e4f261e9E54ecfA83E53E460Ea37CbE9471
4263,15627859,27938,9297283961,27874,64,10,258,0xC02aaA39b223FE8D0A0e5C4F27eAD9083C756Cc2,0xbA4AB67e6037C30454F1C17554264bb513626C16
4264,15627859,46685,9297283961,46197,488,138,40,0x3A472c4D0dfbbb91ed050d3bb6B3623037c6263c,0x84De5F6794C9438A5aAaCeFE1248194064428CD3
4265,15627859,144631,9297283961,144427,204,74,2286,0x7F9306FC1978938d5C1C57Bf6044dc67E07eeB8a,0xED04d3792C439b8Af827B3e46EE626827De53Db5
4266,15627859,51458,9297283961,50970,488,138,359,0x7F9306FC1978938d5C1C57Bf6044dc67E07eeB8a,0x1Ab5d274F499C602E2281dEcaa717AD29bcBB4E5
4267,15627859,21000,9297283961,21000,0,2,169,0x5D16869Fe0a91a7583D93d005B0869289B479e1a,0x8d183A25EB9eFE1694d723cd3d498c8dC17b21c5
4268,15627859,46267,9297283961,45691,576,74,238,0x283Af0B28c62C092C9727F1Ee09c02CA627EB7F5,0x224545C475f8F354D170851CBc4C1E6A32194D59
4269,15627859,21000,9297283961,21000,0,2,1,0x502F44b5Be1470ff0F0850207672A4ca26b1abD5,0x44bf40E073D03B74761062B7d84Bc1A7A6Ef4281
4270,15627859,229614,9297283961,224458,5156,1290,2,0x0000000000c2d145a2526bD8C716263bFeBe1A72,0x2f254CBaA340Bf1C33EA0d206BB727DDcC7C0BA9
4271,15627859,148239,9297283961,141651,6588,1802,307,0x00000000006c3852cbEf3e08E8dF289169EdE581,0x49f96172C92DFC476aB1ebeb2779Ac8a4F38a11f
4272,15627859,142812,9297283961,136236,6576,1802,62,0x00000000006c3852cbEf3e08E8dF289169EdE581,0x7BCE759BC34f7FD60D20D197604576B45a8cb564
4273,15627859,21000,9297283961,21000,0,2,19,0xC7bD9f6d40b698F0f0e7a97b99e79B3Ba26e4B96,0x813625e7b3A4cdcEB1Ab70027E5820eEBAbABDe3
4274,15627859,159996,9297283961,153480,6516,1802,60,0x00000000006c3852cbEf3e08E8dF289169EdE581,0xBeEa584B3F032D0cA801202832E731d6F53C1A79
4275,15627859,46280,9297283961,45420,860,138,45,0xC02aaA39b223FE8D0A0e5C4F27eAD9083C756Cc2,0x314f225CfDd8FFb092f556E8b9FfCf4328c3A710
4276,15627859,180249,9297283961,179325,924,266,40,0x960b236A07cf122663c4303350609A66A7B288C0,0xBc13D80CB3FD572FDBc64210DE762dcb8Bd93469
4277,15627859,21000,9297283961,21000,0,2,98,0x05752F3c28Fd91C027a216F57b05B774E32957B4,0x75A6085Bbc25665B6891EA94475E6120897BA90b
4278,15627859,78040,9297283961,77836,204,74,1,0xB092Ec81F41c619EEa434357477ea8A4b1455755,0xA0f081aD0a561c6e65d005cA846A34bE4FD3ac07
4279,15627859,49175,9297283961,48687,488,138,3101,0x9B0A08F84f7369e157cDD0d4cDcfAdD6C141ecDD,0xD498420B5fFe2093FA078C800b41e6782DF7a83A
4280,15627859,328423,9297283961,325223,3200,906,231,0x68b3465833fb72A70ecDF485E0e4C7bD8665Fc45,0xa7C1d32B4bB7155Ad5e9e53F472b9CE61BB37ddc
4281,15627859,46386,9297283961,45442,944,138,252,0x8EF79D6C328C25dA633559c20c75f638A4863462,0xD631Bc52b1b69Bd79151be24B7d004e0Bc33f8aB
4282,15627859,21000,9297283961,21000,0,2,1668,0x33Fa950A47caa3523215B9B2e504359930266BC2,0x6e300cba264c8314050fdcaC2ECFC04C65758Aa8
4283,15627859,159573,9297283961,159369,204,74,24,0x7F9306FC1978938d5C1C57Bf6044dc67E07eeB8a,0xaC7bfAF518dF5Ed84d352691820fA223fd0853E0
4284,15627859,165640,9297283961,159040,6600,1802,31,0x00000000006c3852cbEf3e08E8dF289169EdE581,0x7CadfbA12a2764656B2EE2Ba13cBf221D0099A84
4285,15627859,36015,9297283961,35751,264,74,1624,0xC02aaA39b223FE8D0A0e5C4F27eAD9083C756Cc2,0x55684b89adF372CC3091975633bD7128da3a46Bc
4286,15627859,65194,9297283961,63402,1792,586,248,0x35CA26A7a7F3ca98F3e60BD94C139C892e45B6C3,0xE426a520d0Cbee2C76098fD9cdAf20036C20D0A7
4287,15627859,384151,9297283961,374371,9780,2834,14137,0x1111111254fb6c44bAC0beD2854e76F90643097d,0xD54e4f8A55247487dd7C8c59f14EE5c0c2889477
4288,15627859,21000,9297283961,21000,0,2,79,0xFffd3BDe62065352b32b81122B74706bfa8d5925,0x38a404D2e859572fab457ad9AdF3cd2d4781d718
4289,15627859,36027,9297283961,35751,276,74,2614,0xC02aaA39b223FE8D0A0e5C4F27eAD9083C756Cc2,0xD73e0DEf01246b650D8a367A4b209bE59C8bE8aB
4290,15627859,21000,9297283961,21000,0,2,25,0xc623483a440A6Fb5C0D41f8E30a9F3dF49a237Ad,0x79739dF810083fa71C8b98DE265a784741549ff8
4291,15627859,132389,9297283961,125921,6468,1682,19,0x00000000006c3852cbEf3e08E8dF289169EdE581,0x1FC756FD86a8c4Dd9773aD83e540dA0267419846
4292,15627859,237872,9297283961,231260,6612,1802,389,0x00000000006c3852cbEf3e08E8dF289169EdE581,0x91BF276C0721c123C578ac840567692e2fD89B43
4293,15627859,55936,9297283961,54992,944,138,4,0xFeeB4D0f5463B1b04351823C246bdB84c4320CC2,0x7FcBdF9c71a26ad4293E89E51239dA26A240104A
4294,15627859,21000,9297283961,21000,0,2,99,0xB111b3b8C23Ccff54E4a0aa6a435aF88C0096798,0x7c80455C1fFf509Cb171737F4FdCB13ea2603851
4295,15627859,21000,9297283961,21000,0,2,5,0x51DEC9cdf985bf1e828d57E78135443B2Cd1b5AF,0x1063704C670529e993045a8aA5Bb740e95132CaB
4296,15627859,166265,9297283961,159629,6636,1802,144,0x00000000006c3852cbEf3e08E8dF289169EdE581,0xd99881A272e14666a5b4394f9deeb383fa05F38B
4297,15627859,46187,9297283961,45615,572,138,5976,0x34Bc797F40Df0445c8429d485232874B15561728,0x2d3162890E0a81bB0F4A1F65E8878D20853f6216
4298,15627859,21000,9297283961,21000,0,2,1,0xc4f6865d0ce53c780B1Ba4fb7C83DD106ec49cE3,0x6585Ef58B6e6C5217794Be782c521C489CD76f24
4299,15627859,311260,9297283961,308524,2736,842,511,0x68b3465833fb72A70ecDF485E0e4C7bD8665Fc45,0xcAc03BC23964d8669bbdaDE110421A57AA055914
4300,15627859,73146,9297283961,65926,7220,1098,153,0x860a79124538c778D9AaFaE5971DCD5D979a1afB,0x34A1c1D3eD7185017e18469C25ceC8EA81F295c8
4301,15627859,46179,9297283961,45691,488,138,9,0x209e639a0EC166Ac7a1A4bA41968fa967dB30221,0x87de4Fa1b2048c3F477837f83394662BE298760f
4302,15627859,410023,9297283961,406443,3580,1162,4278,0x68b3465833fb72A70ecDF485E0e4C7bD8665Fc45,0x0acf1B98Ae3a2084B729797116B0F5aD8d86a3EE
4303,15627859,99244,9297283961,98636,608,138,37,0xA0b86991c6218b36c1d19D4a2e9Eb0cE3606eB48,0x348186d5743793b61E17325F38C557076B59c4e4
4304,15627859,527064,9297283961,526280,784,202,2129,0xd658A338613198204DCa1143Ac3F01A722b5d94A,0x10c16c7B8b1DDCFE65990ec822DE4379dd8a86dE
4305,15627859,39406,9297283961,38462,944,138,403,0x70fc957eb90E37Af82ACDbd12675699797745F68,0x1CeD4e3900c73A54eD775ef2740a4e38aC5b54e2
4306,15627859,291550,9297283961,288766,2784,842,855,0x68b3465833fb72A70ecDF485E0e4C7bD8665Fc45,0xb6047B161F5fC557e28376dD9BCb2cF01647b159
4307,15627859,1206871,9297283961,1206571,300,74,68,0x9ee91F9f426fA633d227f7a9b000E28b9dfd8599,0x0D81C5f52108701E4265459F594d6C3845053aad
4308,15627859,21000,9297283961,21000,0,2,4,0x8CC34902A73937d04bb0A53C4981F3178Ea19e0B,0x7191d8d6939a45F160CB3bf59FB0f0dFe2A06585
4309,15627859,21000,9297283961,21000,0,2,37,0x9bAfa5A5799C46071253316AAcEB449f6B64Bb35,0x44E3eBc39DBC73a293352C75E55c823B0bEA6854
4310,15627859,21000,9297283961,21000,0,2,1461,0xF4C7f558928003113ED4BCb6Cc85556852f0dF0a,0xcD7F7cC5E7D037ef9FC9940e64Fd083800518C94
4311,15627859,77569,9297283961,76901,668,138,1404,0xf1f955016EcbCd7321c7266BccFB96c68ea5E49b,0x47c62785133330467304Ae83Db4b4DD5fBb4Ce1b
4312,15627859,46113,9297283961,45625,488,138,148,0xb08A61d96108136439180Ad3F3e340A24e448f6B,0xCcE7daE7e8798AeF3f7cb1Fe639D3951Efa5DbBf
4313,15627859,36015,9297283961,35751,264,74,411,0xC02aaA39b223FE8D0A0e5C4F27eAD9083C756Cc2,0xe5cdeaDfB631b3B3fBe0386e8D71b50c68B37D9a
4314,15627859,79560,9297283961,79168,392,138,189,0x2b591e99afE9f32eAA6214f7B7629768c40Eeb39,0xFc22EeA4E8518474673c773Ebf5CadAd7af468fd
4315,15627859,146704,9297283961,140128,6576,1802,446,0x00000000006c3852cbEf3e08E8dF289169EdE581,0x79a069e0e7e9B646C8C9a5B329f926202eBa077f
4316,15627859,338527,9297283961,335211,3316,970,186,0x68b3465833fb72A70ecDF485E0e4C7bD8665Fc45,0x6BfE59e8fEaDDfBdBb97F7Da8c6B4550a8bD4ffd
4317,15627859,42000,9297283961,42000,0,2,646168,0x851E08e3E4bdc21a39D7F81140ED2ec8097D12c5,0x29D5527CaA78f1946a409FA6aCaf14A0a4A0274b
4318,15627859,377052,9297283961,373472,3580,1162,4,0x68b3465833fb72A70ecDF485E0e4C7bD8665Fc45,0x83C1fcc5956a27730919ffE52D08396d4827fBd6
4319,15627859,202055,9297283961,199295,2760,650,1893233,0xD1669Ac6044269b59Fa12c5822439F609Ca54F41,0xD2C82F2e5FA236E114A81173e375a73664610998
4320,15627859,94463,9297283961,94031,432,74,49,0xA0c68C638235ee32657e8f720a23ceC1bFc77C77,0x0565df3f5aad5a45D340B98D1e95F255e238cDc3
4321,15627859,146718,9297283961,140130,6588,1802,481,0x00000000006c3852cbEf3e08E8dF289169EdE581,0x263fd42F241E7ab5C2c03D1C01fcb90dc437bA2A
4322,15627859,200000,9297283961,193412,6588,1802,0,0x00000000006c3852cbEf3e08E8dF289169EdE581,0xA6dE2fE8E983C896F4ec61D567466ba524615CB8
4323,15627859,146852,9297283961,140188,6664,1810,76,0x00000000006c3852cbEf3e08E8dF289169EdE581,0x58ED8e76752539f387a2a6e040384D285D3973bD
4324,15627859,196057,9297283961,189573,6484,1738,2403,0x00000000006c3852cbEf3e08E8dF289169EdE581,0x74456CF397975601D7924Ee113BdA64F9024EFaB
4325,15627859,55923,9297283961,54979,944,138,7,0x19A4e33581c3b0ded84E6ce3Ba8515a4D45b5001,0xFE4E1E81081d7A351C3617626476cE571d10764E
4326,15627859,219396,9297283961,216624,2772,842,1457,0x68b3465833fb72A70ecDF485E0e4C7bD8665Fc45,0x43C1Bf1a33506d2d3f023a1F354e608e7784aC46
4327,15627859,63185,9047283961,62601,584,138,1,0xdAC17F958D2ee523a2206206994597C13D831ec7,0x6Dd7230B29b68Ff85f711a1c64B6d76624b3A7aA
4328,15627859,55904,9015832168,54960,944,138,131,0x011b0beAe3eC5953B4805b064cC78f6F892A99cC,0xC730d85a7CeB1a1a865D4f6235078e4Be3EcaCc8
4329,15627859,21000,9000000000,21000,0,2,132,0xf5EDc156Fa22C04eC56053a2EB70a45388d8ca50,0x721bF51c210ad66E94C67cE7b67b6f94eFBd5068
4330,15627859,225849,8980250875,223789,2060,522,109,0xEfF92A263d31888d860bD50809A8D171709b7b1c,0x15ABbbF9a511412f2E0546ef16abefbdA2CfA1dB
4331,15627859,21000,8980250875,21000,0,2,1,0x66930AFa1640368ef7de973fa75F446f46901Cee,0xB79a3F84359454c74d2919ABd8A69144B4eEd24e
4332,15627859,64000,8980250875,63392,608,138,1,0xdAC17F958D2ee523a2206206994597C13D831ec7,0xC25C16cdDFd817f32a4c2A00C519461cC38B60EB
4333,15627859,21000,8980250875,21000,0,2,0,0x66930AFa1640368ef7de973fa75F446f46901Cee,0xf190C330F115758052f86EA38f038E03b7638F47
4334,15627859,21000,8900000000,21000,0,2,4,0xE36067a4c51ff6Cb7Fb6F97D1931bb27a468960B,0xc3FE7b8d4aBd70B9882Fa1b600e8F336af219dA4
4335,15627859,181476,8797283961,179912,1564,394,454,0x1Fa8559e873f698292766790AeCf8080A66433F6,0x80c8Ed1080A2D8AEC288136Df3044b5c55f47E2C
4336,15627859,157391,8797283961,155355,2036,522,262,0x07F72839D7A71A117fA859cBA643c9291EEba921,0x1B352185145d1aEBCB151F7C28257682c3375336
4337,15627859,43633,8797283961,43157,476,138,430,0xb18380485f7bA9C23Deb729bEDD3A3499Dbd4449,0xcc4405Ee3eE4Db06E96B8CF74f7A55B7a9D194f5
4338,15627859,21000,8797283961,21000,0,2,57301,0x1b213D9d7FF0B1Fe5f6C41144D27ABEAc6A54359,0xCfC0F98f30742B6d880f90155d4EbB885e55aB33
4339,15627859,120000,8797283961,119416,584,138,13590,0xdAC17F958D2ee523a2206206994597C13D831ec7,0x6EDF968DA408a9640b8865826429a977a11C5048
4340,15627859,21000,8797283961,21000,0,2,113046,0x5A33dF83Ff3BcDEA8080a7FC8CE096985579d365,0x6081258689a75d253d87cE902A8de3887239Fe80
4341,15627859,62259,9798283961,61603,656,138,113047,0x95aD61b0a150d79219dCF64E1E6Cc01f0B64C4cE,0x6081258689a75d253d87cE902A8de3887239Fe80
4342,15627859,269268,8797283961,237916,31352,5514,112,0xA0c68C638235ee32657e8f720a23ceC1bFc77C77,0x88888F31f9aB8e195B7B05d717f4aBaaBaeF33a0
4343,15627859,147661,8797283961,147445,216,74,171,0x03893669C978033544a160718E3d1a3226845de6,0xCEF557e276AE24293904BA0F2bbbD1FBa8Ef3338
4344,15627859,21000,8797283961,21000,0,2,102637,0x4522c0843A9cfF9d1807cb2a8acC9BDF5B3960C4,0x2Db1D8CdF1Abe8C70b531a790CDf2FF38aecF652
4345,15627859,250000,8797283961,250000,0,2,45337074,0xaAB9aA0E3b65489A245Fe5E6eCe01f8009902734,0xEA674fdDe714fd979de3EdF0F56AA9716B898ec8
4346,15627859,250000,8797283961,250000,0,2,45337075,0x884cD6d146ebF26F26fC7dD6Cdb4FEd43Fd28a0a,0xEA674fdDe714fd979de3EdF0F56AA9716B898ec8
4347,15627859,250000,8797283961,250000,0,2,45337076,0x4be576723a725047761495139F132C3Da6336AC2,0xEA674fdDe714fd979de3EdF0F56AA9716B898ec8
4348,15627859,250000,8797283961,250000,0,2,45337077,0x6A08A641E5C0BaB1d465345fF93704763Ff26249,0xEA674fdDe714fd979de3EdF0F56AA9716B898ec8
4349,15627859,250000,8797283961,250000,0,2,45337078,0x270dF2B1Cf75c16f68a9aa950E0126B6D51348D0,0xEA674fdDe714fd979de3EdF0F56AA9716B898ec8
4350,15627859,250000,8797283961,250000,0,2,45337079,0xAd266a02fc66e945541842aC5587D8891B9Ce034,0xEA674fdDe714fd979de3EdF0F56AA9716B898ec8
4351,15627859,250000,8797283961,250000,0,2,45337080,0xEfE1Ef928683bE1a9770A0aEf525f2a37Ed0f48F,0xEA674fdDe714fd979de3EdF0F56AA9716B898ec8
4352,15627859,250000,8797283961,250000,0,2,45337081,0xD227ca993ef9574704Fa35c63b57Ea99B68cA8B2,0xEA674fdDe714fd979de3EdF0F56AA9716B898ec8
4353,15627859,53915,8797283961,53427,488,138,184,0x6de7aC835EC6841Af9b94fd1273dB83B8d69e3f7,0xde7563d513eb0A15a46062Be03BBaE021C53aD6f
4354,15627859,250000,8797283961,250000,0,2,45337082,0x555a773A21883F3b2e3b2cC0535750eC8c7E31F1,0xEA674fdDe714fd979de3EdF0F56AA9716B898ec8
4355,15627859,250000,8797283961,250000,0,2,45337083,0x0536b0f9CAd3d761aE673D5Bde10Bb96Aa6B9d89,0xEA674fdDe714fd979de3EdF0F56AA9716B898ec8
4356,15627859,250000,8797283961,250000,0,2,45337084,0xb32f8b2dC51a4368B77024eEecF78F83698FC849,0xEA674fdDe714fd979de3EdF0F56AA9716B898ec8
4357,15627859,181476,8797283961,179912,1564,394,651,0x1Fa8559e873f698292766790AeCf8080A66433F6,0xFae96F816876AE1BBec61A810A4F8C033303F206
4358,15627859,585100,8797283961,574756,10344,3146,14,0x3b3ae790Df4F312e745D270119c6052904FB6790,0x0d87933f4d865D120992C697250cb7baC0aCB550
4359,15627859,229678,8797283961,228218,1460,522,11613,0xF3E778F839934fC819cFA1040AabaCeCBA01e049,0xF165D353abDDb7Cb00052d610254249FCc12a8C7
4360,15627859,275602,8797283961,274414,1188,338,2,0x1111111254fb6c44bAC0beD2854e76F90643097d,0xae4B4332fB78162C3512Eb53CAe038D1BAC135De
4361,15627859,181458,8797283961,179906,1552,394,474,0x1Fa8559e873f698292766790AeCf8080A66433F6,0x6264e1269e92B47443cDff51e6fcf29a570e5cb8
4362,15627859,21000,8797283961,21000,0,2,1,0xDe5b12891eab03aA07517840F6BcC9fC7a40fEA5,0x45a63D6C2d8E8DA5469Cc6590Dfc1f7075AD9443
4363,15627859,181476,8797283961,179912,1564,394,455,0x1Fa8559e873f698292766790AeCf8080A66433F6,0x9553776EfB2907EFC8bceEc5FA9658bB1ad48993
4364,15627859,192733,8734628736,191569,1164,338,149,0x1111111254fb6c44bAC0beD2854e76F90643097d,0x913c9Cd8dF10a53057B92FE452Bc5B0F7A5Dea4D
4365,15627859,37223,8698349037,36567,656,138,278,0x2C9023bBc572ff8dc1228c7858A280046Ea8C9E5,0x6EBB37C387f073Db87f53A391a343D18044d534A
4366,15627859,105000,8698349037,105000,0,2,138565,0x194ffaa36BA31413a25D9Bcd19610cc6c9CFae87,0x974CaA59e49682CdA0AD2bbe82983419A2ECC400
4367,15627859,300000,8698349037,299332,668,138,150322,0x3845badAde8e6dFF049820680d1F14bD3903a5d0,0x1C727a55eA3c11B0ab7D3a361Fe0F3C47cE6de5d
4368,15627859,80000,8145803216,79056,944,138,1,0x4Fabb145d64652a948d72533023f6E7A623C7C53,0x52E454866C33B56e7D085cfD3a9Efbb23d85e735
4369,15627859,147225,8145803216,147161,64,10,5843,0x3d76cd9723e0cc8875907CF944c147eE4baFB29E,0x24B23bB643082026227e945C7833B81426057b10
4370,15627859,25200,8145803216,25200,0,2,217,0xD72C32D8b3207FD5f672e3f9f49FD6012c1f62D0,0x515742623E3c51eEF09a080d970D3E32B6d56995
4371,15627859,80000,8145803216,79056,944,138,0,0x0763fdCCF1aE541A5961815C0872A8c5Bc6DE4d7,0x8A84d81326f584c3818bcFC08AB6daccd8ADcd54
4372,15627859,102530,8145803216,100174,2356,586,591,0x75cdA57917E9F73705dc8BCF8A6B2f99AdBdc5a5,0x2EEE62f7501A9b4Fd0ef6bbDAa27E6444F3A81d4
4373,15627859,102530,8980250875,100174,2356,586,592,0x75cdA57917E9F73705dc8BCF8A6B2f99AdBdc5a5,0x2EEE62f7501A9b4Fd0ef6bbDAa27E6444F3A81d4
4374,15627859,191077,8145803216,190177,900,266,154,0xd588b586D61C826A0e87919b3D1a239206d58bf2,0xFF714e5735424170352E19f0Fcd4Ccb87E86BF2C
4375,15627859,315994,8145803216,313590,2404,586,16,0xEfF92A263d31888d860bD50809A8D171709b7b1c,0xE71814755D42816716097a6a2EEC5573Aab76768
4376,15627859,21000,8026163719,21000,0,2,112,0x9f10a9DeA0aDD08e62109160Ee42D0cF800F5e0C,0xA554849eBb0E2BBB668f69541d58Bd42ddbc86cc
4377,15627859,58516,8026163719,57572,944,138,3,0x7D1AfA7B718fb893dB30A3aBc0Cfc608AaCfeBB0,0xD7E56Fc27F5CB9a16Ec772FE52b639C6f1c93D07
4378,15627859,298225,8026163719,295429,2796,842,227,0x68b3465833fb72A70ecDF485E0e4C7bD8665Fc45,0xB6D1aa613F99AcA09a4aE736C37B0d9073f0265F
4379,15627859,64200,8017479201,63488,712,202,3479100,0x5f65f7b609678448494De4C87521CdF6cEf1e932,0xd24400ae8BfEBb18cA49Be86258a3C749cf46853
4380,15627859,224781,8017479201,222969,1812,458,144,0xEfF92A263d31888d860bD50809A8D171709b7b1c,0x00dBF2d57C07bBBFcd8c47c6132055e73fee8871
4381,15627859,213715,8006347540,210147,3568,1162,166,0x68b3465833fb72A70ecDF485E0e4C7bD8665Fc45,0x6930c41EAe5a621e663FD3e2CFaDade9C1D3521c
4382,15627859,230910,8000000000,228874,2036,522,25,0x1fdD76e18dD21046b7e7D54C8254Bf08B239e4D9,0x764616614012F45377C2e9A6D565a9bF86B29B07
4383,15627859,90188,7984752916,89248,940,202,54,0x59468516a8259058baD1cA5F8f4BFF190d30E066,0x01Bf514344dD25906E3F001e98dBE1f52391b721
4384,15627859,288750,7830010246,285082,3668,906,0,0x197492CCB4B1acaAAcd43432657A17832E36AB49,0xBA4048e7946F128B73C893914A6181F2201CC51F
4385,15627859,46103,7807283961,45615,488,138,120,0x34Bc797F40Df0445c8429d485232874B15561728,0x2A275B6280534124bfb0Ca70cb8C1a47a4f22B5b
4386,15627859,30000,7797283961,30000,0,2,640,0x388C818CA8B9251b393131C08a736A67ccB19297,0xf573d99385C05c23B24ed33De616ad16a43a0919
4387,15627860,350000,13047523556,349392,608,138,6925046,0xA0b86991c6218b36c1d19D4a2e9Eb0cE3606eB48,0x46340b20830761efd32832A74d7169B29FEB9758
4388,15627860,55950,12100000000,55006,944,138,5,0x8B3192f5eEBD8579568A2Ed41E6FEB402f93f73F,0x781C4c1696339F8207BD95BD742A0b116Cd175f4
4389,15627860,119135,11940000000,115819,3316,1162,28,0x33C98857E10c1514c8f8699DD5c5CEb692098ccD,0x9D36f87b841fbf59Df518F84487260933282F229
4390,15627860,160386,11735859824,159374,1012,202,6,0x401F6c983eA34274ec46f84D70b31C151321188b,0x850Eb0195a28e202fDEc9aDe2cc6511c69d6142D
4391,15627860,8000000,10776301050,7999936,64,10,15098,0x88266E58a66cB5b1880814F6BFe5E12b68832B9D,0xb2AA4a5DF3641D42e72D7F07a40292794dfD07a0
4392,15627860,225836,10365185103,223788,2048,522,778,0xEfF92A263d31888d860bD50809A8D171709b7b1c,0xA5E2A4105397ABc662827f5daA6D0F449B71bA37
4393,15627860,260357,10365185103,254921,5436,1676,70,0x881D40237659C251811CEC9c364ef91dC08D300C,0xb231E5B824119E2a7AE637eb6a68bBfAfa059af6
4394,15627860,50000,10183000000,49332,668,138,0,0xdAC17F958D2ee523a2206206994597C13D831ec7,0xC150Efc715941acdf3458adB8a43ae0fD6f09ac2
4395,15627860,135599,9865185103,128835,6764,1698,130,0x00000000006c3852cbEf3e08E8dF289169EdE581,0x3485Ca538e61753a6b887ef41b7439b5bA2CE795
4396,15627860,94795,9865185103,94199,596,138,65,0xdAC17F958D2ee523a2206206994597C13D831ec7,0x5A3BB07FbDfB12C2F9e4Ace91aB83A7825A9b7bE
4397,15627860,377196,9865185103,373580,3616,1162,204,0x68b3465833fb72A70ecDF485E0e4C7bD8665Fc45,0x5f614de434C90435e7DEE65bb7E6D958F180912D
4398,15627860,46567,9865185103,46079,488,138,17,0x08038283d6710bF62C8Ac76E53E6dA8E8dc4f787,0x2db9c72646D8a4843f767C78439BC67aeC4Dd415
4399,15627860,21000,9865185103,21000,0,2,373,0xa04c72592849B57c6830B36C43f77faC9A7886B2,0x9Ad83e1fBBF7d4d86f5B395Be4002e8679314859
4400,15627860,21000,9865185103,21000,0,2,80,0x5D1ff0678ED681A68936720C75F9cfB1a63Db266,0x38a404D2e859572fab457ad9AdF3cd2d4781d718
4401,15627860,46323,9865185103,45835,488,138,26,0xB60C2019DDB48623ed1d134b2bb42F437c6A0202,0x814444012a50A540bA3d1C80a05227F0d06C8b7A
4402,15627860,46631,9865185103,46059,572,138,5977,0xaE351b8Ae55B69A5007618E598dDe89d0a092c37,0x2d3162890E0a81bB0F4A1F65E8878D20853f6216
4403,15627860,138672,9365185103,138468,204,74,122,0x4556561740B7B5F858967A6a4E54e506609704Bd,0xCF06063e20832b047985789A2dF9EAf92f746c76
4404,15627860,304795,9302529878,303191,1604,402,96,0x1111111254fb6c44bAC0beD2854e76F90643097d,0x900b00C0cd0CEEFdC27855e2bC76A8c2D5c192BC
4405,15627860,130610,9000000000,128730,1880,330,403,0xc71930B83cbAbfeb35BeDaAF2122e41595179B14,0xe5F55468585ef91CF1a87aa3aF4c830FA7AE78dE
4406,15627860,21000,8980250875,21000,0,2,583,0x15F8733104b67F17158c417d32172Eea56C3b61D,0x8aEF89129806B23C7930DFdf2B46E22ae1849c49
4407,15627860,90000,8980250875,90000,0,2,3479101,0xE8E18b65561979275601530018c2b0BBcE0720a9,0xd24400ae8BfEBb18cA49Be86258a3C749cf46853
4408,15627860,90000,8980250875,90000,0,2,3479102,0x2993002a2E36Cd09d9708B39c00682Be1dDc31F8,0xd24400ae8BfEBb18cA49Be86258a3C749cf46853
4409,15627860,257506,8698349037,254402,3104,714,30527,0x00000000C2Cf7648c169b25ef1C217864bFa38cC,0x98337627A984Cf34924755f7d462177b916f3bC8
4410,15627860,316008,8698349037,313592,2416,586,138,0xEfF92A263d31888d860bD50809A8D171709b7b1c,0xa043720AA3e49F6898E1223d760b12ECAD5242D9
4411,15627860,3000000,8698349037,2998176,1824,242,6931,0xbD6a2bfcCFc6a4f7EcE6c005d50D01428Fb9c086,0x0124D0fA0DfB1430dFcff16eC6A96945E7a0BC10
4412,15627860,1500000,8698349037,1496348,3652,1162,12315,0x8ed11443414197f6f63e13c77D679F3941E8b522,0x09f4DE4db8B52E666e03b22D9e3785181deC85D5
4413,15627860,243616,8698349037,240092,3524,1290,39470,0x7Ed7382D0EcfeE9Bf1085671CCe4b0A5774a6E89,0x79b7a69d90c82E014Bf0315e164208119B510FA0
4414,15627861,21000,18000000000,21000,0,2,33034,0x7FFbF20B2354052D18A49743a2cE6Df1c29E6443,0xBd9B34cCbb8db0FDECb532B1EAF5D46f5b673fE8
4415,15627861,5049560,17000000000,5042424,7136,1098,285,0x0a39DA505DfB5E0BBc6bd84428281A8ba1bC7753,0x495E889d1A6cEB447a57dcc1C68410299392380c
4416,15627861,77320,13470376313,76724,596,138,90,0x467719aD09025FcC6cF6F8311755809d45a5E5f3,0xD21e14023e8d247e2Ac4C7aDfC1d25441E492278
4417,15627861,222222,12000000000,220658,1564,394,290,0x1Fa8559e873f698292766790AeCf8080A66433F6,0x249DB9e6324aFF13Fb5dB17D3e2e9766fDfECC48
4418,15627861,86661,11220568359,86005,656,138,355150,0x1f9840a85d5aF5bf1D1762F925BDADdC4201F984,0x7abE0cE388281d2aCF297Cb089caef3819b13448
4419,15627861,21000,11000000000,21000,0,2,0,0xcd92086d21c3951979628325E11F341cb56234cF,0x33e61295b890E24aFB754C949dD2b0d5d3321A8b
4420,15627861,90000,10539397669,90000,0,2,784408,0xaD8De3Ea80e2f876c29f731d775497a454ce0842,0xcaD621da75a66c7A8f4FF86D30A2bF981Bfc8FdD
4421,15627861,70893,10497731930,69949,944,138,1,0x72B169AD8aF6c4FB53056b6a2A85602Ad6863864,0x89b1e7e50aa3692261897882C80cE1EC37Ec8641
4422,15627861,165310,10497731930,160518,4792,970,56,0x9d763Cca6A8551283478CeC44071d72Ec3FD58Cb,0x04B63973Ee7640264B2FaD75ad3c7D0654598A7b
4423,15627861,21000,10495347521,21000,0,2,57,0xCBD6832Ebc203e49E2B771897067fce3c58575ac,0xB8cBd04660933392F6F5Bb7269418f4f0D49b802
4424,15627861,21000,10495347521,21000,0,2,329,0xCBD6832Ebc203e49E2B771897067fce3c58575ac,0x0707930FbEbD044dCAE031076a8bAb52a52cb6Af
4425,15627861,84567,10380709739,84023,544,202,56,0xdA3a5CF73575984E6f52dB8A035d1D91218Ade59,0x37F92f5301645E4e5cD415148E9eA34069f587C3
4426,15627861,100000,10075669380,99392,608,138,2,0xA0b86991c6218b36c1d19D4a2e9Eb0cE3606eB48,0x89F8AFb76bda495653aA8Db079a73A41d68c50cc
4427,15627861,320654,10000000000,318414,2240,522,229,0x25553828F22bDD19a20e4F12F052903Cb474a335,0x91aBafF87138FAD31389A541e2749e9d095b364B
4428,15627861,21000,9990000000,21000,0,2,0,0x6dfc34609a05bC22319fA4Cce1d1E2929548c0D7,0xe7C6f258AE50887F3F0C398C12A1B18e8AB2558F
4429,15627861,21000,9980250875,21000,0,2,4,0x03476A65eFD691bD32CDa69EA320a5BadDeAD777,0x3ABf4086f390954D095b5aEaaa05e6DB63e45132
4430,15627861,21000,9498731930,21000,0,2,8345,0x4938df248CFd0F259c561Fa5c1d95Af32275DD8e,0x770E66bf008C0204a8231F4ea5C3Af12e5f580e4
4431,15627861,207128,9497731930,207128,0,2,3492276,0xe3AC6197fA32A3a1aCd0Da6F4718a936E701714d,0x56Eddb7aa87536c09CCc2793473599fD21A8b17F
4432,15627861,175110,9497731930,173546,1564,394,456,0x1Fa8559e873f698292766790AeCf8080A66433F6,0x5F5cCe1eA039Bb5E4A798C54450CF4c59c76BFEd
4433,15627861,207128,9497731930,206460,668,138,4708700,0x5A98FcBEA516Cf06857215779Fd812CA3beF1B32,0x28C6c06298d514Db089934071355E5743bf21d60
4434,15627861,740000,9497731930,728512,11488,2506,55556,0x45bb69B89D60878d1e42522342fFCa9F2077dD84,0x7663C5790E1eBf04197245d541279D13f3c2f362
4435,15627861,237614,9497731930,233998,3616,1162,1,0x68b3465833fb72A70ecDF485E0e4C7bD8665Fc45,0xd95D30fd3e089816d14972B15d4dC4E2DF9D0cb4
4436,15627861,207128,9497731930,207128,0,2,3199174,0xa38da119E19EEacF4f85d54AA95efaF8F3a3d66B,0x9696f59E4d72E237BE84fFD425DCaD154Bf96976
4437,15627861,147320,9497731930,137552,9768,1418,71,0x7732674B5E5FfeC4785AEFdAEa807EeCA383B5e6,0x5012e2f6b9d81e96622BFA2F2764fcB406d8e6C1
4438,15627861,207128,9497731930,206460,668,138,4468945,0x320623b8E4fF03373931769A31Fc52A4E78B5d70,0x21a31Ee1afC51d94C2eFcCAa2092aD1028285549
4439,15627861,207128,9497731930,207128,0,2,1679526,0x73005c43c6A82540dabf4115513F5e3A74D5d526,0x4976A4A02f38326660D17bf34b431dC6e2eb2327
4440,15627861,207128,9497731930,207128,0,2,4232334,0xfc7ec79c814ff15e2Ab1301EE21dEAB8a1e76eC8,0xDFd5293D8e347dFe59E90eFd55b2956a1343963d
4441,15627861,207128,9497731930,207128,0,2,4468946,0x92bAC2Baa43c31C7a25EB5B5bcf7a0BB0F66a010,0x21a31Ee1afC51d94C2eFcCAa2092aD1028285549
4442,15627861,207128,9497731930,207128,0,2,4708701,0xc2A69B8b86bb64f19344ff3201AA2fBfc89D3311,0x28C6c06298d514Db089934071355E5743bf21d60
4443,15627861,42000,9497731930,42000,0,2,329527,0x3981CFC72908a33ce93b3Ec353b80f9E4FF4967e,0x9430801EBAf509Ad49202aaBC5F5Bc6fd8A3dAf8
4444,15627861,500000,9497731930,499392,608,138,1262738,0xdAC17F958D2ee523a2206206994597C13D831ec7,0x89e51fA8CA5D66cd220bAed62ED01e8951aa7c40
4445,15627861,152293,9497731930,151661,632,138,21,0xc5fB36dd2fb59d3B98dEfF88425a3F425Ee469eD,0x01FA80E365BBd3c7c73274df7318dd86506505CB
4446,15627861,2000000,9497731930,1997904,2096,522,224,0x7a250d5630B4cF539739dF2C5dAcb4c659F2488D,0x560259a1a735299086661820D6A9da50d82C8E1A
4447,15627861,294323,9497731930,289447,4876,1420,176,0x881D40237659C251811CEC9c364ef91dC08D300C,0xA9FE7dCdb35B7921BeDA5BE139eB7b6c218B7E96
4448,15627861,21000,9497731930,21000,0,2,2,0x500A23B6DbC9125D6d2158899D6A2d7D23a6C496,0xc26a9765dF990B9a800ce5aC05FA0503726857e4
4449,15627861,21000,9446553581,21000,0,2,18,0x52A258ED593C793251a89bfd36caE158EE9fC4F8,0x58dacf1cA22BA8279E1D1cD356b00863cb01E20B
4450,15627861,100000,9147731930,99056,944,138,7994,0x011b0beAe3eC5953B4805b064cC78f6F892A99cC,0x11191bcfe30c6aE7bBEF74c6De97c8D52FF957F9
4451,15627861,174932,9147731930,171256,3676,1162,10,0x68b3465833fb72A70ecDF485E0e4C7bD8665Fc45,0xF162fC5D1174449137E0536923495F3bD9a1380c
4452,15627861,163897,8997731930,154409,9488,3018,523,0x00000000006c3852cbEf3e08E8dF289169EdE581,0x67be0553cea5dc478098D96964E26adF31C24e01
4453,15627861,208159,8997731930,204943,3216,1034,13,0x68b3465833fb72A70ecDF485E0e4C7bD8665Fc45,0x18bD1d8e0bcC62E4E7066871d9116BD47A338DF5
4454,15627861,2034631,8997731930,1881867,152764,52498,4021,0x00000000006c3852cbEf3e08E8dF289169EdE581,0x491BeFAC53aAc201E97Cd6F4C750e4A958d22D46
4455,15627861,180000,8997731930,179668,332,138,22,0xa87492ec6246c71A1e026B042BEb78Ec295e8F07,0x049d41d878C90369b3B5C7689Be950B0a2fc1C26
4456,15627861,163784,8997731930,157208,6576,1802,379,0x00000000006c3852cbEf3e08E8dF289169EdE581,0x9F96c987f70aa929118e6B333e36a06742785806
4457,15627861,46157,8997731930,45669,488,138,13,0x845a007D9f283614f403A24E3eB3455f720559ca,0x6b6fAd6482E8d1F938D6F2075462dDD18a626964
4458,15627861,90000,8997731930,89056,944,138,0,0xdAC17F958D2ee523a2206206994597C13D831ec7,0xd095cBF84929606C1EECaB57245CaBa2aEF769E6
4459,15627861,175971,8997731930,173199,2772,842,225,0x68b3465833fb72A70ecDF485E0e4C7bD8665Fc45,0xcc533E119b8620F77F546D6C8f6D81BE8EaDF127
4460,15627861,21000,8997731930,21000,0,2,95,0x29314888bF57d33cb95c7AE396211f2e7Fa81351,0x81Cd2e351b361D66848B507ba5dca8aABB3D18dE
4461,15627861,21000,8997731930,21000,0,2,6,0x5a3850a9159d64275D46fbEEceF7101b852c349C,0xA5D2ECB35D5AFb78580955a2f3f9c57610063d3f
4462,15627861,210208,8997731930,207460,2748,842,1355,0x68b3465833fb72A70ecDF485E0e4C7bD8665Fc45,0xF8FD771c7Bc7139269Ae006e4FaC6FD02c830A3c
4463,15627861,156289,8997731930,149801,6488,1746,398,0x00000000006c3852cbEf3e08E8dF289169EdE581,0x7C44120fDFcc8c8F9f87c013C14e4D5fe014Ae02
4464,15627861,330921,8997731930,326937,3984,1226,399,0x68b3465833fb72A70ecDF485E0e4C7bD8665Fc45,0xD7bCBf8B462e5CE6C0Dfb72d55957E8dD4A99A93
4465,15627861,53915,8997731930,53427,488,138,98,0x6de7aC835EC6841Af9b94fd1273dB83B8d69e3f7,0xc4Baef35b2D54877343C7e20E46abD7985947580
4466,15627861,100569,8997731930,100517,52,10,139,0x1F78bF06b1b14aaF29833Efa371fC090e11D1420,0xFF2C00c056Af3bF2dad57400C8249DEf4744AF7A
4467,15627861,55951,8997731930,55007,944,138,16,0xf88b9eBB1bc3b6DD28A47f6910DA97E530403a0f,0x3492A42DB528C7963F088518f3311c81Fd45Df5e
4468,15627861,21000,8997731930,21000,0,2,29,0xc623483a440A6Fb5C0D41f8E30a9F3dF49a237Ad,0x04ECb6116f4f53A862e25538a071F0627fD2B66A
4469,15627861,31582,8997731930,31582,0,2,3571,0x4545484255248A57396e081FA1d5836395446170,0xCE222910bA7524cADc75DDC7c57Ec5b97E8bFfc9
4470,15627861,89233,8997731930,89169,64,10,29,0xab500163171C6eC6F26404434993bF3d5Ba13527,0xA20f4DA763Df90C81421F9bA3D59b64A0c8c8cE3
4471,15627861,50719,8997731930,50111,608,138,128,0xdAC17F958D2ee523a2206206994597C13D831ec7,0x2a40229B267F5aBfD0A5d177F9c3EF5f0d55C8B0
4472,15627861,287426,8997731930,285102,2324,522,226,0x283Af0B28c62C092C9727F1Ee09c02CA627EB7F5,0x57679F905F9618d50a638cc1fe272003A831cec1
4473,15627861,46267,8997731930,45691,576,74,54,0x283Af0B28c62C092C9727F1Ee09c02CA627EB7F5,0x3ACA969EB5FC9612187d1C9537f7FC012F2ed6a5
4474,15627861,46124,8997731930,45636,488,138,17,0x07A7a80cB340E72525E51bF0699b10dc57AdD06B,0x675964a3420d5B749f4F07cCB22138FDc06B9b11
4475,15627861,21000,8997731930,21000,0,2,415,0x885cb1217070bc7e05661a6B2a906Ce3d9cea705,0xD0471582c70d35B2A1928552F4D0f82fE4C6cFBa
4476,15627861,21000,8997731930,21000,0,2,62,0xC0aE28fD7256c9b8b87EF74d2cb47d6b9fFa7d68,0x74b2322EcC16ce486aBC45845a833de48B200475
4477,15627861,55760,8997731930,54816,944,138,1293,0xd0c59798F986d333554688cD667033d469C2398e,0xBAceea144d035A70Ba8c8e2F4E9634feCFFb1553
4478,15627861,46111,8997731930,45623,488,138,39,0xb087EC2cf65fa9372cF61A20602BD37399837985,0xE39c69a3ee0F553ad70b27622e4dAEb2225fB1b3
4479,15627861,297183,8997731930,293895,3288,1034,365,0x68b3465833fb72A70ecDF485E0e4C7bD8665Fc45,0xe3108157338a6038410D18A2D70F2Fe579cA7414
4480,15627861,46769,8997731930,46197,572,138,31,0x9FE9caA2c7551520FfAE6b8FA126eeBf99ab5f3B,0x67798826B9FE74b12bDf20450E00dd754E5AB29C
4481,15627861,36015,8997731930,35751,264,74,777,0xC02aaA39b223FE8D0A0e5C4F27eAD9083C756Cc2,0xea79b1f6EA30a2DccB7C066Da6204fBf4131BD2C
4482,15627861,150756,8997731930,150692,64,10,1,0x65c2e54a4c75ff6da7b6B32369c1677250075fb2,0xe2C897C54B99E6BFabd6a23D7449C497a3fbc2a2
4483,15627861,77502,8997731930,76846,656,138,1780,0x0E74417b5A86BB99E6Bd27Cd4EF8772C8eeA8310,0xB972C02761e51C9C502636c5DBF56635b41c1C26
4484,15627861,76920,8997731930,76480,440,138,3,0xaf36b103Bb8970eD36526b69F9F9d6c7362f4762,0x7D35286C7d6864Cf6A61b4EC90F3d2FB6F8C7935
4485,15627861,143727,8997731930,143523,204,74,0,0xaEab9eCBfae9A0ec5D6035c887D4D115aBcAe1D0,0x8BA3719B8eF5Dfc3CEF00Df337CDf16e26456028
4486,15627861,92000,8997731930,91484,516,146,783,0xC02aaA39b223FE8D0A0e5C4F27eAD9083C756Cc2,0x6040a8F2C2BB3789BAfb6232114ff941B0e1bE16
4487,15627861,72878,8997731930,71006,1872,458,160,0xFbdDaDD80fe7bda00B901FbAf73803F2238Ae655,0xB78F8440a21a3128439BE04ac257703EE549a41E
4488,15627861,303956,8997731930,300720,3236,1098,29,0xC36442b4a4522E871399CD717aBDD847Ab11FE88,0xc01f46f418B9D9BACDCaf9453E8F0f1ca818C925
4489,15627861,299359,8997731930,296159,3200,906,232,0x68b3465833fb72A70ecDF485E0e4C7bD8665Fc45,0xa7C1d32B4bB7155Ad5e9e53F472b9CE61BB37ddc
4490,15627861,21000,8984752916,21000,0,2,1,0x03476A65eFD691bD32CDa69EA320a5BadDeAD777,0x37B53BA6E065A1970719d66FE54d6F9b902B7A17
4491,15627861,21000,8984752916,21000,0,2,1,0x03476A65eFD691bD32CDa69EA320a5BadDeAD777,0x96d36263bE0fBE5328CCC26AFA22439037870aFa
4492,15627861,90000,8980250875,90000,0,2,3479103,0xE8E18b65561979275601530018c2b0BBcE0720a9,0xd24400ae8BfEBb18cA49Be86258a3C749cf46853
4493,15627861,90000,8980250875,90000,0,2,3479104,0x5d25b5A8299561cA2bafA55Bc018D42F7d170434,0xd24400ae8BfEBb18cA49Be86258a3C749cf46853
4494,15627861,64200,8980250875,63488,712,202,3479105,0x5f65f7b609678448494De4C87521CdF6cEf1e932,0xd24400ae8BfEBb18cA49Be86258a3C749cf46853
4495,15627861,64200,8980250875,63488,712,202,3479106,0x5f65f7b609678448494De4C87521CdF6cEf1e932,0xd24400ae8BfEBb18cA49Be86258a3C749cf46853
4496,15627861,351400,8980250875,349864,1536,458,3479107,0x5f65f7b609678448494De4C87521CdF6cEf1e932,0xd24400ae8BfEBb18cA49Be86258a3C749cf46853
4497,15627861,138107,8980250875,137531,576,74,3479108,0x485b9a41e8BF06E57BB64c6Ba7cB04f9d53D2d76,0xd24400ae8BfEBb18cA49Be86258a3C749cf46853
4498,15627861,351400,8980250875,349804,1596,458,3479109,0x5f65f7b609678448494De4C87521CdF6cEf1e932,0xd24400ae8BfEBb18cA49Be86258a3C749cf46853
4499,15627861,56659,8547731930,55715,944,138,28,0xAD13C2a8d418d01F3236F4d8b9d724575a4e9d24,0x2d90Fa49f5BEFfE4Ce9Ba7e461B2D53E911FAEE6
4500,15627861,199647,8497731930,198239,1408,394,2,0x3b3ae790Df4F312e745D270119c6052904FB6790,0xC6713011d33cCA99670887c387112cB5191F4D96
4501,15627861,56659,8497731930,55715,944,138,10,0x12b6893cE26Ea6341919FE289212ef77e51688c8,0x17D1D8DeF765263Ff23F916d2c00Da0FC9E43E00
4502,15627861,181458,8497731930,179906,1552,394,59,0x1Fa8559e873f698292766790AeCf8080A66433F6,0x05f7d005A8208D336Bb7f0fE095565d811ED0dfa
4503,15627861,196246,8497731930,195878,368,138,0,0x8652168693827ff341f2ad5AD9a091f2A975710A,0x246262b41f9C78c455719b84C31C7944A5CE1d7A
4504,15627861,435855,8000000000,427683,8172,2378,57,0xc8d7899F22bc4995C8176e3f2a5Ba3F5e87D95E5,0xBdded97972826D81caA65Bae117eF81b1DbF79d3
4505,15627861,300000,7984752916,299392,608,138,150323,0xA0b86991c6218b36c1d19D4a2e9Eb0cE3606eB48,0x1C727a55eA3c11B0ab7D3a361Fe0F3C47cE6de5d
4506,15627861,48506,7984752916,47530,976,202,890829,0xdAC17F958D2ee523a2206206994597C13D831ec7,0x340d693ED55d7bA167D184ea76Ea2Fd092a35BDc
4507,15627861,21000,9877217573,21000,0,2,890830,0xfD2b0E8AC7D0abC52637591C70B19eCc89ecAd34,0x340d693ED55d7bA167D184ea76Ea2Fd092a35BDc
4508,15627861,57262,14791526711,56286,976,202,890831,0xA0b86991c6218b36c1d19D4a2e9Eb0cE3606eB48,0x340d693ED55d7bA167D184ea76Ea2Fd092a35BDc
4509,15627861,57250,11707429085,56286,964,202,890832,0xA0b86991c6218b36c1d19D4a2e9Eb0cE3606eB48,0x340d693ED55d7bA167D184ea76Ea2Fd092a35BDc
4510,15627861,57262,7892019769,56286,976,202,890833,0xA0b86991c6218b36c1d19D4a2e9Eb0cE3606eB48,0x340d693ED55d7bA167D184ea76Ea2Fd092a35BDc
4511,15627861,277715,7794034013,276551,1164,266,369,0x7d2768dE32b0b80b7a3454c06BdAc94A69DDc7A9,0x907206D1Fb31AeB9E36Fdc98CE09F5B088bE56bF
4512,15627861,288840,7777502239,285172,3668,906,0,0x197492CCB4B1acaAAcd43432657A17832E36AB49,0xfF404f3dA1871A380e3636107566066E482eBd30
4513,15627861,21000,7746190476,21000,0,2,0,0xD515Bc4a1539f6803C4991dd985B6313EbE01303,0x22Cd6F03Fa736A5cC7f543c54c621B3aAA0e96C9
4514,15627861,210139,7731378788,208975,1164,338,134,0x1111111254fb6c44bAC0beD2854e76F90643097d,0xE00973e3954135cCB87fc18C045dcf19585C48d4
4515,15627861,223604,7726611688,220844,2760,842,2,0x68b3465833fb72A70ecDF485E0e4C7bD8665Fc45,0x21228fDA62C0a15e22B97f178CD211A82773227b
4516,15627861,21000,7726611688,21000,0,2,364,0x12d22534A6F503fD8DFA22A9eb3E1c26eE151a94,0x287544938d9011394634B48e9Fc1d8192EAc3e19
4517,15627861,90000,7685200885,90000,0,2,154370,0x9f9cF32E966Ae6B1742759f450AE52653e73Cfe0,0xCBD6832Ebc203e49E2B771897067fce3c58575ac
4518,15627861,330727,7685200885,163267,167460,21152,183245,0x5E4e65926BA27467555EB562121fac00D24E9dD2,0x6887246668a3b87F54DeB3b94Ba47a6f63F32985
4519,15627861,288883,7629325279,285203,3680,906,0,0x197492CCB4B1acaAAcd43432657A17832E36AB49,0xCA458E3B3ceA473D9e30F7258699fe91Cdf2d657
4520,15627862,315384,67223513694,313632,1752,458,481,0x7a250d5630B4cF539739dF2C5dAcb4c659F2488D,0xe3691faBe650e4Ce0E2570BBd32ac1BAe8600E71
4521,15627862,200000,31460000000,199392,608,138,1205079,0xdAC17F958D2ee523a2206206994597C13D831ec7,0xFfec0067F5a79CFf07527f63D83dD5462cCf8BA4
4522,15627862,162046,24800826133,160710,1336,190,2396,0x9507c04B10486547584C37bCBd931B2a4FeE9A41,0xeDa2ec928a39Db51d18AFC4875F6B807C85D66b3
4523,15627862,280000,18223513694,273412,6588,1802,193,0x00000000006c3852cbEf3e08E8dF289169EdE581,0xc2136927EB5C00D65A9aFce9e231772A3D8f9eB8
4524,15627862,500000,10223513694,498028,1972,394,60926,0x585C3d4Da9b533C7e3dF8AC7356C882859298cEe,0xd5cf0Cb9a8DF9B46f077f561d8b76c34A69bD82F
4525,15627862,750000,7223513694,744172,5828,1482,47,0x0352086e5Ce73fc2eC4C41fef56361F7dEF6Ea91,0x0cD370FD23F1c6778415d8039703274Be87FD434
4526,15627862,56605,14492625729,55997,608,138,1,0xdAC17F958D2ee523a2206206994597C13D831ec7,0x7fC8877D73a0005D4B9988EF5FaE2c376e20c6b8
4527,15627862,350000,13470376313,349356,644,138,6925047,0x6De037ef9aD2725EB40118Bb1702EBb27e4Aeb24,0x46340b20830761efd32832A74d7169B29FEB9758
4528,15627862,350000,13470376313,349392,608,138,6925048,0xdAC17F958D2ee523a2206206994597C13D831ec7,0x46340b20830761efd32832A74d7169B29FEB9758
4529,15627862,298359,12049874898,296651,1708,256,5123,0x507888e987257a8DdE6F8AFa46375CEfe2CbF504,0x678111a6cA5749f1744b5E080A855CEC8d631E20
4530,15627862,222222,12000000000,220658,1564,394,169,0x1Fa8559e873f698292766790AeCf8080A66433F6,0x83E44B50B15FEf6cC79B6CDCFd14D427aE0C9EC0
4531,15627862,90000,12000000000,89392,608,138,12621,0x05237E2bd2dfAb39a135d254cABAE94b183C8baD,0xFd25F5A3415e29f0AeeB5746E5D513DE67169225
4532,15627862,21000,11940000000,21000,0,2,8,0x26032288b2090843CF3940747Aba28a7aF699B7D,0x603e8560e7D314cB530B9c454beB124f6E93258C
4533,15627862,257736,11223513695,255420,2316,650,106624,0xA69babEF1cA67A37Ffaf7a485DfFF3382056e78C,0x9AAb3F81604c683a1a0D14019FBfe15bef7aA1ee
4534,15627862,164337,11223513694,162741,1596,230,2344,0x9507c04B10486547584C37bCBd931B2a4FeE9A41,0xECfa588035d50Ce798618C199f67609064462139
4535,15627862,250000,11000000000,249392,608,138,270669,0xdAC17F958D2ee523a2206206994597C13D831ec7,0x23f4569002a5A07f0Ecf688142eEB6bcD883eeF8
4536,15627862,49800,11000000000,49192,608,138,26,0xA0b86991c6218b36c1d19D4a2e9Eb0cE3606eB48,0xdD59ece9bE82aa2e910b609286CEF0dd320E405d
4537,15627862,49800,11000000000,49204,596,138,82,0xA0b86991c6218b36c1d19D4a2e9Eb0cE3606eB48,0x075ecF7c0C5eb58E42616fC007855a03714f541B
4538,15627862,49800,11000000000,49192,608,138,4,0xA0b86991c6218b36c1d19D4a2e9Eb0cE3606eB48,0x586D15b13b07B6DE57bA2f3EE224ca84CCdeebCF
4539,15627862,49800,11000000000,49204,596,138,3,0xA0b86991c6218b36c1d19D4a2e9Eb0cE3606eB48,0x56A7cf0AFc154a4c185a88Faee49357d1852E65B
4540,15627862,49800,11000000000,49204,596,138,28,0xA0b86991c6218b36c1d19D4a2e9Eb0cE3606eB48,0x02dEC412310e7c019A73C7d7659470708FD81775
4541,15627862,21000,11000000000,21000,0,2,39,0x389505f098a29a994A3ed0e674f07cd451dde42C,0xDA0821c6348E506b2056D7289e0E804D61094577
4542,15627862,49800,11000000000,49192,608,138,6,0xA0b86991c6218b36c1d19D4a2e9Eb0cE3606eB48,0x3348D99d14359DC9C2e978560aFAEd3Be953e6F1
4543,15627862,49800,11000000000,49192,608,138,1,0xA0b86991c6218b36c1d19D4a2e9Eb0cE3606eB48,0x552a85026f8114B46d270456CC00335160C44F1b
4544,15627862,84290,10983803109,83302,988,202,355151,0xA0b86991c6218b36c1d19D4a2e9Eb0cE3606eB48,0x7abE0cE388281d2aCF297Cb089caef3819b13448
4545,15627862,76207,10983803109,75231,976,202,4709916,0xdAC17F958D2ee523a2206206994597C13D831ec7,0x2FAF487A4414Fe77e2327F0bf4AE2a264a776AD2
4546,15627862,62901,10983803109,61901,1000,202,4709917,0x6B175474E89094C44Da98b954EedeAC495271d0F,0x2FAF487A4414Fe77e2327F0bf4AE2a264a776AD2
4547,15627862,66459,10983803109,65435,1024,202,4709918,0x0D8775F648430679A709E98d2b0Cb6250d2887EF,0x2FAF487A4414Fe77e2327F0bf4AE2a264a776AD2
4548,15627862,80521,10983803109,79865,656,138,4709919,0x514910771AF9Ca656af840dff83E8264EcF986CA,0x2FAF487A4414Fe77e2327F0bf4AE2a264a776AD2
4549,15627862,21000,10700000000,21000,0,2,0,0x6dfc34609a05bC22319fA4Cce1d1E2929548c0D7,0xF24ef785c962d562C189A51aF3fc6e6a2c97d4C0
4550,15627862,21000,10700000000,21000,0,2,0,0x6dfc34609a05bC22319fA4Cce1d1E2929548c0D7,0xBa4d81d698b9bcc2978B530F80f3AF1aC32723a0
4551,15627862,21000,10690817572,21000,0,2,155624,0x0bD00E8595bF564c0C750d6075E6C35B30b7E56a,0xcDd37Ada79F589c15bD4f8fD2083dc88E34A2af2
4552,15627862,60000,10580000000,59344,656,138,9,0x491604c0FDF08347Dd1fa4Ee062a822A5DD06B5D,0xC5c0B68F4c813b0bcE1C2873F5144111c3f59452
4553,15627862,21000,10426427346,21000,0,2,47,0xCBD6832Ebc203e49E2B771897067fce3c58575ac,0x851E08e3E4bdc21a39D7F81140ED2ec8097D12c5
4554,15627862,21000,10426427346,21000,0,2,7,0xCBD6832Ebc203e49E2B771897067fce3c58575ac,0x5aB9faB4a21791e230153f1b9ADB85f08E6d704f
4555,15627862,100000,10265179433,99356,644,138,1050385,0x5Ca381bBfb58f0092df149bD3D243b08B9a8386e,0xf16E9B0D03470827A95CDfd0Cb8a8A3b46969B91
4556,15627862,90000,10265179433,90000,0,2,784409,0x76b36A038cd2086406120b2807258cD7b857308F,0xcaD621da75a66c7A8f4FF86D30A2bF981Bfc8FdD
4557,15627862,8000000,10263184869,7999936,64,10,15099,0x88266E58a66cB5b1880814F6BFe5E12b68832B9D,0xb2AA4a5DF3641D42e72D7F07a40292794dfD07a0
4558,15627862,200000,10263184869,198680,1320,266,35384,0x5a54fe5234E811466D5366846283323c954310B2,0x1A8ed0D3Ad42c9019CC141aAce7e5Fb6E576B917
4559,15627862,200000,10263184869,198680,1320,266,40069,0x5a54fe5234E811466D5366846283323c954310B2,0x6eCe61d29b90642941C41240da924690da145696
4560,15627862,122429,10223513694,121677,752,138,192814,0xDBd324B73f6f85bf9013B75C442021303b635Ff9,0x19f494583c7C933be7B0eE58104DDaFac1E8aDfA
4561,15627862,21000,10223513694,21000,0,2,17,0x25ceE3a836286d1D9188e54bc563E5C74BE984A9,0x3d96eB0d26108B1889Ab36F0e8B66328b625d6AD
4562,15627862,21000,10000000000,21000,0,2,34,0xcC0226654A57845b9e2da42275973fe72240e495,0xd2146dfFdBc24Ba0Fbe113e98C59472CF2ff60C3
4563,15627862,21000,10000000000,21000,0,2,12,0xDf8DD5e0b4168f20a3488Ad088dDB198fE602Cb3,0x00A6426e17279926FF37E72B8F735d0C57d2c3dd
4564,15627862,452506,9723513694,452074,432,74,495,0xe204807A5Ab1e7932902e4da441b377E631f935F,0x7c91D210052Fb7D76415545C64141cA3E560c4B6
4565,15627862,106522,9723513694,105658,864,266,5890,0xc4DCC4D76d2cbCf3E0C7eADD3aaC4D49B421f19F,0xbbDd1b3C87c211E482CdA98eA14fa8bF50022CA0
4566,15627862,264311,9723513694,233031,31280,5514,227,0xA0c68C638235ee32657e8f720a23ceC1bFc77C77,0x6B78Ff6668D639DEb89363d8E24f2abe2D7Ab1bA
4567,15627862,145445,9723513694,145241,204,74,2481,0x55f1C36Bb7aE0d7D6caE97902E30A2306686Ec73,0xeb6Bc3940C9fe8D7A90BAeB168F64F2FeCD9A5cE
4568,15627862,21000,9610000000,21000,0,2,705875,0xd35A80935af88125E1F1CC59C87DD00CFa0381E7,0x6dfc34609a05bC22319fA4Cce1d1E2929548c0D7
4569,15627862,30109,9560000000,30109,0,2,4,0xfabe3fcF983B6A2A063e0e5466d4B02513325279,0x68286F847071a768672C5BE7DfB4985303344A9c
4570,15627862,21000,9552654058,21000,0,2,6,0x03476A65eFD691bD32CDa69EA320a5BadDeAD777,0xF8f3d2b211f616254b28b2d4876db33d71Ad38b6
4571,15627862,21000,9552654058,21000,0,2,7,0x03476A65eFD691bD32CDa69EA320a5BadDeAD777,0x9F1760816727b6a8BfDBBe35a89b251B14c118F0
4572,15627862,21000,9552654058,21000,0,2,52,0x03476A65eFD691bD32CDa69EA320a5BadDeAD777,0x1F8230d3c4D6334d4b5f5E655e30A38189C33d5E
4573,15627862,21000,9552654058,21000,0,2,7,0x03476A65eFD691bD32CDa69EA320a5BadDeAD777,0x4EAF27087C908C4ec3D9257b651c1078C75B8e13
4574,15627862,21000,9552654058,21000,0,2,2,0x03476A65eFD691bD32CDa69EA320a5BadDeAD777,0xC5438E84E7E02b5B0DCd98bcA47a03fEBe6E13a3
4575,15627862,21000,9446553581,21000,0,2,4,0x52A258ED593C793251a89bfd36caE158EE9fC4F8,0x81AefeBb5C5828C641537184471f4CFaEf2BAf7A
4576,15627862,90000,9423513694,89392,608,138,614726,0xdAC17F958D2ee523a2206206994597C13D831ec7,0x3C02290922a3618A4646E3BbCa65853eA45FE7C6
4577,15627862,298225,9273513694,295429,2796,842,200,0x68b3465833fb72A70ecDF485E0e4C7bD8665Fc45,0x85C3D25bb569FE6915CE128e1eE5cDCd8b0d9947
4578,15627862,21000,9224513694,21000,0,2,102638,0x07BD02e2b39c894378CaF3FDef2a74F06E1cA89D,0x2Db1D8CdF1Abe8C70b531a790CDf2FF38aecF652
4579,15627862,21000,9224513694,21000,0,2,113048,0xbC4239Bca8dE350fccF59773A655B1FF661Ed19d,0x6081258689a75d253d87cE902A8de3887239Fe80
4580,15627862,21000,9224513694,21000,0,2,251061,0x55dbAC71d136A8aD02edd815B1E1b9217E4a9e22,0x8216874887415e2650D12D53Ff53516F04a74FD7
4581,15627862,740000,9223513694,729004,10996,2506,37861,0x3d47eF9690Bd00C77c568b73140dC20F34453766,0x70bC61658615725A82D5e78FF0066BFCb1b98988
4582,15627862,77898,9223513694,77278,620,138,81,0x15D4c048F83bd7e37d49eA4C83a07267Ec4203dA,0xE716B2DDCa8A9a746a5b7ED1132D2e48277Ee4Fb
4583,15627862,218798,9223513694,215558,3240,1034,867,0x68b3465833fb72A70ecDF485E0e4C7bD8665Fc45,0xc9BF80eA3918c2fcbf8Fa9e2325241E69A413874
4584,15627862,49542,9223513694,49478,64,10,10,0xC02aaA39b223FE8D0A0e5C4F27eAD9083C756Cc2,0x8F35f46d6912C91D5F1e8a25da1480df9A012606
4585,15627862,355599,9223513694,347115,8484,1226,351,0x84927e55Ed03EA00732F17FdAA89f482AD12c005,0xB82e84aA632c101e924C7b0B8faAad0322822010
4586,15627862,101976,9223513694,101912,64,10,26,0xFc377A505DFE0eC8d7fB34c52FC68C74D48A8c5f,0x3317a5241c9deAA134660369C54C54A3709d1A2a
4587,15627862,223904,9223513694,220348,3556,1162,7412,0x68b3465833fb72A70ecDF485E0e4C7bD8665Fc45,0x25548Ba111d4F6cbA0498Ab77a6b40EACbeFab52
4588,15627862,175971,9223513694,173199,2772,842,1477,0x68b3465833fb72A70ecDF485E0e4C7bD8665Fc45,0xa12B0Fa4104569906c018Eb3541e6605ffe8e54b
4589,15627862,21000,9223513694,21000,0,2,2759939,0xC3ae483EE1Fb6386DAf5202fBEfb606776cDA881,0x267be1C1D684F78cb4F6a176C4911b741E4Ffdc0
4590,15627862,21000,9223513694,21000,0,2,2759940,0x634624E269E2C2BD412577884805fE23aC39AAD4,0x267be1C1D684F78cb4F6a176C4911b741E4Ffdc0
4591,15627862,49542,9223513694,49478,64,10,399,0xC02aaA39b223FE8D0A0e5C4F27eAD9083C756Cc2,0x7cFBfE6a6C5a1089a542534C0c7F69e749f6b80f
4592,15627862,271156,9223513694,267992,3164,906,4104,0x68b3465833fb72A70ecDF485E0e4C7bD8665Fc45,0xaAa313393E79ea3454939e843E0AA8DEC66A9949
4593,15627862,70000,9223513694,69392,608,138,527,0xdAC17F958D2ee523a2206206994597C13D831ec7,0xf5491f793D47A6Ea22f5e0B9AD3990CF66c4b40B
4594,15627862,181476,9223513694,179912,1564,394,4,0x1Fa8559e873f698292766790AeCf8080A66433F6,0x46A6eB9c24B1706086905A472B59cB070F9f892a
4595,15627862,51571,9223513694,50951,620,138,1017,0x467719aD09025FcC6cF6F8311755809d45a5E5f3,0x27CccC678b2F6C374d7a57862d96378C87e1E3F2
4596,15627862,100000,9223513694,99024,976,202,88936,0xdAC17F958D2ee523a2206206994597C13D831ec7,0x3018018c44338B9728d02be12d632C6691E020d1
4597,15627862,500000,9223513694,499344,656,138,87313,0x6B175474E89094C44Da98b954EedeAC495271d0F,0x66c57bF505A85A74609D2C83E94Aabb26d691E1F
4598,15627862,368160,9223513694,362916,5244,1484,47,0x881D40237659C251811CEC9c364ef91dC08D300C,0x4239e68e2eF8E5F46EB85c480788a0aEB54605ff
4599,15627862,42000,9223513694,42000,0,2,329528,0x9D38e5355Ae92D0d3b0dB42ee3305412C58f01A1,0x9430801EBAf509Ad49202aaBC5F5Bc6fd8A3dAf8
4600,15627862,120000,9223513694,119356,644,138,1,0x5891599664Ed15C6e88041B4F5bc08594f026f0e,0x98DDf0e86Cb950308756f09943133945B854307c
4601,15627862,298225,9223513694,295429,2796,842,1222,0x68b3465833fb72A70ecDF485E0e4C7bD8665Fc45,0x9cA213288C3cFb4f7be4dD66Bde1E025a4c8c856
4602,15627862,500000,9223513694,499356,644,138,2945,0x9f8F72aA9304c8B593d555F12eF6589cC3A579A2,0xa939bffB33bED18dC0063737CB9EA41a1fdB2Fe3
4603,15627862,311299,9223513694,308515,2784,842,133,0x68b3465833fb72A70ecDF485E0e4C7bD8665Fc45,0xdbf722373D9c0dba24AB41f3Bc64a9D9B707Ef30
4604,15627862,169228,9223513694,168776,452,138,77,0x94235659cF8b805B2c658f9ea2D6d6DDbb17C8d7,0xfCDc25ba0D9D9C16A40506802a50C6c0870d5BC6
4605,15627862,263695,9223513694,259579,4116,1034,47,0xe66B31678d6C16E9ebf358268a790B763C133750,0xc11135be9f38fCb5A75C34e9b5824C62C4011660
4606,15627862,207128,9223513694,206532,596,138,4232335,0xdAC17F958D2ee523a2206206994597C13D831ec7,0xDFd5293D8e347dFe59E90eFd55b2956a1343963d
4607,15627862,84354,9113513694,84150,204,74,23,0x9b9D659D4f2cF68b6616Cc0a65683f1951Eb725C,0x096748d0d94eFf7f9e1d9E0E5A823A041E180c06
4608,15627862,51458,9072709249,50970,488,138,16,0x7F9306FC1978938d5C1C57Bf6044dc67E07eeB8a,0x60d770D1707EDF692601A4dD4ea802d241C7fF19
4609,15627862,21000,9000000000,21000,0,2,2702,0x2d64AcAB7C9578A9e226643d4D1B2b2a76E721f3,0x40A8e4407b2049e57A768Eca162f4B1F8BD52175
4610,15627862,114219,8980250875,106359,7860,1226,1773,0x6E99ee539594fa6a621a29022Aa50AE7f32f14BB,0xdFE201CeDC41f970D43f95674d6b4bE02dE784dD
4611,15627862,84354,8833513694,84150,204,74,28,0x9b9D659D4f2cF68b6616Cc0a65683f1951Eb725C,0x625a34E2d3d55efc627FdA5F1c584902F12fF97c
4612,15627862,84354,8833513694,84150,204,74,31,0x9b9D659D4f2cF68b6616Cc0a65683f1951Eb725C,0x1F0b90c9Ae9E9710535684f736E3959F13B5E1F6
4613,15627862,84354,8833513694,84150,204,74,26,0x9b9D659D4f2cF68b6616Cc0a65683f1951Eb725C,0x02C04FDB63809814E7612DD4eD1e90Fd1F1eBA2D
4614,15627862,84354,8833513694,84150,204,74,53,0x9b9D659D4f2cF68b6616Cc0a65683f1951Eb725C,0xC619441829efdff87bFDC7D8cD7cC5fa0dd6AdF5
4615,15627862,600000,8811893504,598740,1260,458,59276,0xE544cF993C7d477C7ef8E91D28aCA250D135aa03,0x69f36eA1ebf4Ec9E53e3aaBF11CAF62b034ff3eE
4616,15627862,21000,8723513694,21000,0,2,26,0x42f678DBE97bF17c7a75d6Df81C62DA45a29c110,0x25eC4C7b245df86F0AdeDfF55bD6b4D420517A2c
4617,15627862,1065060,8723513694,1064716,344,138,404,0xF403C135812408BFbE8713b5A23a04b3D48AAE31,0x1CeD4e3900c73A54eD775ef2740a4e38aC5b54e2
4618,15627862,21000,8723513694,21000,0,2,81,0x8d903bBA637e5fE063B724701217ebdC5Bf5bE13,0x38a404D2e859572fab457ad9AdF3cd2d4781d718
4619,15627862,46769,8723513694,46197,572,138,32,0x9FE9caA2c7551520FfAE6b8FA126eeBf99ab5f3B,0x67798826B9FE74b12bDf20450E00dd754E5AB29C
4620,15627862,248886,8723513694,246138,2748,842,796,0x68b3465833fb72A70ecDF485E0e4C7bD8665Fc45,0x6953Ba87386bD829F800C533D73264BFA5d43D6D
4621,15627862,154238,8723513694,151466,2772,842,959,0x68b3465833fb72A70ecDF485E0e4C7bD8665Fc45,0x07FCd9D839B49d8A571c0A4cD67890EA5788793a
4622,15627862,89173,8723513694,88969,204,74,77,0x8cFC27c666a31638AD5Cce720c5d09373517F58b,0xe0f93Ad44EF180f4CA0d61Ca5f1106AD444A0ff3
4623,15627862,21000,8723513694,21000,0,2,18,0x51DEC9cdf985bf1e828d57E78135443B2Cd1b5AF,0x71c833CE823775e712315cb08ac5da177BA65C7f
4624,15627862,64354,8723513694,63402,952,202,35,0x40112e8A75C8a22B53F454F6ca636071155aAd19,0x8dacC95548541b5AF2ca8d35EA52E5e364854849
4625,15627862,50719,8723513694,50111,608,138,24,0xdAC17F958D2ee523a2206206994597C13D831ec7,0x227D2f1F7A018dC24767A6eA512937A202DdF672
4626,15627862,21000,8723513694,21000,0,2,521,0xa505aE15DBE01419D2cF569cb9F5345b6Ce4e2D5,0xB7B10292EE6c5828b20eB0942C8c1275E8344800
4627,15627862,46280,8723513694,45420,860,138,25,0xC02aaA39b223FE8D0A0e5C4F27eAD9083C756Cc2,0x749767cC11F5462B02FeD9ac7ED7056EAaB3805D
4628,15627862,65000,8723513694,64392,608,138,646169,0xdAC17F958D2ee523a2206206994597C13D831ec7,0x29D5527CaA78f1946a409FA6aCaf14A0a4A0274b
4629,15627862,182918,8723513694,176126,6792,1802,151,0x00000000006c3852cbEf3e08E8dF289169EdE581,0xd1fb0192864C3B21447B57AE8922dB85783bA9B7
4630,15627862,31582,8723513694,31582,0,2,3572,0x37861cCdDB1e36a9Dc732eb12ea570438173f0b6,0xCE222910bA7524cADc75DDC7c57Ec5b97E8bFfc9
4631,15627862,167079,8723513694,160427,6652,1810,77,0x00000000006c3852cbEf3e08E8dF289169EdE581,0xaa69CD8502BE79c5DbBc4abf3f36Aa7774aC4755
4632,15627862,99244,8723513694,98636,608,138,180,0xA0b86991c6218b36c1d19D4a2e9Eb0cE3606eB48,0xC2606254E1c3bD456B19650c9488F031823a8c77
4633,15627862,289475,8723513694,287103,2372,522,480,0x283Af0B28c62C092C9727F1Ee09c02CA627EB7F5,0x74667801993b457B8ccF19d03bbBaA52b7ffF43B
4634,15627862,118268,8723513694,116012,2256,650,323,0xC45f3c76FeeEa53aAE5AFA9b51F166E025145400,0x23d8646672cDca0b3261adc46aA2d5A44B0A56EB
4635,15627862,55904,8723513694,54960,944,138,383,0x011b0beAe3eC5953B4805b064cC78f6F892A99cC,0xce45DbC50E99c5e17Cb3C439CCB96fBac3fc270d
4636,15627862,21000,8723513694,21000,0,2,349,0xd8096612065AA2710eb695d44A226C91d4e5245b,0xD7D4F0D1D46443FA79B81B3C3e6E578b98BdD0e8
4637,15627862,101229,8723513694,100277,952,202,499,0x0c2E57EFddbA8c768147D1fdF9176a0A6EBd5d83,0x27D447C2CAc8050e3716AaE99CE8CA37442B589e
4638,15627862,199163,8723513694,188607,10556,3402,671,0x00000000006c3852cbEf3e08E8dF289169EdE581,0x9829C7157889EE198cBc40208a8ABb29b3Ad2A2d
4639,15627862,589699,8723513694,586059,3640,1162,28,0x68b3465833fb72A70ecDF485E0e4C7bD8665Fc45,0xC5dd6747592c69651a4486B3b957D697621c645c
4640,15627862,46103,8723513694,45615,488,138,491,0xD05FE72B0DD55f08051b6590a7D8b7c79fAb59F4,0xF22b63bFaF049C9a91e9933b962131dBdDaFc838
4641,15627862,46588,8723513694,46100,488,138,374,0x283f687f87a0052696AaA5Ab7A31694A3a6762C5,0x5Db71204C7D9a9a23359676aE159eD28D2fF4523
4642,15627862,150756,8723513694,150692,64,10,4,0x65c2e54a4c75ff6da7b6B32369c1677250075fb2,0xEd0f4e8A17578E44865B47BDA3D1eEB411A7635E
4643,15627862,143545,8723513694,142605,940,202,156,0xe6A05f25A051a90D5d144C04F783f6999e48e32D,0x2F488546e9Db21444125e5B0914EeadFc05845c4
4644,15627862,21000,8723513694,21000,0,2,9,0x7E7D68e06df82Cb949fD0faCDCa3aC841768d67c,0xceB36a0dd5a54Be6221C51d79EF3dac77cfF9eCC
4645,15627862,197385,8723513694,193697,3688,1162,8,0x68b3465833fb72A70ecDF485E0e4C7bD8665Fc45,0xFE4E1E81081d7A351C3617626476cE571d10764E
4646,15627862,21000,8723513694,21000,0,2,95,0x15AC5D20f329641d6734d8ee0b398BCb79A9b0A7,0x1A92a63a87f7877e7Fa7C35a38C6EAF65FB61C40
4647,15627862,46267,8723513694,45691,576,74,780,0x283Af0B28c62C092C9727F1Ee09c02CA627EB7F5,0x57b8734F103eEEaD3A699656e2C2Ef031aEd9508
4648,15627862,211159,8723513694,210687,472,202,24,0xC549d87E9CEA28961927436a2B7D6944f7CA86eb,0x389d96a6eE133EdA37138d63b10EB7Cf614AD6e5
4649,15627862,46267,8723513694,45691,576,74,25,0x283Af0B28c62C092C9727F1Ee09c02CA627EB7F5,0x07d175E9a075aB47fB36b149207EEB650E5FDdA8
4650,15627862,232580,8723513694,228976,3604,1162,18,0x68b3465833fb72A70ecDF485E0e4C7bD8665Fc45,0x19cd53393B8b7e285AceEeF7502f554795E66a9D
4651,15627862,197007,8723513694,186387,10620,3410,28,0x00000000006c3852cbEf3e08E8dF289169EdE581,0xc5bDdD29992D37826691a8Db737A5eaaD7d6d01E
4652,15627862,62217,8723513694,61329,888,266,12,0xFF1F2B4ADb9dF6FC8eAFecDcbF96A2B351680455,0x65fbf8eccfd4a61E5e75779bDC49F420B309e2DD
4653,15627862,21000,8723513694,21000,0,2,401,0x042f7cdD30ab9dc024d68d77A91b57036728b75c,0xB8B9AC3f40B0eBa543847A45d59BC393b6B4dA83
4654,15627862,46076,8723513694,45588,488,138,266,0x57f1887a8BF19b14fC0dF6Fd9B2acc9Af147eA85,0xd0A58603A86fCdB48607357DaD44e295c9fBDA43
4655,15627862,21000,8723513694,21000,0,2,82,0x3671A52814d2E8D6a179075A215D3337867735b8,0x38a404D2e859572fab457ad9AdF3cd2d4781d718
4656,15627862,471477,8723513694,467849,3628,1162,5,0x68b3465833fb72A70ecDF485E0e4C7bD8665Fc45,0x7FcBdF9c71a26ad4293E89E51239dA26A240104A
4657,15627862,21000,8723513694,21000,0,2,976,0x6eF5Dc6D049Db935e16318F33D919446a0668a78,0x5ED2728f5fD8680f547232D03593cC421fF42795
4658,15627862,74380,8723513694,72440,1940,330,15,0x00000000000C2E074eC69A0dFb2997BA6C7d2e1e,0x975F6b37456b9b03996F494B430bde71e75429A4
4659,15627862,148001,8723513694,141389,6612,1802,110,0x00000000006c3852cbEf3e08E8dF289169EdE581,0xee0E61623a7142883D92Bf98980C3F58a409b1C8
4660,15627862,55897,8723513694,54953,944,138,856,0xeF497B970f50286a9805b91809b8615E6d0eF19B,0xb6047B161F5fC557e28376dD9BCb2cF01647b159
4661,15627862,134802,8723513694,128298,6504,1802,72,0x00000000006c3852cbEf3e08E8dF289169EdE581,0x90FEdB809d30520C46977b55be9D1ef87C611EAB
4662,15627862,251539,8723513694,245571,5968,1738,897,0x68b3465833fb72A70ecDF485E0e4C7bD8665Fc45,0x056fbE1Cb4200C3C8FCd22123346F1D79B2450EC
4663,15627862,46255,8723513694,45691,564,74,210,0x283Af0B28c62C092C9727F1Ee09c02CA627EB7F5,0xb4a53b85a873A5fFa6fBe995E39107C9C1bCd935
4664,15627862,185288,8723513694,182540,2748,842,3,0x68b3465833fb72A70ecDF485E0e4C7bD8665Fc45,0x472258c3F3eE37f05941fd147cBA19010eB2281c
4665,15627862,411172,8723513694,407508,3664,1162,1894,0x68b3465833fb72A70ecDF485E0e4C7bD8665Fc45,0x751E6256485EB5eCEC56042924Aa34F01A289373
4666,15627862,182403,8723513694,179139,3264,1034,175,0x68b3465833fb72A70ecDF485E0e4C7bD8665Fc45,0x9113a2817bD8DF95bD8B90F0289d0842117498d8
4667,15627862,599837,8723513694,588633,11204,3594,27,0x0000000000c2d145a2526bD8C716263bFeBe1A72,0x814444012a50A540bA3d1C80a05227F0d06C8b7A
4668,15627862,49175,8723513694,48687,488,138,558,0xDD05c08aFE08aAFDD2381622C3E009f5c44cF007,0x6b1Fd5D876771b764D0131746dF48C1054e37f73
4669,15627862,73170,8723513694,72574,596,138,527,0xA0b86991c6218b36c1d19D4a2e9Eb0cE3606eB48,0xf220404cdecD90E78a280b2F13f0F9cd3336b1E0
4670,15627862,190887,8723513694,171387,19500,4682,83,0x00000000006c3852cbEf3e08E8dF289169EdE581,0x2388693c321842e2DcFdE252999E49f1d3EED79E
4671,15627862,64332,8723513694,63380,952,202,23,0xdCc596A145Af23a2627936EbcB9518a16bbdB43b,0x99cdb33Df8726F1952af7f60a02e70436241d499
4672,15627862,690321,8723513694,645017,45304,15826,198,0x00000000006c3852cbEf3e08E8dF289169EdE581,0x33Fa950A47caa3523215B9B2e504359930266BC2
4673,15627862,21000,8723513694,21000,0,2,1,0x2ccD6C70F326b260b2E2C1B3D7c5778E87b00C4C,0x8cEF047f37a8C244b5d17Db3c2e0a6Ae94EF2f0c
4674,15627862,278821,8723513694,278617,204,74,2919,0x55f1C36Bb7aE0d7D6caE97902E30A2306686Ec73,0x0338CE5020c447f7e668DC2ef778025CE398266B
4675,15627862,191263,8723513694,184687,6576,1802,64,0x00000000006c3852cbEf3e08E8dF289169EdE581,0x26Fe0D45dd516b9e82916636edBA51C4bec58dCD
4676,15627862,21000,8723513694,21000,0,2,2615,0x4D19b23bF96E1516F111786e8bA7c70ee638bd22,0xD73e0DEf01246b650D8a367A4b209bE59C8bE8aB
4677,15627862,155876,8723513694,149288,6588,1802,443,0x00000000006c3852cbEf3e08E8dF289169EdE581,0x090882db986Fc820404962d6b8E4AEF615eB4ade
4678,15627862,21000,8723513694,21000,0,2,12,0x25Ac7D60726D113d64Ee4bE453A304cE4Ab57e4e,0x790E46C554c4ED0FBdd0F5F1495EC7d6d7894Ae0
4679,15627862,62499,8723513694,61547,952,202,399,0xC86664e7d2608f881f796ee8E24FA9d4d7598406,0x7D3E5dD617EAF4A3d42EA550C41097086605c4aF
4680,15627862,1448760,8723513694,1437788,10972,4042,206,0x4f1C53F096533C04d8157EFB6Bca3eb22ddC6360,0xdCE8e2B29a416280e8cd7E8baA1a1d244c50ee99
4681,15627862,21000,8723513694,21000,0,2,33,0x0E638C186C9cF41cfaBbc7E8024E0D1987b2011f,0xEd4F343A0C87D260c59C6371279245c15346E9bB
4682,15627862,49175,8723513694,48687,488,138,240,0x8B576c79767791f83613bEd5095ef22E04245F3E,0x8694918FFA878B8b53c54c11DF41f7BC574Fb2fd
4683,15627862,400000,8723513694,388484,11516,3594,104,0x36C72892fcc72b52FA3b82eD3BB2A467D9079B9A,0xE3d3D0eD702504e19825f44BC6542Ff2ec45cB9A
4684,15627862,58143,8723513694,56307,1836,458,5666,0x4976fb03C32e5B8cfe2b6cCB31c09Ba78EBaBa41,0x484eC62385e780f2460fEaC34864A77bA5A18134
4685,15627862,46267,8723513694,45691,576,74,7,0x283Af0B28c62C092C9727F1Ee09c02CA627EB7F5,0x5f7e5f3f08c836c092B216667a82a61eE9eceEDA
4686,15627862,21000,8723513694,21000,0,2,2,0xCC6029ca0f1b2E5E85BB4c845B9D2B1D663AC7c2,0x9763fD3C3D53D9a7EFbeC776cB5D22591028Ba56
4687,15627862,99184,8723513694,98828,356,138,2314,0x8EE5DD62A654a60f6F17A99d544102f37B58dA26,0xd577df616cbfdA9C7d322E8cb5938CD9a47b837e
4688,15627862,21000,8723513694,21000,0,2,57,0xc4f20b2cBDd108Fd8BE8db04EC854098322a6843,0x77751dbF17cC682a3141749335BCbD2f5FCE4F3c
4689,15627862,176942,8723513694,170354,6588,1802,193,0x00000000006c3852cbEf3e08E8dF289169EdE581,0xda4c111B94cC6ffF12bAaCA83D615AC5489b314A
4690,15627862,60703,8723513694,53271,7432,2506,77,0x00000000006c3852cbEf3e08E8dF289169EdE581,0x2FFaec0794C30c811AF190BBD2cBDDd0464f30Fc
4691,15627862,365103,8723513694,336871,28232,3630,97,,0x7Aa96077eB5c3DE1c061ca20fa1920A8562097f7
4692,15627862,56000,8721059542,55048,952,202,164391,0xdAC17F958D2ee523a2206206994597C13D831ec7,0x6871EaCd33fbcfE585009Ab64F0795d7152dc5a0
4693,15627862,21000,8685200885,21000,0,2,1,0x03476A65eFD691bD32CDa69EA320a5BadDeAD777,0x66C154bfd0A086209E89b29Ce587b7b8491eddB6
4694,15627862,21000,8685200885,21000,0,2,19,0x03476A65eFD691bD32CDa69EA320a5BadDeAD777,0xbc85DBBd27E5b77976b67D27EFf96604Ca17e892
4695,15627862,21000,8620000000,21000,0,2,1,0x564D6C609093c175c69424dcCa0c143BC62557d1,0xdd5Eba7a53fc556221F5E64297a7E5DdF3654eb6
4696,15627862,600000,8552654058,599392,608,138,138566,0xdAC17F958D2ee523a2206206994597C13D831ec7,0x974CaA59e49682CdA0AD2bbe82983419A2ECC400
4697,15627862,21000,8552654058,21000,0,2,123,0x4103c267Fba03A1Df4fe84Bc28092d629Fa3f422,0x6ce088Ce419fBE5a0ccB7ABC0DB1f9251A9109ee
4698,15627862,98786,8423513694,98582,204,74,13,0x6E6cFb804D87242B5C138BCB9640f7F1Ed0b92FA,0xB1328d7B0F83dF4992C66d9fE43c40a943d4C1F1
4699,15627862,21000,8393257258,21000,0,2,327,0x1ED566bef24e06D4741d6329B2BD190236b05dF5,0xBAF40a2920c7eb7bD83A3a6b9221cec4c8BC3f2d
4700,15627862,21000,8273513694,21000,0,2,27,0xB83976FF9Ab26d5Dfa0D8581C5b82Fd9f2E2Ce60,0x2AD25E2067F3666673f5D8B93731eB935bCc3E69
4701,15627862,255873,8223513694,253077,2796,842,133,0x68b3465833fb72A70ecDF485E0e4C7bD8665Fc45,0xf0FD4a182764229DcE256a59B29f9e2FD6469d96
4702,15627862,268366,8223513694,237622,30744,5450,113,0xA0c68C638235ee32657e8f720a23ceC1bFc77C77,0x88888F31f9aB8e195B7B05d717f4aBaaBaeF33a0
4703,15627862,70000,8223513694,69392,608,138,48729,0xdAC17F958D2ee523a2206206994597C13D831ec7,0x8195D3496305D2DbE43B21d51e6cC77B6C9C8364
4704,15627862,153858,8223513694,153654,204,74,326,0x008F603F0f9Aaa2C05db0F4De44cdE91fcFF430a,0xca2a640a45f74c404D4De26e65145F3c67820d69
4705,15627862,148482,8223513694,145698,2784,842,9,0x68b3465833fb72A70ecDF485E0e4C7bD8665Fc45,0x1cCD91B84b615eb8885Ea013a6D93e10636DDFF5
4706,15627862,297198,8223513694,293898,3300,1034,489,0x68b3465833fb72A70ecDF485E0e4C7bD8665Fc45,0x7862958ee0797a7ABD33A65030fC608a656febB7
4707,15627862,21000,8223513694,21000,0,2,16,0xaEF7124Da3d23d3f0E41fF22fA89fc8B58657fe3,0xd463632A0E8618995fe4c2809856E97d0E52C028
4708,15627862,45038,8223513694,44974,64,10,67,0xC02aaA39b223FE8D0A0e5C4F27eAD9083C756Cc2,0x1d9136fa6c577aDBf437dB4e63dc216D331289e6
4709,15627862,181440,8223513694,179900,1540,394,1752,0x1Fa8559e873f698292766790AeCf8080A66433F6,0xcfF5f4A02033A8EB2AA0c8F51031dBFD183085aC
4710,15627862,46083,8223513694,45595,488,138,535,0x79471Bb4CbB351a17Fa1EadB5B77AA76795c423a,0x22a9F28B71db0D0A1D0f543047DfB511d978Ad21
4711,15627862,147661,8223513694,147445,216,74,172,0x03893669C978033544a160718E3d1a3226845de6,0xCEF557e276AE24293904BA0F2bbbD1FBa8Ef3338
4712,15627862,181476,8223513694,179912,1564,394,1197,0x1Fa8559e873f698292766790AeCf8080A66433F6,0xC9B44b591A92483445923F37E49C3c562316d2Cc
4713,15627862,76335,8223513694,75727,608,138,71327,0x083D41d6DD21EE938f0c055CA4fb12268DF0EfaC,0xeE61F5fB0dB81d3A09392375Ee96f723C0620E07
4714,15627862,191257,8223513694,190237,1020,266,212,0xd588b586D61C826A0e87919b3D1a239206d58bf2,0xde499CC69295e266DcA857ab4DF0Bc6A22a99142
4715,15627862,600000,8223513694,590640,9360,4490,11614,0xCAF0784E89D2BCa4e9790eA6003947bfE7Ee31B7,0xF165D353abDDb7Cb00052d610254249FCc12a8C7
4716,15627862,21000,8144197544,21000,0,2,92739,0x72899F655f7c71F6e664CAa9A346a2cd83847f7C,0xF1300cc9c2Cf347f7902742fEC4dF9dbA952fD7b
4717,15627862,21000,8144197544,21000,0,2,92740,0xeC0b1311ef6ECF5baa07133FC0c542d90B380807,0xF1300cc9c2Cf347f7902742fEC4dF9dbA952fD7b
4718,15627862,63221,8000000000,62625,596,138,0,0xdAC17F958D2ee523a2206206994597C13D831ec7,0x8b0D183156BE36A341dC61B14291f59Dec331D20
4719,15627862,92640,8000000000,92436,204,74,516,0x5D004ddB5D92938dAF8448b9eac1CaA593cd26Ca,0xd8657569dC06cC67691A62be572C32e01AA6582f
4720,15627862,21000,8000000000,21000,0,2,47,0x8cB20525bf15147ac50c9329CfDD7b5757aA1Df5,0x70A92a3fb642fD07ed7f018A8B1C9ff80b9632bC
4721,15627862,85000,8000000000,84332,668,138,3,0x0944D5848BD9F60A34Ba92aEa300d4286696Eb76,0xc59e22E409C296CEd0e0468D49d9d72a132Acd0B
4722,15627862,5342733,7984752916,5110993,231740,30738,4,,0x478AEC926aA00D69F004874f08558d1819c30848
4723,15627862,58565,7960000000,57945,620,138,14,0xA0b86991c6218b36c1d19D4a2e9Eb0cE3606eB48,0x0A0c70DD3C586C96b47006bE5F50cF41DbF26a79
4724,15627862,288775,7792781920,285107,3668,906,0,0x197492CCB4B1acaAAcd43432657A17832E36AB49,0xe04D0aDA9BC6106dDD789999dCf4F3E5c06B7A83
4725,15627862,273028,7685200885,249880,23148,3722,285,0xCA41932888D323B3d99f5eA48F86D502055C0322,0x4814C3ebB4a740963096232A0CcA54a02B1De969
4726,15627862,288154,7598451604,286766,1388,402,245,0x1111111254fb6c44bAC0beD2854e76F90643097d,0x17aFdC04CA1D732b3A376Fb9A8131F35D894f563
4727,15627862,755439,7572355958,728639,26800,7498,4358,0x9008D19f58AAbD9eD0D60971565AA8510560ab41,0x731a0A8ab2C6FcaD841e82D06668Af7f18e34970
4728,15627862,348386,7482868287,346174,2212,586,64,0x89078be8004Fb238630C2E156DF7d3bA56e590EF,0x99CCE83Ab2e046E0e08d8aE0797f1c6f46956ec9
4729,15627862,240543,7479988633,237795,2748,842,257,0x68b3465833fb72A70ecDF485E0e4C7bD8665Fc45,0xd58fDD267f67D5c62f2D8B488Ee10aa4670018F5
4730,15627862,240558,7479988633,237798,2760,842,88,0x68b3465833fb72A70ecDF485E0e4C7bD8665Fc45,0xB74b76E1694D0830A40867212Ab7b057f1FE59bF
4731,15627862,223618,7479988633,220846,2772,842,16,0x68b3465833fb72A70ecDF485E0e4C7bD8665Fc45,0x0780b048D9f102CB89a3a87eeB15807eB254cDe8
4732,15627862,200506,7452393452,199270,1236,338,5819,0x1111111254fb6c44bAC0beD2854e76F90643097d,0xCCa178a04D83Af193330C7927fb9a42212Fb1C25
4733,15627862,1000000,7424105475,997392,2608,586,109717,0x2796317b0fF8538F253012862c06787Adfb8cEb6,0x230A1AC45690B9Ae1176389434610B9526d2f21b
4734,15627862,1000000,7424105475,998336,1664,330,109718,0x2796317b0fF8538F253012862c06787Adfb8cEb6,0x230A1AC45690B9Ae1176389434610B9526d2f21b
4735,15627862,67797,7410982649,66845,952,202,0,0x4d928Fada59F3446627C5bea707A81e006Cf676f,0x20166A7206C7908706c53D01d7D6932CD63F80f9
4736,15627862,79396,7400000000,78788,608,138,48,0xA0b86991c6218b36c1d19D4a2e9Eb0cE3606eB48,0x4d22a6584137Ed320f6eafE2EdC00fB968B22936
4737,15627862,26000,7223513694,26000,0,2,12024,0xfFEE087852cb4898e6c3532E776e68BC68b1143B,0xDAFEA492D9c6733ae3d56b7Ed1ADB60692c98Bc5
4738,15627863,69908,68034596478,68964,944,138,482,0x906e314921251090902fa78E9f9C85f04283c739,0xe3691faBe650e4Ce0E2570BBd32ac1BAe8600E71
4739,15627863,331947,68034596478,330195,1752,458,53,0x7a250d5630B4cF539739dF2C5dAcb4c659F2488D,0xC77f80824C97073b9afcF679eD8D5BD1489C4dc6
4740,15627863,21000,50000000000,21000,0,2,1,0x8b8a4abc707F16dA24B795e3e46ed22975A9D329,0x2017BD725F9432Cee396dc43e34680d5C649d129
4741,15627863,181458,30000000000,179906,1552,394,498,0x1Fa8559e873f698292766790AeCf8080A66433F6,0xA45FC9c051738F135541F97faAE2631cc6167c7C
4742,15627863,106152,8034596478,105452,700,130,11238,0xE8c060F8052E07423f71D445277c61AC5138A2e5,0xb5eaaC5a8649142dcDd13F981767913bcDF7ee42
4743,15627863,176014,9534596478,173206,2808,842,279,0x68b3465833fb72A70ecDF485E0e4C7bD8665Fc45,0x8013F0aEB145e4527d31032A3370f3B581C92152
4744,15627863,96908,37955867845,95888,1020,170,11239,0xE8c060F8052E07423f71D445277c61AC5138A2e5,0xb5eaaC5a8649142dcDd13F981767913bcDF7ee42
4745,15627863,81978,17000000000,81382,596,138,2188230,0x397Deb686C72384FAd502A81f4d7fDb89e1f1280,0x75e89d5979E4f6Fba9F97c104c2F0AFB3F1dcB88
4746,15627863,99262,17000000000,98654,608,138,2188231,0xA0b86991c6218b36c1d19D4a2e9Eb0cE3606eB48,0x75e89d5979E4f6Fba9F97c104c2F0AFB3F1dcB88
4747,15627863,237054,8034596478,234870,2184,650,122591,0xA69babEF1cA67A37Ffaf7a485DfFF3382056e78C,0x1c8F6A5F009E051CaB9C3851ca2DA2c936b2775A
4748,15627863,334585,13034596478,334381,204,74,3153,0x55f1C36Bb7aE0d7D6caE97902E30A2306686Ec73,0x86fFf6af1614bc18c72840ff8e6C033DD43BEd8A
4749,15627863,222222,12000000000,220658,1564,394,176,0x1Fa8559e873f698292766790AeCf8080A66433F6,0xE998CD7ef2593D5DDcE5437F2ed22726d393535C
4750,15627863,21000,11940000000,21000,0,2,21,0x28B29A66B93bdB18B713d2ef6f0405f3c569ff15,0xb9e83009aa3E15Ac4a6fC255C3642D8f66B9725c
4751,15627863,63187,11940000000,63187,0,2,4,0xa12Cfe9bdF0020114779B4D275B56279B10a9629,0xc920039Dd137A51782a5F3F52F8C733dC1Ca6368
4752,15627863,63000,11794885893,63000,0,2,2710052,0x85B8bEac4A0b4E375f8A79463B983126e655bAdb,0xC098B2a3Aa256D2140208C3de6543aAEf5cd3A94
4753,15627863,700000,11034596478,698224,1776,458,169,0xEfF92A263d31888d860bD50809A8D171709b7b1c,0xd4B0E9b4ACa0CEe858F03f746c498E4c902cE8cc
4754,15627863,714933,11034596478,712849,2084,522,210,0x7a250d5630B4cF539739dF2C5dAcb4c659F2488D,0x019Df15Da0d0b6FB35F5B54C17a63d3842e12BE3
4755,15627863,181456,8034596478,180824,632,90,103242,0x01FF6318440f7D5553a82294D78262D5f5084EFF,0x5AA17fC7F2950ECa85376C3A8CB1509e8e4B39dF
4756,15627863,215188,9534596478,212404,2784,842,66,0x68b3465833fb72A70ecDF485E0e4C7bD8665Fc45,0xc6dCDC797d18C3B81Bc59B18F70E4bEC6FF9D504
4757,15627863,171597,16029182951,170645,952,130,103243,0x01FF6318440f7D5553a82294D78262D5f5084EFF,0x5AA17fC7F2950ECa85376C3A8CB1509e8e4B39dF
4758,15627863,49800,11000000000,49192,608,138,18,0xA0b86991c6218b36c1d19D4a2e9Eb0cE3606eB48,0x84DB7c2937A75e6544Fa8a032271E831A419F1cb
4759,15627863,49800,11000000000,49204,596,138,0,0xA0b86991c6218b36c1d19D4a2e9Eb0cE3606eB48,0xCc0d405E7f076cb6261DC4DB504682211C1765a7
4760,15627863,78348,10800000000,77360,988,202,172428,0xAb1c5153483Be3Dd60a8C698E348A0c6d216424C,0xE052113bd7D7700d623414a0a4585BCaE754E9d5
4761,15627863,143796,10534596478,143592,204,74,73,0x7F9306FC1978938d5C1C57Bf6044dc67E07eeB8a,0x9B989898d9B293481E000df547d310b79d4137e7
4762,15627863,237636,10534596478,234828,2808,842,43,0x68b3465833fb72A70ecDF485E0e4C7bD8665Fc45,0x5C2372213B140Bc989824a7cC3813859893B0C87
4763,15627863,129691,10534596478,129487,204,74,431,0x7F9306FC1978938d5C1C57Bf6044dc67E07eeB8a,0x6eE74060e6F102cb1a2B70102214E47e75C51C3D
4764,15627863,21000,10243596478,21000,0,2,251062,0xC35B5cF074A66b6dC6eF6Ae7Bc33a36e77156F4E,0x8216874887415e2650D12D53Ff53516F04a74FD7
4765,15627863,21000,10035596478,21000,0,2,113049,0xE39Fc711DD655C7A791C786700b69B1c5Bd302d8,0x6081258689a75d253d87cE902A8de3887239Fe80
4766,15627863,50000,10035596478,50000,0,2,57499,0xE1bEf5cD780885589A6DB9C35Af564Ec9ed51A4c,0x91a0a3043f68986043D7083C4D85B558B21F0A7B
4767,15627863,207128,10034596478,207128,0,2,3492277,0xFE6fc65866F075882efBF9F7464898260d159187,0x56Eddb7aa87536c09CCc2793473599fD21A8b17F
4768,15627863,207128,10034596478,206496,632,138,4468947,0x3845badAde8e6dFF049820680d1F14bD3903a5d0,0x21a31Ee1afC51d94C2eFcCAa2092aD1028285549
4769,15627863,235564,10034596478,231960,3604,1162,40,0x68b3465833fb72A70ecDF485E0e4C7bD8665Fc45,0x6699950BF1324B13d3055566767d4966A0759376
4770,15627863,207128,10034596478,207128,0,2,4468948,0xd86E840E377aD58c994a89A5C54324610DB38262,0x21a31Ee1afC51d94C2eFcCAa2092aD1028285549
4771,15627863,2000000,10034596478,1992072,7928,1866,171042,0xA9D1e08C7793af67e9d92fe308d5697FB81d3E43,0x7830c87C02e56AFf27FA8Ab1241711331FA86F43
4772,15627863,21000,10034596478,21000,0,2,8265750,0xE1cDDe843446f0BdE8787F85aE01aE3d28d6b65B,0xb5d85CBf7cB3EE0D56b3bB207D5Fc4B82f43F511
4773,15627863,21000,10034596478,21000,0,2,1783203,0xfFBd263Ca04CE5649241d39d6E35996b82e235eC,0x503828976D22510aad0201ac7EC88293211D23Da
4774,15627863,21000,10034596478,21000,0,2,8804465,0x6a820102208f750328Cd503771607c4e78850Df0,0x3cD751E6b0078Be393132286c442345e5DC49699
4775,15627863,21000,10034596478,21000,0,2,1211348,0x8f1B8e9E307911e11385Ff05d09b13a8c65be2F0,0x95A9bd206aE52C4BA8EecFc93d18EACDd41C88CC
4776,15627863,2000000,10034596478,1985836,14164,3082,171043,0xA9D1e08C7793af67e9d92fe308d5697FB81d3E43,0x7830c87C02e56AFf27FA8Ab1241711331FA86F43
4777,15627863,21000,10034596478,21000,0,2,52377,0x49710daf3191CAc32363CA37319e1F9F40e08a7A,0x7c195D981AbFdC3DDecd2ca0Fed0958430488e34
4778,15627863,42000,10034596478,42000,0,2,329529,0xF451fC6c1E98DC6EECD48916a90078678bD1D633,0x9430801EBAf509Ad49202aaBC5F5Bc6fd8A3dAf8
4779,15627863,90000,10034596478,89380,620,138,93926,0xA0b86991c6218b36c1d19D4a2e9Eb0cE3606eB48,0xf89d7b9c864f589bbF53a82105107622B35EaA40
4780,15627863,50719,10034596478,50111,608,138,489,0xdAC17F958D2ee523a2206206994597C13D831ec7,0xC7D7a60c125A8C01E852E8b5bc67dE8517C5e4F1
4781,15627863,210690,10034596478,208286,2404,586,281,0xd9e1cE17f2641f24aE83637ab66a2cca9C378B9F,0xc89371d31C43846077a240F55208bfe1FA1D5b27
4782,15627863,230559,10034596478,223895,6664,1810,97,0x00000000006c3852cbEf3e08E8dF289169EdE581,0x464725Da1ebC575a8192da6CAcB01b70DF0be0c0
4783,15627863,246026,10000000000,243290,2736,842,5,0x68b3465833fb72A70ecDF485E0e4C7bD8665Fc45,0xbE8ECD560EE51cFA9AFf0540207E38248C192f00
4784,15627863,191041,10000000000,190165,876,266,1391,0xd588b586D61C826A0e87919b3D1a239206d58bf2,0xC22d03e13B888Dabb33A1575e4F6542f0e996622
4785,15627863,150000,9879299216,149392,608,138,29,0xe3c408BD53c31C085a1746AF401A4042954ff740,0xBd65fF2AeE16f5ec6Fc8b5A164EE50c7B0e4d8a9
4786,15627863,402467,9694596478,394975,7492,2314,293,0xDEF171Fe48CF0115B1d80b88dc8eAB59176FEe57,0x17D065070486Ca0fC8b4B382b946BE79Fb4fF10D
4787,15627863,50000,9634277443,50000,0,2,1210287,0x966ca8f23BAB6a8A2aF6f3e806c2A6e47440bc57,0x912fD21d7a69678227fE6d08C64222Db41477bA0
4788,15627863,128120,9534596478,127348,772,202,2,0xcDA72070E455bb31C7690a170224Ce43623d0B6f,0xfa41E58b32972630F769B98bC1FA749315a167f3
4789,15627863,220458,9534596478,217638,2820,842,495,0x68b3465833fb72A70ecDF485E0e4C7bD8665Fc45,0xbCa96f4D7129512D195Ebc65D537FC2324835822
4790,15627863,70807,9534596478,70743,64,10,283,0x5cd2FAc9702D68dde5a94B1af95962bCFb80fC7d,0xf74e644D030D378Ce753FC45A5d4b0aF06E5d0E5
4791,15627863,130937,9534596478,130441,496,202,32,0xD930c1C055C96aD8f58c9d6761Ab4Cbb71E176F4,0x7CadfbA12a2764656B2EE2Ba13cBf221D0099A84
4792,15627863,166745,9534596478,160145,6600,1802,26,0x00000000006c3852cbEf3e08E8dF289169EdE581,0x19443b60F0047551b16491a65e0A01486a2Cd9a0
4793,15627863,46157,9534596478,45669,488,138,3,0xEb4e856F69158052aC0AaF7Dc26f63DCb1ee067F,0xcB3cd55f9f75490CCD311caAb8f1C9E46f7BbB13
4794,15627863,21000,9534596478,21000,0,2,708,0x11F4f2F7433cf7f33204988a205eD5D564fa9FE2,0x17301aA866A6FFEe762c51134934924d2727b35E
4795,15627863,928590,9534596478,918366,10224,3338,40,0x0000000000c2d145a2526bD8C716263bFeBe1A72,0xE39c69a3ee0F553ad70b27622e4dAEb2225fB1b3
4796,15627863,175971,9534596478,173199,2772,842,1137,0x68b3465833fb72A70ecDF485E0e4C7bD8665Fc45,0x6d01af8711133DEE2B2edfC54DC6Ce38223f8396
4797,15627863,21000,9534596478,21000,0,2,110,0xF8240634ff7dc031ba5bf2013F0fC2789F28F288,0x854aE8072c8D0BdC761D5251ac8827729E907C29
4798,15627863,46280,9534596478,45420,860,138,79,0xC02aaA39b223FE8D0A0e5C4F27eAD9083C756Cc2,0x17ff38F48f36bd691B5322DDb68792000440fdd6
4799,15627863,21000,9534596478,21000,0,2,24,0x4286262EC04cBE19d85944441a09Ca44C567B27a,0x9a2BBc3a1b644Df5AD1E47D810A6Ce7397497115
4800,15627863,59382,9534596478,52558,6824,2130,260,0x00000000006c3852cbEf3e08E8dF289169EdE581,0x11CC2c512B7DBEF83E2641C3c00B3cE43De3B457
4801,15627863,86349,9534596478,86145,204,74,228,0x55f1C36Bb7aE0d7D6caE97902E30A2306686Ec73,0x12892CEeF1db846FEded7d411deE5F80701bC4A7
4802,15627863,316898,9534596478,312130,4768,1546,958,0x68b3465833fb72A70ecDF485E0e4C7bD8665Fc45,0x6E4e13909EC2833100E3751Dd772A59623D874D1
4803,15627863,53915,9534596478,53427,488,138,116,0x6de7aC835EC6841Af9b94fd1273dB83B8d69e3f7,0xe00fEe0F54d337FAF283a77c4fCC59604f59A473
4804,15627863,148058,9534596478,141446,6612,1802,134,0x00000000006c3852cbEf3e08E8dF289169EdE581,0x521A40028B0C2Bb47b9e9Bf059a2A43A02F9Ad86
4805,15627863,46267,9534596478,45691,576,74,324,0x283Af0B28c62C092C9727F1Ee09c02CA627EB7F5,0x78d3D4ed8386e51b60c58ae916302d96E5c0F845
4806,15627863,135575,9534596478,128835,6740,1698,152,0x00000000006c3852cbEf3e08E8dF289169EdE581,0xF0107Fc925f074Da6f3fa410875E9917627A63F7
4807,15627863,604915,9534596478,593123,11792,3666,944,0xDef1C0ded9bec7F1a1670819833240f027b25EfF,0xBb07f16C0E85dE5D3e3215462293d66C54E974FF
4808,15627863,46092,9534596478,45604,488,138,2527,0x71bbbD73e29132AF6B54DCC4d7f530F2700C6134,0x385Ce1e2ACC629CB20e5A41F583aDFeD9Fc3Ad79
4809,15627863,55636,9534596478,54692,944,138,42,0xC02aaA39b223FE8D0A0e5C4F27eAD9083C756Cc2,0xD96F023D7182256e3f20A6a149BF5c2BB204aCf0
4810,15627863,389460,9534596478,385844,3616,1162,401,0x68b3465833fb72A70ecDF485E0e4C7bD8665Fc45,0x4140B0BE326a07C4ad3D24A39B404A02B2dE4aC3
4811,15627863,210000,9534596478,209060,940,202,1208,0xF845e3d7AE916CA50C7Db40808E9Cc579B5f6705,0x4a465C6dB61C0055469a891D5BAF7A4DD1c7ae15
4812,15627863,62465,9534596478,61893,572,138,76,0x4CEB477A068350BC652caBFf127f87AD874B11F9,0xF2C0272D384393f3DD8F5F9C4691838aBA74C4E8
4813,15627863,195613,9534596478,189025,6588,1802,10,0x00000000006c3852cbEf3e08E8dF289169EdE581,0x2993002a2E36Cd09d9708B39c00682Be1dDc31F8
4814,15627863,50719,9534596478,50111,608,138,14,0xdAC17F958D2ee523a2206206994597C13D831ec7,0x5b9e37Fc0201Bc592a784c8051FD629abaB1f4EF
4815,15627863,21000,9534596478,21000,0,2,109,0x881038B32B35Ae0E0f5b19Dd87141b41bFe920f7,0x08Deb89d3A895f535C8a9f865d93C146Fd7b5dA8
4816,15627863,21000,9534596478,21000,0,2,27,0x888874E5ab7b4F0955Fc07f3400016Ab2e948888,0x111128188f959727332d58A217CF704d516e5555
4817,15627863,264597,9534596478,258113,6484,1738,2061,0x00000000006c3852cbEf3e08E8dF289169EdE581,0x62B4bCaFe045048916632a35A5DF563790eEBf81
4818,15627863,61423,9534596478,53271,8152,2506,45,0x00000000006c3852cbEf3e08E8dF289169EdE581,0x78644036dd87DEF9fe66a95f58fB9D33f172454d
4819,15627863,21000,9534596478,21000,0,2,7,0xB96Ab28F90b838435152148032392ea0da3AC7DA,0xf720426f35033C9B000AA0895f6987997fff4510
4820,15627863,56456,9534596478,55512,944,138,20,0x1f9840a85d5aF5bf1D1762F925BDADdC4201F984,0xDEB1195c419C54bC6a4dD55bb0D4fe9B18FA21F9
4821,15627863,21000,9534596478,21000,0,2,86,0xd5481575130a7DeCF4503c81a50152B3753031F9,0x2869d9C6314F3D9aB1E50F608cC2136535FE6604
4822,15627863,146706,9534596478,140130,6576,1802,482,0x00000000006c3852cbEf3e08E8dF289169EdE581,0x263fd42F241E7ab5C2c03D1C01fcb90dc437bA2A
4823,15627863,21000,9534596478,21000,0,2,462,0xA45D9C27778D6403e3487c4E1658B88bEe37e4eA,0xe5b48580a225F542B57c34a29EaeA9A01Bf9245E
4824,15627863,56659,9534596478,55715,944,138,94,0x9431DE2DFE10BDB30995bd3791dE03a6c9570054,0xA5D3379E5b04908B1e375c268341d2B57C8f1bf6
4825,15627863,504708,9534596478,503608,1100,330,1154,0xF3E778F839934fC819cFA1040AabaCeCBA01e049,0x99F84F7BA2EDF044B844d15CAED4b5B4A676E463
4826,15627863,121833,9534596478,120845,988,202,21,0xCB53ac3735c0c234FB420d459043684cbc073A12,0x5630bab8549Aaaf78435023c389c586aA0c356Ae
4827,15627863,21000,9534596478,21000,0,2,835,0x9cD0Ebe38F97c92F0e22613EaB7CDd6082A6202B,0x6f4c221f1c06ADb4bE502395a27D326178278f0E
4828,15627863,49389,9534596478,48901,488,138,41,0xa5D86a7Aabc36b3ef14060bb47C74ea8efC65752,0x3106804Fc9E3A769aDD46c28712a1f1EA960D441
4829,15627863,155520,9534596478,154668,852,266,340,0x10b53e97818f42F4E4DA98De956b353AC1340118,0x85c11238C97EB14EEF0957cf5bA69e28288c1493
4830,15627863,159130,9534596478,152490,6640,1810,322,0x00000000006c3852cbEf3e08E8dF289169EdE581,0xb998874bCb70F1075d2CaC03B560245ae2917989
4831,15627863,392775,9534596478,389147,3628,1162,625,0x68b3465833fb72A70ecDF485E0e4C7bD8665Fc45,0x913e0251ded5F3fAf0EEaeeB36Ca31610ddbA014
4832,15627863,46682,9534596478,46194,488,138,1073,0x67df41EDf21e1c581A77E939f60db7bAa5E96993,0x430d00d7b63715fF5f19c825B750Aa20CE627C8b
4833,15627863,21000,9270000000,21000,0,2,705876,0x1D313918b9eab3973EF89B182F348064fEDc935e,0x6dfc34609a05bC22319fA4Cce1d1E2929548c0D7
4834,15627863,21000,9253753255,21000,0,2,11,0xa7de08C1fF5Bf1ff3475f8bCF70Ff1D2352463e9,0x9afEf63384A707f8ba9AC4F09638267C6135091F
4835,15627863,63589,9134597478,63325,264,74,7,0xC02aaA39b223FE8D0A0e5C4F27eAD9083C756Cc2,0xEe0D588697cAb9Bf800D90Cd3804175403A17372
4836,15627863,266456,9034596478,264200,2256,650,116840,0xA69babEF1cA67A37Ffaf7a485DfFF3382056e78C,0x6046945C5B5eF5933b8E73a98A6AD7bF3e031df7
4837,15627863,181476,9034596478,179912,1564,394,913,0x1Fa8559e873f698292766790AeCf8080A66433F6,0x99F1396495cCeaFfE82C9e22b8A6ceB9c6b9336d
4838,15627863,305920,9034596478,298920,7000,970,2528,0x9b3B6974531d8AA15A87908FFd821A64863Ede5B,0xbEe1f7e369B3271088Ed58bF225DF13Cd96D32d5
4839,15627863,181476,9034596478,179912,1564,394,204,0x1Fa8559e873f698292766790AeCf8080A66433F6,0x780ca3A3980c0ba5DC9c9fE332b99F74cCACB6C8
4840,15627863,184162,9034596478,177534,6628,1810,627,0x00000000006c3852cbEf3e08E8dF289169EdE581,0x75CE0A06A40b86D5c9D43F9f9c14D8b060C3E7F8
4841,15627863,263532,9034596478,259712,3820,970,119380,0xa57Bd00134B2850B2a1c55860c9e9ea100fDd6CF,0x0cac3d1a887206e0f6169222C4504301A8b4b993
4842,15627863,159001,9034596478,156157,2844,842,383,0x68b3465833fb72A70ecDF485E0e4C7bD8665Fc45,0x1453169a1B1Fb2160B4c64E573c2296CB131143A
4843,15627863,125000,9034596478,124392,608,138,579944,0xd3A090FE0C76c19EDe5F3b5B5c71AEF43f437622,0x74dEc05E5b894b0EfEc69Cdf6316971802A2F9a1
4844,15627863,181476,9034596478,179912,1564,394,127,0x1Fa8559e873f698292766790AeCf8080A66433F6,0xE17A6a509C173b0783B33254201B7476BEb32DCF
4845,15627863,21000,9034596478,21000,0,2,7100799,0x87114caD3245fbeC0f5B0a3575f73C67dB8a4C81,0xddfAbCdc4D8FfC6d5beaf154f18B778f892A0740
4846,15627863,21000,9034596478,21000,0,2,1783204,0x1A1F7B0D3d114dc4C7Bbf74712eA421C4B27e0b0,0x503828976D22510aad0201ac7EC88293211D23Da
4847,15627863,21000,9034596478,21000,0,2,346922,0xbcd372E502886C756fE814E400E5D86030B79319,0x77696bb39917C91A0c3908D577d5e322095425cA
4848,15627863,21000,9034596478,21000,0,2,469164,0x485Cb923f3aF87366A79489b58f71edd272Ac995,0xb739D0895772DBB71A89A3754A160269068f0D45
4849,15627863,160399,9000000000,153811,6588,1802,379,0x00000000006c3852cbEf3e08E8dF289169EdE581,0xC645C8bDb7bAc795a7AaD2A2903d9C1EAB54b995
4850,15627863,69530,9000000000,68922,608,138,385,0xdAC17F958D2ee523a2206206994597C13D831ec7,0x01E6d28d21B6ac49686035D846E406F8958Ea4Ee
4851,15627863,8000000,8893179178,7999936,64,10,15100,0xF2A0BD19d179F8283be3E4907fa8a6D53A096745,0xb2AA4a5DF3641D42e72D7F07a40292794dfD07a0
4852,15627863,227660,8540000000,227228,432,74,4,0x44c01e5e4216f3162538914d9c7f5E6A0d87820e,0x53E2859aA0Cc758248B3b67770C619e347ce4B8d
4853,15627863,21000,8410982649,21000,0,2,1,0x03476A65eFD691bD32CDa69EA320a5BadDeAD777,0x72232730f2250D05b96197E5e7627C7e37FaBF7d
4854,15627863,21000,8410982649,21000,0,2,3,0x03476A65eFD691bD32CDa69EA320a5BadDeAD777,0xCb6b47A6cEf3B053D608012d35fE0a0C055848F2
4855,15627863,55978,8293951071,55034,944,138,228,0xd4cB651749953988647eEE9b51DDB8DB5aeb3410,0xB6D1aa613F99AcA09a4aE736C37B0d9073f0265F
4856,15627863,93400,8222065433,91812,1588,394,60,0xa909871F46d2cD8Fb015d176483Ffc3C330DCDA4,0xcc8992DcA072330ACC2E0DCC13d67edf27ddCf32
4857,15627863,200000,8222065433,199392,608,138,856,0xdAC17F958D2ee523a2206206994597C13D831ec7,0x741241465Ba6C882E0414665b89794A5E90c86DB
4858,15627863,26000,8034596478,26000,0,2,12025,0xBE691BA3c196b8179ed6C607785B81c751759386,0xDAFEA492D9c6733ae3d56b7Ed1ADB60692c98Bc5
4859,15627864,69908,67853936099,68964,944,138,54,0x906e314921251090902fa78E9f9C85f04283c739,0xC77f80824C97073b9afcF679eD8D5BD1489C4dc6
4860,15627864,227265,57853936099,225417,1848,458,1049,0x7a250d5630B4cF539739dF2C5dAcb4c659F2488D,0xA1CC352bC94caDdFddaA4D095762F37B2b9bc57A
4861,15627864,157872,7853936099,157304,568,76,5186,0x00000000A991C429eE2Ec6df19d40fe0c80088B8,0x77ad3a15b78101883AF36aD4A875e17c86AC65d1
4862,15627864,206428,9853936099,203668,2760,842,1362,0x68b3465833fb72A70ecDF485E0e4C7bD8665Fc45,0xc3FD9C40521394c1DbcF57d6912baBCf394F33C0
4863,15627864,142003,90186785801,141115,888,116,5187,0x00000000A991C429eE2Ec6df19d40fe0c80088B8,0x77ad3a15b78101883AF36aD4A875e17c86AC65d1
4864,15627864,420000,30000000000,419344,656,138,2198553,0xD533a949740bb3306d119CC777fa900bA034cd52,0x6cC5F688a315f3dC28A7781717a9A798a59fDA7b
4865,15627864,55914,17853936099,54970,944,138,622,0xe0aC26c7a2A3511458B147F1F5B23E7F399B7fa8,0x1aC217D61C002cAa32e1D46DadBBf3dC8F07E792
4866,15627864,5049496,17000000000,5042372,7124,1098,286,0x0a39DA505DfB5E0BBc6bd84428281A8ba1bC7753,0x495E889d1A6cEB447a57dcc1C68410299392380c
4867,15627864,90000,15000000000,89392,608,138,0,0xdAC17F958D2ee523a2206206994597C13D831ec7,0x3E22a86E22E461a636bF64092754CdA6f46996e2
4868,15627864,21000,13370255592,21000,0,2,33035,0xb7Af6031d3b3d7917AACacDDef44a482dba148e1,0xBd9B34cCbb8db0FDECb532B1EAF5D46f5b673fE8
4869,15627864,356073,12853936099,354321,1752,458,84,0x7a250d5630B4cF539739dF2C5dAcb4c659F2488D,0x4ED112256BCa213441dA597C593637B2feBd0848
4870,15627864,30000,12319502007,30000,0,2,27,0x0158C01F09CF246791C6818c6b976b5f9C478268,0xC2f0BbF5A3503B1e1D0c0270f1c7ae5b72cCB51d
4871,15627864,350000,11116473974,349392,608,138,6925049,0xdAC17F958D2ee523a2206206994597C13D831ec7,0x46340b20830761efd32832A74d7169B29FEB9758
4872,15627864,350000,11116473974,350000,0,2,6925050,0x90571F7CBc82eae8886f610fc017C918d6085a20,0x46340b20830761efd32832A74d7169B29FEB9758
4873,15627864,100000,11116473973,99392,608,138,181433,0x473037de59cf9484632f4A27B509CFE8d4a31404,0x6238872A0Bd9F0E19073695532a7Ed77ce93C69E
4874,15627864,100000,11116473973,99392,608,138,181434,0x473037de59cf9484632f4A27B509CFE8d4a31404,0x6238872A0Bd9F0E19073695532a7Ed77ce93C69E
4875,15627864,49800,11000000000,49192,608,138,14,0xA0b86991c6218b36c1d19D4a2e9Eb0cE3606eB48,0xB8ed33257A0EF6D294FC6579b23Bdc1A30AA8195
4876,15627864,282861,10853936099,282409,452,138,543,0x4E053ac1F6F34A73F5Bbd876eFd20525EAcB5382,0x3063D85AB19C6154fca06f5dc7A92502F030751e
4877,15627864,55872,10690817572,55440,432,74,155625,0x3B30FD5b2850F24d76912C7a00FbB42e208a4782,0xcDd37Ada79F589c15bD4f8fD2083dc88E34A2af2
4878,15627864,21000,10363768030,21000,0,2,60,0xCBD6832Ebc203e49E2B771897067fce3c58575ac,0xC7bD9f6d40b698F0f0e7a97b99e79B3Ba26e4B96
4879,15627864,150000,10353936099,149504,496,202,5,0x7561DEAf4ECf96dc9F0d50B4136046979ACdAD3e,0x8C7eD0Db0785ce8210C987246FAd9b6409d823D4
4880,15627864,172350,10353936099,171922,428,138,217,0x28c6ea3F9cF9bC1a07A828fce1e7783261691B49,0x158DF9e0dF873286B1233CbA5F4965044cb779C8
4881,15627864,537484,10353936099,532032,5452,2314,217,0xecEabe75639E063EfbD67C2BcF217731869B025D,0x93a51CA37Da14A2706AB4D316A70cDB092242ea5
4882,15627864,21000,10332984109,21000,0,2,95,0xCBD6832Ebc203e49E2B771897067fce3c58575ac,0x29F9e85Bf1B1F5454fE7b935B83B6BBF24890085
4883,15627864,21000,10280000000,21000,0,2,0,0x6dfc34609a05bC22319fA4Cce1d1E2929548c0D7,0x6E805A268899D389E728d9797C9cBe96cD370949
4884,15627864,21000,10280000000,21000,0,2,90,0x6dfc34609a05bC22319fA4Cce1d1E2929548c0D7,0xb9BED9Dd8c30a310D0482050825AB684937BA39B
4885,15627864,21000,10062936099,21000,0,2,23547,0xFAF8C777C3CA109e827b7978dF20143A1D4a76F4,0x43fdA7708C97C4C40d5402c6392f0457f23c0b8e
4886,15627864,362467,10000000000,362263,204,74,82,0x55f1C36Bb7aE0d7D6caE97902E30A2306686Ec73,0xf09dF69Cc7F88cB249E68A3d526BEB9a31CA23e3
4887,15627864,362467,10000000000,362263,204,74,80,0x55f1C36Bb7aE0d7D6caE97902E30A2306686Ec73,0x396DB57d24bFCeFe2105065d79Ca61d27Ce06831
4888,15627864,362467,10000000000,362263,204,74,81,0x55f1C36Bb7aE0d7D6caE97902E30A2306686Ec73,0x2c8CFdC42CD80577a71174787D0bc247B1923153
4889,15627864,197076,9863936099,195028,2048,522,348,0x7a250d5630B4cF539739dF2C5dAcb4c659F2488D,0x788296BAb7c874416c34BB5d7Bc0eb2170c97334
4890,15627864,300000,9854936099,299392,608,138,42951,0xdAC17F958D2ee523a2206206994597C13D831ec7,0xf1088841Ab08FC1Cb3835fd75207bCB3137F6EE3
4891,15627864,181476,9853936099,179912,1564,394,1736,0x1Fa8559e873f698292766790AeCf8080A66433F6,0x1228a857FD7Ee845f4999f33540F6b9D0988e80d
4892,15627864,21000,9853936099,21000,0,2,77,0x9e7B0623411e93D72A59D097D3f2465ED192Cd24,0xf2fCAe119f36afcb3eE840B311Df79a60ACA7531
4893,15627864,70000,9853936099,69392,608,138,528,0xdAC17F958D2ee523a2206206994597C13D831ec7,0xf5491f793D47A6Ea22f5e0B9AD3990CF66c4b40B
4894,15627864,39630,9853936099,39354,276,74,98,0xC02aaA39b223FE8D0A0e5C4F27eAD9083C756Cc2,0xDFB1e63A77A5Ef8FC82c378967a2e7e756A28597
4895,15627864,405586,9853936099,401270,4316,1098,0,0xe66B31678d6C16E9ebf358268a790B763C133750,0x5d8136d87AFfeDd8Fb5deAaB49E01100fC437643
4896,15627864,141613,9853936099,141409,204,74,842,0x4556561740B7B5F858967A6a4E54e506609704Bd,0x6B0a789e01eC7e7c2d02905d9DaBD3e879Ff7417
4897,15627864,314511,9853936099,305055,9456,2636,97,0x881D40237659C251811CEC9c364ef91dC08D300C,0x1c632152D528D0aa32624E0b2a410B4d97F7D0a2
4898,15627864,80000,9853936099,79356,644,138,25933,0x4a220E6096B25EADb88358cb44068A3248254675,0x8C54EbDD960056d2CfF5998df5695dACA1FC0190
4899,15627864,229650,9853936099,223350,6300,1802,1409,0x00000000006c3852cbEf3e08E8dF289169EdE581,0xcF8d3063e7074B38f4548A7e2798CE2D498A8Ee2
4900,15627864,353110,9853936099,348246,4864,1546,480,0x68b3465833fb72A70ecDF485E0e4C7bD8665Fc45,0x8764885033215F2fdfE7A2CF3a6430E14FA5BdB2
4901,15627864,42000,9853936099,42000,0,2,329530,0x9a7804FD60AB39Ab3aC39FFfAE68fd264D3731DE,0x9430801EBAf509Ad49202aaBC5F5Bc6fd8A3dAf8
4902,15627864,39617,9853936099,39353,264,74,236,0xC02aaA39b223FE8D0A0e5C4F27eAD9083C756Cc2,0x790878D7167cff1c27cb5Fd59d708359be57bFf6
4903,15627864,218798,9853936099,215558,3240,1034,257,0x68b3465833fb72A70ecDF485E0e4C7bD8665Fc45,0x97bAFecB09d44Afa1886e7d0E378e5AA3007E69C
4904,15627864,241128,9853936099,235184,5944,1738,26,0x68b3465833fb72A70ecDF485E0e4C7bD8665Fc45,0xB2cAa03F8e8abaf89186A8Ce30591CE4C36286A5
4905,15627864,582985,9853936099,563777,19208,5772,102,0x881D40237659C251811CEC9c364ef91dC08D300C,0x1DFfDE609F9023bF847A7a63f6e638A6B27d52ac
4906,15627864,51458,9853936099,50970,488,138,704,0x7F9306FC1978938d5C1C57Bf6044dc67E07eeB8a,0x09DDfF305d65F019c4611fbDF57DE848F8102E4c
4907,15627864,51458,9853936099,50970,488,138,122,0x7F9306FC1978938d5C1C57Bf6044dc67E07eeB8a,0x027425D941EE947B66adEC81763ABF99Da9A6A9F
4908,15627864,51458,9853936099,50970,488,138,228,0x7F9306FC1978938d5C1C57Bf6044dc67E07eeB8a,0xB8546dc9dBA305e6136899d4783CDe2efCf5F35A
4909,15627864,51458,9853936099,50970,488,138,188,0x7F9306FC1978938d5C1C57Bf6044dc67E07eeB8a,0x86A4BBeA92F18A564e609f4Dd379eed4bEc00037
4910,15627864,51458,9853936099,50970,488,138,83,0x7F9306FC1978938d5C1C57Bf6044dc67E07eeB8a,0xD4516cF36e27C89d3bDCa98E6F7319E6ebed3D49
4911,15627864,55950,9853936099,55006,944,138,1,0x6097004C68F7B350d72226003226Ac089597D579,0xCCA6815482a886227eA5f751445505fbA516215a
4912,15627864,181476,9853936099,179912,1564,394,190,0x1Fa8559e873f698292766790AeCf8080A66433F6,0x101745aF21d0F0fA93F1758f38c252a1175B9941
4913,15627864,51458,9853936099,50970,488,138,74,0x7F9306FC1978938d5C1C57Bf6044dc67E07eeB8a,0x72679F3c7E55F8d31CFeBc2ab532e6D041B58AC6
4914,15627864,51458,9853936099,50970,488,138,420,0x7F9306FC1978938d5C1C57Bf6044dc67E07eeB8a,0xf8A329bCe2A0085e01e410ed4981a9C1aF11fAA6
4915,15627864,227728,9853936099,224968,2760,842,404,0x68b3465833fb72A70ecDF485E0e4C7bD8665Fc45,0x9b122ab8CBE7c7E81e8C24Ab78a20b8c86A7455F
4916,15627864,51458,9853936099,50970,488,138,372,0x7F9306FC1978938d5C1C57Bf6044dc67E07eeB8a,0x67c8dAD0265cb5EC9D85A6Ae118016b42E75b442
4917,15627864,110408,9853936099,109676,732,266,2127,0x283Af0B28c62C092C9727F1Ee09c02CA627EB7F5,0xD15e7ab216AdDB92Bd95d96cb5D0F3f43719C679
4918,15627864,282679,9853936099,279919,2760,842,939,0x68b3465833fb72A70ecDF485E0e4C7bD8665Fc45,0x0ba08fd9bB14114e64EAeCb9371D149727C884d4
4919,15627864,85000,9853936099,84512,488,138,67,0xD27dcbcC8778a8AB33AAc529Df36a634567Be325,0xb8f082044e022D143C2fF78572942aA2c63C20A6
4920,15627864,85000,9853936099,84512,488,138,73,0xD27dcbcC8778a8AB33AAc529Df36a634567Be325,0xa6Ca3bC2DEbB9EAbb391d143215C410252640507
4921,15627864,51458,9853936099,50970,488,138,432,0x7F9306FC1978938d5C1C57Bf6044dc67E07eeB8a,0xbec0F91113ecB2e58eD38204Fba8796E70F2B4b4
4922,15627864,51458,9853936099,50970,488,138,375,0x7F9306FC1978938d5C1C57Bf6044dc67E07eeB8a,0x1900516b55133db14B8cE5ef0F85F9eD26F8dA19
4923,15627864,51458,9853936099,50970,488,138,355,0x7F9306FC1978938d5C1C57Bf6044dc67E07eeB8a,0xDd3811D3688f1675323BBbD7d2F256F121D40065
4924,15627864,51458,9853936099,50970,488,138,443,0x7F9306FC1978938d5C1C57Bf6044dc67E07eeB8a,0x18512898c791334313d6DbE44CDea21ea021027d
4925,15627864,51458,9853936099,50970,488,138,404,0x7F9306FC1978938d5C1C57Bf6044dc67E07eeB8a,0xc90c3a6F16b211C3Ad7711F1a04fd71d9340e9bF
4926,15627864,78538,9823936099,77894,644,138,0,0x12b6893cE26Ea6341919FE289212ef77e51688c8,0x896D3407159309e9567eF39Aa9B69a7F5614C7D3
4927,15627864,100000,9410982649,99428,572,138,1,0xC18c07a18198A6340cf4d94855fE5eb6DD33b46E,0xe0cAFa49dC7c8A751905fF4b0492f7D22d13b3EC
4928,15627864,268084,9353936099,265704,2380,586,1063,0x25553828F22bDD19a20e4F12F052903Cb474a335,0xDb4eDD77a7C6fd364822Da6254Ce4F4FE4b172d9
4929,15627864,1000000,9353936099,999344,656,138,4121131,0x42bBFa2e77757C645eeaAd1655E0911a7553Efbc,0x0D0707963952f2fBA59dD06f2b425ace40b492Fe
4930,15627864,110542,9353936099,109834,708,266,83,0x283Af0B28c62C092C9727F1Ee09c02CA627EB7F5,0xC60eA1e0DCc3E0a672304fd28F61591D9A914DA3
4931,15627864,21000,9353936099,21000,0,2,3,0x51234CF5a85d39c66840fa9D24953E65B3cd007d,0xee1593fADbaD6A7c012453e7307a0bB2317AEc0D
4932,15627864,21000,9353936099,21000,0,2,96,0x3E6BA192edF31098FcD288FB3122BA6409B05b2e,0xFd80bEF746F2D640AAE2af5294D6efEACca0192e
4933,15627864,46091,9353936099,45603,488,138,3260,0x32d86ae52597EFDc405571a403F23343A38bA900,0xdB6b6395B8a748Ea7e9df7AAC3a79F184A37651d
4934,15627864,191640,9353936099,188036,3604,1162,1294,0x68b3465833fb72A70ecDF485E0e4C7bD8665Fc45,0xBAceea144d035A70Ba8c8e2F4E9634feCFFb1553
4935,15627864,21000,9353936099,21000,0,2,84,0x95FEe334Ae5Bb5779F7e52A0fb8bf59Ca3e887ca,0x0c3Efbe3e7CecEE4d6247436475b400c12A3623c
4936,15627864,46267,9353936099,45691,576,74,227,0x283Af0B28c62C092C9727F1Ee09c02CA627EB7F5,0x57679F905F9618d50a638cc1fe272003A831cec1
4937,15627864,1000000,9353936099,999332,668,138,4121132,0x22987407FD1fC5A971e3FDA3B3e74C88666cDa91,0x0D0707963952f2fBA59dD06f2b425ace40b492Fe
4938,15627864,1000000,9353936099,999380,620,138,4121133,0x467719aD09025FcC6cF6F8311755809d45a5E5f3,0x0D0707963952f2fBA59dD06f2b425ace40b492Fe
4939,15627864,46267,9353936099,45691,576,74,179,0x283Af0B28c62C092C9727F1Ee09c02CA627EB7F5,0x483B9B145C728f34157a73596530f53429DAE189
4940,15627864,21000,9353936099,21000,0,2,513,0x7945152B7f83Da9d33dF4Bd203Dab30133CB01B0,0x1de23D0B427d764BDbABE7AE8a1735a6F2492bD3
4941,15627864,21000,9353936099,21000,0,2,4,0x35E3830659E00A15551aDa8d80f08644fc56156d,0x464131356C012C04EBceBDf060D311DFD04374EB
4942,15627864,161658,9353936099,154490,7168,1930,281,0x00000000006c3852cbEf3e08E8dF289169EdE581,0xaf5ccC7FF539301A9eed8c7bf1b52a7286Ae83dC
4943,15627864,21000,9353936099,21000,0,2,2520,0xBb6F57d9736e845A133F8164CD46A833699E65aA,0x55B9d99aF7EcCebCD0f462B70ebB5eDd23b8F048
4944,15627864,94759,9353936099,94187,572,138,4,0xdAC17F958D2ee523a2206206994597C13D831ec7,0x4F3e651fe077A653A3e51d0C060b02D2111a9934
4945,15627864,61495,9353936099,53271,8224,2506,130,0x00000000006c3852cbEf3e08E8dF289169EdE581,0x6A50896247dEbf458394BD5ec52E91a5Eee045B5
4946,15627864,21000,9353936099,21000,0,2,10,0x25512ce3e9F3107bdf91b0aB6FC1E03FFf39B261,0xe32Ef1d7756c001DABd69b947595c627a66bcb5B
4947,15627864,190465,9353936099,189045,1420,394,1331,0x99C9fc46f92E8a1c0deC1b1747d010903E884bE1,0x9a25d79AB755718e0b12BD3C927A010A543C2b31
4948,15627864,34454,9353936099,34454,0,2,63,0x52ec2F3d7C5977A8E558C8D9C6000B615098E8fC,0x72a1B660F394b50C0affe1de15ed7F8a5863A25E
4949,15627864,62465,9353936099,61893,572,138,77,0x4CEB477A068350BC652caBFf127f87AD874B11F9,0xF2C0272D384393f3DD8F5F9C4691838aBA74C4E8
4950,15627864,46267,9353936099,45691,576,74,59,0x283Af0B28c62C092C9727F1Ee09c02CA627EB7F5,0x16869FdB8AdaD248330EBF7a1F19859Cecb491bE
4951,15627864,46267,9353936099,45691,576,74,939,0x283Af0B28c62C092C9727F1Ee09c02CA627EB7F5,0x0af691F5533C2d1FBeca5Cb86705307f225F8bd3
4952,15627864,47285,9353936099,46345,940,202,1,0xF7b8aabC98D169020b9EE716FC55541cF3e8B55B,0x1b7BC68315Ca93D43D5C0d914AdcAf88C5117Cd1
4953,15627864,46267,9353936099,45691,576,74,25,0x283Af0B28c62C092C9727F1Ee09c02CA627EB7F5,0xDF960d01035aB6d705Bd9ac25B63a75fAA2D632d
4954,15627864,215860,9353936099,212256,3604,1162,185,0x68b3465833fb72A70ecDF485E0e4C7bD8665Fc45,0xFf37F09aaDe720531507DaBCF368E751aD1757bE
4955,15627864,56667,9353936099,55723,944,138,2,0xc667a0e7711de7C5916038B6FB709C93DBb7B67f,0x960F560D882e89e783F2a5Ece445F8441dD96eC1
4956,15627864,46270,9353936099,45698,572,138,1267,0x52E66cA968010d064938A8099a172CBAaf08c125,0x7c03C6FC64293c460bE652F4015aD232E695aC8e
4957,15627864,1860069,9353936099,1720593,139476,47690,559,0xaE9C73fd0Fd237c1c6f66FE009d24ce969e98704,0x876d80348d91cCA1E6BF7FAAeA94C7FeB3fD3eE9
4958,15627864,938369,9353936099,911365,27004,8458,30156,0xDEF171Fe48CF0115B1d80b88dc8eAB59176FEe57,0x65A8F07Bd9A8598E1b5B6C0a88F4779DBC077675
4959,15627864,149879,9353936099,143327,6552,1802,343,0x00000000006c3852cbEf3e08E8dF289169EdE581,0xd643aD32B6A7A8b14ecb6c4A5C0eFbFa7379e8D6
4960,15627864,21064,9353936099,21064,0,2,59,0xe5Bb8d98a3A5c70A8c3D8484FD3c296Ef3D90C94,0xe5Bb8d98a3A5c70A8c3D8484FD3c296Ef3D90C94
4961,15627864,194665,9353936099,188053,6612,1802,778,0x00000000006c3852cbEf3e08E8dF289169EdE581,0xea79b1f6EA30a2DccB7C066Da6204fBf4131BD2C
4962,15627864,1000000,9353936099,999392,608,138,4121134,0xdAC17F958D2ee523a2206206994597C13D831ec7,0x0D0707963952f2fBA59dD06f2b425ace40b492Fe
4963,15627864,1000000,9353936099,999392,608,138,4121135,0x467719aD09025FcC6cF6F8311755809d45a5E5f3,0x0D0707963952f2fBA59dD06f2b425ace40b492Fe
4964,15627864,21000,9353936099,21000,0,2,212,0xD054fE7359bdbD77118F4E9D909d566a5C3bd659,0x98fc34DE0844423DffA5f4151cc1b46Aec844220
4965,15627864,163805,9353936099,157217,6588,1802,196,0x00000000006c3852cbEf3e08E8dF289169EdE581,0xf96A03aEe86e0c47889a1367FBb1555C3b29Eb4b
4966,15627864,183452,9353936099,176220,7232,1938,1858,0x00000000006c3852cbEf3e08E8dF289169EdE581,0x97bDd734FcA8456dE0c98a7820f0F3907EF1BD83
4967,15627864,46859,9353936099,46371,488,138,1,0x197492CCB4B1acaAAcd43432657A17832E36AB49,0x01BB57dDe333314a7614973C67C60C598F076e14
4968,15627864,98983,9353936099,97691,1292,330,26,0xA0c68C638235ee32657e8f720a23ceC1bFc77C77,0x567E4357913D7e0B227D8da9644212eD2A4f7C87
4969,15627864,46383,9353936099,45607,776,138,15,0x95aD61b0a150d79219dCF64E1E6Cc01f0B64C4cE,0x27Cda06B00a0ecCF4225371792DdE8f1a5eA97EB
4970,15627864,21000,9353936099,21000,0,2,4,0x1c98d47e1065Ca1dbDeB94dd0B16E7E7d0F819b6,0xEA1AED0eF12F15C3ddfc22253822f1694EFeb85D
4971,15627864,21000,9353936099,21000,0,2,5642,0xC9B44b591A92483445923F37E49C3c562316d2Cc,0xb5F31EB9e70f88c5997a243DfB59b7097bcd84bE
4972,15627864,52529,9353936099,51685,844,202,3,0x000000000000509081d6FCD3ee63e791aD1db763,0x23a4Ae366288456A888C601e195e906C631d89c9
4973,15627864,95991,9353936099,95395,596,138,1804,0xABB3738f04Dc2Ec20f4AE4462c3d069d02AE045B,0x13A7d2Fb3F73B57EF539C35C4Ec59Ed49b1833cA
4974,15627864,401742,9163936099,399754,1988,522,7995,0x7a250d5630B4cF539739dF2C5dAcb4c659F2488D,0x11191bcfe30c6aE7bBEF74c6De97c8D52FF957F9
4975,15627864,2000000,9044271976,1997940,2060,522,475,0x7a250d5630B4cF539739dF2C5dAcb4c659F2488D,0xCa6b060a4E795473a2205ebD1ff2599A8bEF1DF8
4976,15627864,210000,9000000000,209404,596,138,1801,0xdAC17F958D2ee523a2206206994597C13D831ec7,0x2e43785346bDe33A4804a1dccB333Bdc2919eF31
4977,15627864,50000,9000000000,50000,0,2,0,0x077D360f11D220E4d5D831430c81C26c9be7C4A4,0xa103Cc8eB72D77E3305fBAE8ea7Cc3D51ef929A6
4978,15627864,337383,9000000000,331343,6040,1738,60,0x362fA9D0bCa5D19f743Db50738345ce2b40eC99f,0xe5Bb8d98a3A5c70A8c3D8484FD3c296Ef3D90C94
4979,15627864,21000,8900000000,21000,0,2,1,0x292f04a44506c2fd49Bac032E1ca148C35A478c8,0xd5928959718A706D0f734cA136D87DdFbC6014f4
4980,15627864,8000000,8893179178,7999936,64,10,15101,0xF2A0BD19d179F8283be3E4907fa8a6D53A096745,0xb2AA4a5DF3641D42e72D7F07a40292794dfD07a0
4981,15627864,21000,8853936099,21000,0,2,8265751,0x867805cc764D075cdBc100a4C163Ebe28Da685ae,0xb5d85CBf7cB3EE0D56b3bB207D5Fc4B82f43F511
4982,15627864,21000,8853936099,21000,0,2,1783205,0xC2Cd9648aE5E2918ba0bd02403E064728040eFe7,0x503828976D22510aad0201ac7EC88293211D23Da
4983,15627864,181458,8853936099,179906,1552,394,190,0x1Fa8559e873f698292766790AeCf8080A66433F6,0xb1CcE4Cc002cd7fD96E6225727C6a43B1DaC0905
4984,15627864,102382,8853936099,101054,1328,330,114,0xA0c68C638235ee32657e8f720a23ceC1bFc77C77,0x88888F31f9aB8e195B7B05d717f4aBaaBaeF33a0
4985,15627864,181476,8853936099,179912,1564,394,1943,0x1Fa8559e873f698292766790AeCf8080A66433F6,0x4eC3B52C788f58a6f273F33e4cbC38ae2cBfE6C8
4986,15627864,69400,8853936099,68824,576,74,106,0x283Af0B28c62C092C9727F1Ee09c02CA627EB7F5,0xc40456ee3Ce933b81D9be4D68d964Eeb1F684298
4987,15627864,250000,8853936099,250000,0,2,45337085,0x19299869c5F266Fa067C92df4a70Dce7B6158967,0xEA674fdDe714fd979de3EdF0F56AA9716B898ec8
4988,15627864,250000,8853936099,250000,0,2,45337086,0xAd860fCB8C7487bbb95E4E99820F2c7f0c1f0Fa1,0xEA674fdDe714fd979de3EdF0F56AA9716B898ec8
4989,15627864,250000,8853936099,250000,0,2,45337087,0xb3C2FF7496ae8467181F989213F18e503991d4e0,0xEA674fdDe714fd979de3EdF0F56AA9716B898ec8
4990,15627864,250000,8853936099,250000,0,2,45337088,0x585f18582E652D107712F217d3F769f21d158A1A,0xEA674fdDe714fd979de3EdF0F56AA9716B898ec8
4991,15627864,250000,8853936099,250000,0,2,45337089,0xbA132398fFdBE4a608d5D4E86883172F65F07070,0xEA674fdDe714fd979de3EdF0F56AA9716B898ec8
4992,15627864,250000,8853936099,250000,0,2,45337090,0x64E79b584f4C9CD64D95A8acD3a5453275c0f04c,0xEA674fdDe714fd979de3EdF0F56AA9716B898ec8
4993,15627864,250000,8853936099,250000,0,2,45337091,0x171D4086875c1762F19c8b7984E784df02cb9EEb,0xEA674fdDe714fd979de3EdF0F56AA9716B898ec8
4994,15627864,250000,8853936099,250000,0,2,45337092,0xb14Aa6Fbe2Cb86463199162D9637347460136065,0xEA674fdDe714fd979de3EdF0F56AA9716B898ec8
4995,15627864,250000,8853936099,250000,0,2,45337093,0x629FCC333BED90c0E1E19B41457cE7928bAA5c5C,0xEA674fdDe714fd979de3EdF0F56AA9716B898ec8
4996,15627864,250000,8853936099,250000,0,2,45337094,0x844Ce86be38715B3548265Ca655a3Cefd6367549,0xEA674fdDe714fd979de3EdF0F56AA9716B898ec8
4997,15627864,175074,8853936099,173534,1540,394,7,0x1Fa8559e873f698292766790AeCf8080A66433F6,0xcB00F8072b7Ba0b5773F3D801f96Ea8a66a0049d
4998,15627864,112827,8853936099,111787,1040,330,111,0x6D7c44773C52D396F43c2D511B81aa168E9a7a42,0xb89E89b79513D251341924698D50962c69dba33a
4999,15627864,43110,8853936099,42846,264,74,202,0x55f1C36Bb7aE0d7D6caE97902E30A2306686Ec73,0x5bAB06Aab8aEcD0E60c8287391233F2285ad7071
5000,15627864,21000,8853936099,21000,0,2,7100800,0xA4c507a1eB3cd1bf2c1389F2D6cb93C9be971911,0xddfAbCdc4D8FfC6d5beaf154f18B778f892A0740
5001,15627864,21000,8853936099,21000,0,2,8265752,0x05A0F770229Be7FE32cF3849ea33C1E78DEEe8d8,0xb5d85CBf7cB3EE0D56b3bB207D5Fc4B82f43F511
5002,15627864,42120,8853936099,42056,64,10,4,0x011b0beAe3eC5953B4805b064cC78f6F892A99cC,0x7D35286C7d6864Cf6A61b4EC90F3d2FB6F8C7935
5003,15627864,181476,8853936099,179912,1564,394,314,0x1Fa8559e873f698292766790AeCf8080A66433F6,0xB32b2aF57A7f5602973F47Ec696334102A9ce0eC
5004,15627864,272544,8791280874,268892,3652,1162,4282,0x68b3465833fb72A70ecDF485E0e4C7bD8665Fc45,0x404F5A67F72787a6DBDbF73E5cfEBD17216e9D32
5005,15627864,386971,8791280874,381287,5684,1866,391,0x68b3465833fb72A70ecDF485E0e4C7bD8665Fc45,0xDD4C5ecde17620c87e68B9a1153AF5a6a19D1f45
5006,15627864,21000,8685200885,21000,0,2,11,0x1ED566bef24e06D4741d6329B2BD190236b05dF5,0x4ABf3b8F97327cc6EbE579699ef0c9Ba02A8A158
5007,15627864,163801,8497731930,163597,204,74,56,0x6b6fa17ce72EDd3bf092D4DA66a45Aab87750867,0x9f603bB97c9799B38AcA0F6cA02E1CD3Ae49AD78
5008,15627864,51458,8497731930,50970,488,138,408,0xEd94eA1aecdBF56E1fB49d90f348F15B4043E6B5,0x2d42e1EeC1c61dD9d1dDff2405E91BA6179Aa0B8
5009,15627864,21000,8410982649,21000,0,2,8,0x03476A65eFD691bD32CDa69EA320a5BadDeAD777,0x5d615fdCf213bC57750bEE92E622aB9F0252f762
5010,15627864,88853,8223513694,85577,3276,1034,536,0x0000000000c2d145a2526bD8C716263bFeBe1A72,0x22a9F28B71db0D0A1D0f543047DfB511d978Ad21
5011,15627864,105000,8222065433,105000,0,2,138567,0xc919cC63a66e099a9E40cC10d2A65560E1bC7aD5,0x974CaA59e49682CdA0AD2bbe82983419A2ECC400
5012,15627864,21000,8222065433,21000,0,2,42,0x787B8840100d9BaAdD7463f4a73b5BA73B00C6cA,0x769a7307378C41BDF43C4AB27d71fE711AA5a83b
5013,15627864,80000,8222065433,79056,944,138,0,0xA0b86991c6218b36c1d19D4a2e9Eb0cE3606eB48,0x8e6345559beB03A72BbE314d3Fdb774Cd8eb8F3E
5014,15627864,213169,8222065433,211333,1836,458,5547,0xEfF92A263d31888d860bD50809A8D171709b7b1c,0x26663DF4bdB9983466FC83cDF527c973F92428e7
5015,15627864,246501,8192518004,235937,10564,3274,4359,0x9008D19f58AAbD9eD0D60971565AA8510560ab41,0x731a0A8ab2C6FcaD841e82D06668Af7f18e34970
5016,15627864,94795,8187100033,94199,596,138,8,0xdAC17F958D2ee523a2206206994597C13D831ec7,0x5A401f146b2795131116c15721219A270F86E48B
5017,15627864,189420,8113290692,186600,2820,842,167,0x68b3465833fb72A70ecDF485E0e4C7bD8665Fc45,0x6930c41EAe5a621e663FD3e2CFaDade9C1D3521c
5018,15627864,347215,8041405054,164231,182984,23106,183246,0x5E4e65926BA27467555EB562121fac00D24E9dD2,0x6887246668a3b87F54DeB3b94Ba47a6f63F32985
5019,15627864,21000,8000000000,21000,0,2,24,0x6183DAD91372043CFfdFAe523a618549e11840B3,0x369FA2CB711B582527F94d375C5Ae7a7dC3824E5
5020,15627864,26000,7853936099,26000,0,2,12026,0x9695Ee4778Bdeb13B217979d93c4670cBF41CC65,0xDAFEA492D9c6733ae3d56b7Ed1ADB60692c98Bc5
5021,15627865,21000,68000000000,21000,0,2,160699,0x961f4481F39B531EA1D2D6a9348e4586EF504169,0x7aeB3314E041153c4F6bbea19AbECBCe20946fD4
5022,15627865,120000,63000000000,119392,608,138,131,0xdAC17F958D2ee523a2206206994597C13D831ec7,0xED7593E8D4238BF1f8F8C80137DF7c4F15d8077f
5023,15627865,120000,63000000000,119392,608,138,33,0xdAC17F958D2ee523a2206206994597C13D831ec7,0xb1dc8232ae1C05c370986CaB381e77B0B556e368
5024,15627865,170000,11000000000,169392,608,138,508309,0xdAC17F958D2ee523a2206206994597C13D831ec7,0x39F6a6C85d39d5ABAd8A398310c52E7c374F2bA3
5025,15627865,362467,10000000000,362263,204,74,126,0x55f1C36Bb7aE0d7D6caE97902E30A2306686Ec73,0x40fbe1B0071aB7aA08413BA412C86Cd93f8C6367
5026,15627865,51458,9874003102,50970,488,138,455,0x7F9306FC1978938d5C1C57Bf6044dc67E07eeB8a,0xc01542Eb312f7A817EFE7f40C2E94fCf1a519452
5027,15627865,51458,9874003102,50970,488,138,370,0x7F9306FC1978938d5C1C57Bf6044dc67E07eeB8a,0x92f119Ec92B2b671fc13A4CB205d8ec11Bad45f6
5028,15627865,51458,9874003102,50970,488,138,140,0x7F9306FC1978938d5C1C57Bf6044dc67E07eeB8a,0x1F8F63B02C2aC1c8d740C1dfDA7eF38B836198B0
5029,15627865,45038,9874003102,44974,64,10,42,0xC02aaA39b223FE8D0A0e5C4F27eAD9083C756Cc2,0x33fCa83BB619034BDfe729Ed4b25734612c75bBF
5030,15627865,51458,9874003102,50970,488,138,137,0x7F9306FC1978938d5C1C57Bf6044dc67E07eeB8a,0x83b4ECA752452d3bA87a085BA1c4f4a6edA736c1
5031,15627865,51458,9874003102,50970,488,138,141,0x7F9306FC1978938d5C1C57Bf6044dc67E07eeB8a,0xdB2b4bae2c26Ac0d24B36b42220826E57a75FE51
5032,15627865,51458,9874003102,50970,488,138,133,0x7F9306FC1978938d5C1C57Bf6044dc67E07eeB8a,0x23eA9062eb0201Ed82E080D6b037e2D8a40bC0C3
5033,15627865,51458,9874003102,50970,488,138,135,0x7F9306FC1978938d5C1C57Bf6044dc67E07eeB8a,0xCC10bCF3e6FF56F7CedEACaF05734EeD136d24A1
5034,15627865,80000,9874003102,79344,656,138,1862,0x3506424F91fD33084466F402d5D97f05F8e3b4AF,0x351C17F198062d7074586FCF48A23EBd0C3d37D0
5035,15627865,50000,9607000000,49332,668,138,0,0xdAC17F958D2ee523a2206206994597C13D831ec7,0xd35A80935af88125E1F1CC59C87DD00CFa0381E7
5036,15627865,167293,9374003102,164437,2856,842,253,0x68b3465833fb72A70ecDF485E0e4C7bD8665Fc45,0xD631Bc52b1b69Bd79151be24B7d004e0Bc33f8aB
5037,15627865,21000,9374003102,21000,0,2,42,0xEb18f4e090D981f30a949d81b0354C0A4D3c1A43,0xeaCb4fb49a94FdDAc3dCB7dAd5C63C3807A235Ee
5038,15627865,21000,9374003102,21000,0,2,44,0x2c522236579771899F8a933f5c267960F02AdCd9,0xBc84B49932874dFaD5927E7f9F9D6AF0503E4EE6
5039,15627865,99226,9374003102,98630,596,138,528,0xA0b86991c6218b36c1d19D4a2e9Eb0cE3606eB48,0xf220404cdecD90E78a280b2F13f0F9cd3336b1E0
5040,15627865,288812,9374003102,288280,532,202,17,0x25121EDDf746c884ddE4619b573A7B10714E2a36,0x0A2901Fe562B988FA3c1b8c61D5E12CE9A22013A
5041,15627865,51406,9374003102,50918,488,138,212,0xa44D6f0EBA63A4A7AE268Ed30c3569A7b8Cf59BB,0x25dfFa06697c4DE3be8798a6005F9dD5e8CbBce2
5042,15627865,864136,9374003102,810436,53700,17354,152,0xaE9C73fd0Fd237c1c6f66FE009d24ce969e98704,0xC727D9b5Ab6548890A888A3CC68e0b66eE99030A
5043,15627865,174085,9374003102,167485,6600,1802,152,0x00000000006c3852cbEf3e08E8dF289169EdE581,0xbc25Ec02B37c3cc3b71b25Cc6b53AA83db4731c6
5044,15627865,181341,9000000000,179505,1836,458,415,0x7a250d5630B4cF539739dF2C5dAcb4c659F2488D,0x3A73b93c5bd2FF728741b1F62E83477b7367B8EB
5045,15627866,120000,63000000000,119392,608,138,0,0xdAC17F958D2ee523a2206206994597C13D831ec7,0x222A1D4119Eb38716a93a16100Ba19800d881574
5046,15627866,69881,57030325258,68937,944,138,1050,0x011b0beAe3eC5953B4805b064cC78f6F892A99cC,0xA1CC352bC94caDdFddaA4D095762F37B2b9bc57A
5047,15627866,297414,40000000000,285210,12204,3530,163,0x617Dee16B86534a5d792A4d7A62FB491B544111E,0x3C2a7589f22f4cC06938d33aC80784c6aD784A2F
5048,15627866,420000,30000000000,419416,584,138,1226077,0xdAC17F958D2ee523a2206206994597C13D831ec7,0x5041ed759Dd4aFc3a72b8192C143F72f4724081A
5049,15627866,500000,20000000000,498212,1788,458,15,0x7a250d5630B4cF539739dF2C5dAcb4c659F2488D,0xBcb958331862BeD5e3aF56695583F9ec2C6C7ff9
5050,15627866,177472,17030325258,173820,3652,1162,623,0x68b3465833fb72A70ecDF485E0e4C7bD8665Fc45,0x1aC217D61C002cAa32e1D46DadBBf3dC8F07E792
5051,15627866,600000,13030325258,598048,1952,522,5,0x7a250d5630B4cF539739dF2C5dAcb4c659F2488D,0x078cFdf223F7d92B4672ec7299aF4F00bf1Ad318
5052,15627866,600000,13030325258,598036,1964,522,5,0x7a250d5630B4cF539739dF2C5dAcb4c659F2488D,0x801F5b36a7bEB854340bF999CD5CEddB1f75D655
5053,15627866,210720,12346705246,207948,2772,842,1553,0x68b3465833fb72A70ecDF485E0e4C7bD8665Fc45,0x0d9044A9E9e3A9f510342a7B77BadFFcb4B5D2B0
5054,15627866,21000,12288219300,21000,0,2,63,0xC098B2a3Aa256D2140208C3de6543aAEf5cd3A94,0x34d404995990b4176CE02e4Cf23F32f70D2eb28b
5055,15627866,21000,12288219300,21000,0,2,55,0xC098B2a3Aa256D2140208C3de6543aAEf5cd3A94,0xad72542A5CF353dfAC6F8111AC83b6293Ae041DD
5056,15627866,21000,12092208085,21000,0,2,181435,0x2F454945fFBAbF4303B7CC1F13a77f61ca702fE8,0x6238872A0Bd9F0E19073695532a7Ed77ce93C69E
5057,15627866,69972,12030325258,69028,944,138,85,0x2cb055cAa56bfb341422ed9Abd90632c8defaf97,0x4ED112256BCa213441dA597C593637B2feBd0848
5058,15627866,33600,12030325258,33600,0,2,222,0x11a839fc79F822f9b869Bb820A51DD5D25Caf13A,0xB18FE18b6BEa40DB0440a833855bd09570E7A45c
5059,15627866,400000,12030325258,398248,1752,458,792,0x7a250d5630B4cF539739dF2C5dAcb4c659F2488D,0xbe7779Ab38864cF0a60D44264E9389f9e10A9051
5060,15627866,400000,12030325258,398260,1740,458,522,0x7a250d5630B4cF539739dF2C5dAcb4c659F2488D,0x0Df42b5857A28665f6F5e76900Db7A0bd3AaE26a
5061,15627866,400000,12030325258,398248,1752,458,395,0x7a250d5630B4cF539739dF2C5dAcb4c659F2488D,0x73Cea9B76E7127a67AC0BA66b47Ee32eB7d65541
5062,15627866,400000,12030325258,398248,1752,458,318,0x7a250d5630B4cF539739dF2C5dAcb4c659F2488D,0xaC2c6cc66aa0cF5e348dF2759477b42fF5EEcfD5
5063,15627866,46104,12030325258,45616,488,138,196,0x80ADB36595239fe918c7D118C1F81e07d070801a,0x585869bdd43497dF24A8CeC2e1D4E115869Fe2a3
5064,15627866,181476,12030325258,179912,1564,394,319,0x1Fa8559e873f698292766790AeCf8080A66433F6,0x6244a51AF50Dd60C60a74ef59368e16a1169768f
5065,15627866,600000,12030325258,598164,1836,458,1708,0x7a250d5630B4cF539739dF2C5dAcb4c659F2488D,0x0b8207ec94676910CedBa3b5a07eD2BBA3f93c2e
5066,15627866,250000,12000000000,249356,644,138,270670,0x1f9840a85d5aF5bf1D1762F925BDADdC4201F984,0x23f4569002a5A07f0Ecf688142eEB6bcD883eeF8
5067,15627866,222222,12000000000,220658,1564,394,164,0x1Fa8559e873f698292766790AeCf8080A66433F6,0x9885E82B7430ae310308f339484797914b2b4a75
5068,15627866,21000,11500000000,21000,0,2,323,0x2910949849Af9F437f01ae63D85c2533F309A330,0x2daBA6db68F91BC9245000708ec7EcF257d65e66
5069,15627866,21000,11319105000,21000,0,2,100438,0x97eA7aDd3C82aF4ce528AE746ba6523904aE2F44,0x5Ecddc1AC099074ae965D140A7c62bd71B7Fc80a
5070,15627866,300014,11030325258,298486,1528,394,134155,0x98C3d3183C4b8A650614ad179A1a98be0a8d6B8E,0x8e8f818d3371F797A2Db7eDB32803607c8b3c6A9
5071,15627866,300014,11030325258,298462,1552,394,45488,0x98C3d3183C4b8A650614ad179A1a98be0a8d6B8E,0xA6807d794411D9a80bc435dfC4CDa0Ba0DddE979
5072,15627866,300014,11030325258,298450,1564,394,19342,0x98C3d3183C4b8A650614ad179A1a98be0a8d6B8E,0x81FfD37ed3ab472F9bC1d3135D583dC594Bf4795
5073,15627866,34900,11000000000,34244,656,138,13,0x95aD61b0a150d79219dCF64E1E6Cc01f0B64C4cE,0xDb343e339E092DDd76eC4e5Cc424CBd2011e9Bad
5074,15627866,84261,10830325258,83297,964,202,4709920,0xA0b86991c6218b36c1d19D4a2e9Eb0cE3606eB48,0x2FAF487A4414Fe77e2327F0bf4AE2a264a776AD2
5075,15627866,84276,10830325258,83300,976,202,4709921,0xA0b86991c6218b36c1d19D4a2e9Eb0cE3606eB48,0x2FAF487A4414Fe77e2327F0bf4AE2a264a776AD2
5076,15627866,84276,10830325258,83300,976,202,4709922,0xA0b86991c6218b36c1d19D4a2e9Eb0cE3606eB48,0x2FAF487A4414Fe77e2327F0bf4AE2a264a776AD2
5077,15627866,89156,10830325258,88500,656,138,4709923,0xdeFA4e8a7bcBA345F687a2f1456F5Edd9CE97202,0x2FAF487A4414Fe77e2327F0bf4AE2a264a776AD2
5078,15627866,50000,10453826570,50000,0,2,1210288,0xb9B484F5F9D8a67b60E3Baf4be441Bb6a7c2e025,0x912fD21d7a69678227fE6d08C64222Db41477bA0
5079,15627866,21000,10424723318,21000,0,2,13,0x2bE57C141D65bAC2bdc0C666f5287bE1fD7344e4,0x9858bE5C5eE001245218285349551600eaE8C466
5080,15627866,69181,10424723318,68561,620,138,1,0xdAC17F958D2ee523a2206206994597C13D831ec7,0xE677607666665724c56Fa49dF332DBDd1d29dbe1
5081,15627866,21000,10306028518,21000,0,2,46,0xCBD6832Ebc203e49E2B771897067fce3c58575ac,0xC35B5cF074A66b6dC6eF6Ae7Bc33a36e77156F4E
5082,15627866,21000,10280000000,21000,0,2,0,0x6dfc34609a05bC22319fA4Cce1d1E2929548c0D7,0x30e4094f6D678F78bD96102BA27DA1d005D251b9
5083,15627866,21000,10277146020,21000,0,2,4,0xCBD6832Ebc203e49E2B771897067fce3c58575ac,0x51234CF5a85d39c66840fa9D24953E65B3cd007d
5084,15627866,21000,10200000000,21000,0,2,0,0x9e4b98B5D9f08F0142FF9AF417215cebc10Bbe7e,0x51B6BeC009c5B0AcdCa445C12206125ac62367E8
5085,15627866,100000,10100000000,99024,976,202,705877,0xdAC17F958D2ee523a2206206994597C13D831ec7,0x6dfc34609a05bC22319fA4Cce1d1E2929548c0D7
5086,15627866,21000,10060000000,21000,0,2,0,0x6dfc34609a05bC22319fA4Cce1d1E2929548c0D7,0xB8Cca5b6d8b673dE87160a3F7768504baDa0aEe3
5087,15627866,362467,10000000000,362263,204,74,97,0x55f1C36Bb7aE0d7D6caE97902E30A2306686Ec73,0x98Cb7eBaD8F01EE32F751Be05029dAC224378193
5088,15627866,362467,10000000000,362263,204,74,142,0x55f1C36Bb7aE0d7D6caE97902E30A2306686Ec73,0xB38091eFb35B18E54D5f48de782060246Ec90310
5089,15627866,90000,10000000000,89404,596,138,7,0xA0b86991c6218b36c1d19D4a2e9Eb0cE3606eB48,0x7c3Cef9458B0861658168EBfFF80ee202D2d9fc7
5090,15627866,21000,9757887252,21000,0,2,134,0xF28B6F93f801649966493d9f5eE1b5e04C5F8A86,0x2736E1821318d93c86F5159a363f19Ec4f672d75
5091,15627866,1497500,9673766468,1470836,26664,6602,38596,0x902F09715B6303d4173037652FA7377e5b98089E,0xe93685f3bBA03016F02bD1828BaDD6195988D950
5092,15627866,8000000,9649686064,7999936,64,10,15102,0xc9b4948214eF6f727966b79e33A705d010675587,0xb2AA4a5DF3641D42e72D7F07a40292794dfD07a0
5093,15627866,21000,9560000000,21000,0,2,2,0x546367D801a949107A95Cd1D591C741078598fF3,0xa5D6b32Bfd6710F5F1B3006F1500E499E4567F22
5094,15627866,21000,9560000000,21000,0,2,0,0x8BD737e1Ed1eF278e11BDB7933226629310af41F,0x8bf6DA3aeA14CB31a141F76D6Fc143613a900143
5095,15627866,46364,9530325258,45420,944,138,2,0xC02aaA39b223FE8D0A0e5C4F27eAD9083C756Cc2,0xE594F8e4a4518585C4FFC87ADDA973C412E5E895
5096,15627866,150756,9530325258,150692,64,10,2,0x65c2e54a4c75ff6da7b6B32369c1677250075fb2,0x970fd32cDcd023dBb5C02F99311B6C8Ba6C3BCd1
5097,15627866,143796,9530325258,143592,204,74,120,0x7F9306FC1978938d5C1C57Bf6044dc67E07eeB8a,0x53cF6198b88c405870D88D75968B34ce53a6C968
5098,15627866,83131,9530325258,83067,64,10,308,0x9B7FCaEbE9a69eCeeAb72142Ed35A238775D179a,0xBca854485eF39369146545fc9B5966B2f718f611
5099,15627866,21000,9234325258,21000,0,2,32472,0xc2B08191310c2A33b0e495d6C6F881cfAd0733c1,0xaa364c1A348f9517009207A1601E0a73C1Cd530b
5100,15627866,159222,9164861843,158070,1152,266,82962,0xBE9a129909EbCb954bC065536D2bfAfBd170d27A,0xf42Ed7184f3bDd07b0456952F67695683AfD9044
5101,15627866,51458,9030325258,50970,488,138,142,0x7F9306FC1978938d5C1C57Bf6044dc67E07eeB8a,0x502ca494f14bAd99f320a1A9bb68D0761B0cd22F
5102,15627866,51458,9030325258,50970,488,138,144,0x7F9306FC1978938d5C1C57Bf6044dc67E07eeB8a,0x11dDd2eB0bD45c373AA19940964882FA516263Ba
5103,15627866,51458,9030325258,50970,488,138,146,0x7F9306FC1978938d5C1C57Bf6044dc67E07eeB8a,0xabe1aA61c0aDe6A826DE6e55F3869D1502A2e5CB
5104,15627866,51458,9030325258,50970,488,138,138,0x7F9306FC1978938d5C1C57Bf6044dc67E07eeB8a,0xE35325A84D56729b6A2166fFBdF44669F6127640
5105,15627866,51458,9030325258,50970,488,138,129,0x7F9306FC1978938d5C1C57Bf6044dc67E07eeB8a,0xC42724C5253773A626Ab15a4E800FbD50B2fC939
5106,15627866,207128,9030325258,207128,0,2,4708702,0x5b63cf24dd1b7117ebBeD9F45a41650e800f28c1,0x28C6c06298d514Db089934071355E5743bf21d60
5107,15627866,207128,9030325258,206532,596,138,3199175,0xdAC17F958D2ee523a2206206994597C13D831ec7,0x9696f59E4d72E237BE84fFD425DCaD154Bf96976
5108,15627866,207128,9030325258,207128,0,2,1679527,0x3c7F1E7D67f67a50A5D29899A7A5f486A30522b1,0x4976A4A02f38326660D17bf34b431dC6e2eb2327
5109,15627866,207128,9030325258,206520,608,138,3492278,0xdAC17F958D2ee523a2206206994597C13D831ec7,0x56Eddb7aa87536c09CCc2793473599fD21A8b17F
5110,15627866,207128,9030325258,207128,0,2,4468949,0x11f71B7fB4eB8f2605e6ED4768226c898965B48b,0x21a31Ee1afC51d94C2eFcCAa2092aD1028285549
5111,15627866,207128,9030325258,206460,668,138,4232336,0x320623b8E4fF03373931769A31Fc52A4E78B5d70,0xDFd5293D8e347dFe59E90eFd55b2956a1343963d
5112,15627866,83827,9030325258,82715,1112,330,55,0x5427FEFA711Eff984124bFBB1AB6fbf5E3DA1820,0x1265F7550f7cB16f39F499De7A4cBecF60d31d7F
5113,15627866,538275,9030325258,536167,2108,522,779,0xEfF92A263d31888d860bD50809A8D171709b7b1c,0xA5E2A4105397ABc662827f5daA6D0F449B71bA37
5114,15627866,21000,9030325258,21000,0,2,2759941,0x37B828853A799819751934A10D54857470a787e7,0x267be1C1D684F78cb4F6a176C4911b741E4Ffdc0
5115,15627866,285326,9030325258,282530,2796,842,1223,0x68b3465833fb72A70ecDF485E0e4C7bD8665Fc45,0x9cA213288C3cFb4f7be4dD66Bde1E025a4c8c856
5116,15627866,207128,9030325258,207128,0,2,3199176,0x32C8a80dB4801f95Ad8Ca2301D4Ecb7AEC1eCaea,0x9696f59E4d72E237BE84fFD425DCaD154Bf96976
5117,15627866,336276,9030325258,333076,3200,906,451,0x68b3465833fb72A70ecDF485E0e4C7bD8665Fc45,0x263835b05ad8972731083fa2751aCd438e6B768e
5118,15627866,235987,9030325258,233239,2748,842,368,0x68b3465833fb72A70ecDF485E0e4C7bD8665Fc45,0x8BBFA2713284CD8BE7fA321b515ed12bD7C2c008
5119,15627866,207128,9030325258,206520,608,138,4468950,0xdAC17F958D2ee523a2206206994597C13D831ec7,0x21a31Ee1afC51d94C2eFcCAa2092aD1028285549
5120,15627866,56659,9030325258,55715,944,138,70,0xAD13C2a8d418d01F3236F4d8b9d724575a4e9d24,0xD5b5E8a77b87224B1f6712Ba02c34fE163F78c62
5121,15627866,42000,9030325258,42000,0,2,329531,0xD580937a71fEd830c418f54DCD594e8dc757E5eF,0x9430801EBAf509Ad49202aaBC5F5Bc6fd8A3dAf8
5122,15627866,323250,9030325258,313894,9356,2700,12,0x881D40237659C251811CEC9c364ef91dC08D300C,0x3d4159Bc4980D53C99291b924cB7970F6AdC2265
5123,15627866,248727,9030325258,248663,64,10,352,0x84927e55Ed03EA00732F17FdAA89f482AD12c005,0xB82e84aA632c101e924C7b0B8faAad0322822010
5124,15627866,257992,9030325258,252952,5040,1292,2360,0x881D40237659C251811CEC9c364ef91dC08D300C,0x401982cbe24F6eeEab77C463D5BE0FC4c986bE1b
5125,15627866,260059,9030325258,256395,3664,1162,2249,0x68b3465833fb72A70ecDF485E0e4C7bD8665Fc45,0x74eEf19f8712aBbCFe9D79c7D3e4e2d434fbB1F1
5126,15627866,1171944,9030325258,1168352,3592,1162,53,0x68b3465833fb72A70ecDF485E0e4C7bD8665Fc45,0xD0e087889c63604a645c220296C339054Ee5E2c5
5127,15627866,21000,9030325258,21000,0,2,72,0xC6DF6e7113979FCe34bd9F1f5eC0833552a0b6a9,0x4Ba4bED31fE23143C365941b52b8a6aC33A05188
5128,15627866,181476,9030325258,179912,1564,394,588,0x1Fa8559e873f698292766790AeCf8080A66433F6,0xa75be179dc8B36d24F0FdD02aaC8b5740Ec5B615
5129,15627866,283174,9030325258,280426,2748,842,14,0x68b3465833fb72A70ecDF485E0e4C7bD8665Fc45,0xd07Be64F76635de4A649c4D1bD0B2B0255697DE0
5130,15627866,740000,9030325258,728104,11896,2506,68131,0xAC28f6D70c6C6d5089e506eFb80624B8ECb666F8,0x43793ee58E0a3D920e3e4a115A9FA07dc4B09715
5131,15627866,241089,9030325258,235157,5932,1738,45,0x68b3465833fb72A70ecDF485E0e4C7bD8665Fc45,0x2dACB9CD9b7CF4c3F0b21EF2212cB3Ba085a52c3
5132,15627866,21000,9030325258,21000,0,2,72343,0xEfD2A7811a4e1239ff36Cca576ddDadC1D684C45,0xab97925eB84fe0260779F58B7cb08d77dcB1ee2B
5133,15627866,221478,9030325258,218682,2796,842,66,0x68b3465833fb72A70ecDF485E0e4C7bD8665Fc45,0xE170dA9eA20A5D01ae045ad7C77958Efc63f977b
5134,15627866,405274,9030325258,401646,3628,1162,282,0x68b3465833fb72A70ecDF485E0e4C7bD8665Fc45,0x261EF24887B02243Ef9d50b19e2529e6854aaF11
5135,15627866,81616,9030325258,81008,608,138,66,0x2260FAC5E5542a773Aa44fBCfeDf7C193bc2C599,0xc8E063FF9881781156D550b304c79C3A4867CB7d
5136,15627866,234894,9030325258,232134,2760,842,0,0x68b3465833fb72A70ecDF485E0e4C7bD8665Fc45,0x0DE0865de9f33C813D4Cf6E176a42eE549dc73f5
5137,15627866,207128,9030325258,207128,0,2,1312153,0x7EdE7d2de92305601617DfDA66c16e7dcF0fCD8A,0xf60c2Ea62EDBfE808163751DD0d8693DCb30019c
5138,15627866,21000,9030325258,21000,0,2,146,0x98352EC844dE71fBab32defa310FeC036a25013b,0x5Ae50a924a367B0d30746bcd98f4aC5080b78D62
5139,15627866,70000,9030325258,69392,608,138,529,0xdAC17F958D2ee523a2206206994597C13D831ec7,0xf5491f793D47A6Ea22f5e0B9AD3990CF66c4b40B
5140,15627866,21000,9030325258,21000,0,2,88937,0xC58A6D80C98D07f56A598A97d275DA3b65eB9870,0x3018018c44338B9728d02be12d632C6691E020d1
5141,15627866,21000,9030325258,21000,0,2,6578031,0xC549b4ADEfe86a1f4Bda0898B9f9CB33Ee08341d,0xeB2629a2734e272Bcc07BDA959863f316F4bD4Cf
5142,15627866,21000,9030325258,21000,0,2,513,0xD4142730f3e5640C129DB5E206Fd990B53aBFC30,0xA7142Ef4f6F4a93796B2bDA2C3760Ae94FE6fF78
5143,15627866,21000,9030325258,21000,0,2,4,0x5E2103591f4658817ac560b31CF57DDFCCfb83e2,0xEbdCa07AaB34199d8B707E39c05Ddf1FBE0C309D
5144,15627866,21000,8982846000,21000,0,2,9,0xd84E850c86cCC8728aaBA647DE0F76869beB5155,0xb986E80f340798F5Bb06591ae7B5de16DF8ed8Fc
5145,15627866,2000000,8845545559,1997940,2060,522,410,0x7a250d5630B4cF539739dF2C5dAcb4c659F2488D,0xC598DE2944734AF41EeB92dFD24Aac8803aDca0E
5146,15627866,100000,8806811564,99332,668,138,1050386,0xF411903cbC70a74d22900a5DE66A2dda66507255,0xf16E9B0D03470827A95CDfd0Cb8a8A3b46969B91
5147,15627866,21000,8531325258,21000,0,2,113050,0xa987b5CF8b85844B30C47c5fD49E2DbA30C2AfEC,0x6081258689a75d253d87cE902A8de3887239Fe80
5148,15627866,139466,8530325258,138654,812,330,238,0x988d7888A3E2c572A4B4d27b3f57224159dD0227,0xd8fd0ae6076B3D643543B7C7D386d5425bb48284
5149,15627866,179960,8530325258,173348,6612,1802,1319,0x00000000006c3852cbEf3e08E8dF289169EdE581,0x11C4947808DA68a6f893D70d9997cE2ec74aDaF2
5150,15627866,400000,8530325258,399392,608,138,172,0xc3d688B66703497DAA19211EEdff47f25384cdc3,0x94aEc6a2Fd64b63cd501960E920A4D5562d35d40
5151,15627866,21000,8530325258,21000,0,2,9,0x502598F6B65F6fAC34D8f931C3896664b1837d06,0xFE4E1E81081d7A351C3617626476cE571d10764E
5152,15627866,85158,8530325258,84526,632,138,106,0x8207c1FfC5B6804F6024322CcF34F29c3541Ae26,0x0Dd480b9b8209B2a1438DB721c2Ae904Df749818
5153,15627866,250256,8530325258,246592,3664,1162,278,0x68b3465833fb72A70ecDF485E0e4C7bD8665Fc45,0x906eA1f28992B948f6FEbBfD44E6541B13a3d0dF
5154,15627866,55904,8530325258,54960,944,138,221,0x011b0beAe3eC5953B4805b064cC78f6F892A99cC,0xceB7Bc1098138e850195698F4Ff2726031CDe545
5155,15627866,65286,8530325258,64346,940,202,99,0x0c537f8F6780628aFdf866E41A81d2ED97CFC8a2,0x02ca10C62f160CDD126d1E44EF42224CAc745Ac8
5156,15627866,46161,8530325258,45589,572,138,559,0x0BD4D37E0907C9F564aaa0a7528837B81B25c605,0xBc86dA04ab1A0926bAA23e0C1F49F75A31EAeCd1
5157,15627866,278821,8530325258,278617,204,74,468,0x55f1C36Bb7aE0d7D6caE97902E30A2306686Ec73,0x36151eF8bF252eB963235fd76245B98580D595F0
5158,15627866,72912,8530325258,71968,944,138,14,0xA0b86991c6218b36c1d19D4a2e9Eb0cE3606eB48,0x18bD1d8e0bcC62E4E7066871d9116BD47A338DF5
5159,15627866,546064,8530325258,511256,34808,12114,318,0x00000000006c3852cbEf3e08E8dF289169EdE581,0xF7df35E5b15E7597354a888B179407e2Fd5a0326
5160,15627866,96817,8530325258,96541,276,74,98,0xfc4913214444aF5c715cc9F7b52655e788A569ed,0x6103922E0AEb8a574e09aB549191e5997DC12207
5161,15627866,57357,8530325258,55881,1476,458,33,0x6c6aB773F0C3D682660E6526D517f48F347125Ea,0x1484ddB021FA661B830b69c0D3EaD24E43191B41
5162,15627866,301656,8530325258,298504,3152,906,43,0x68b3465833fb72A70ecDF485E0e4C7bD8665Fc45,0xD96F023D7182256e3f20A6a149BF5c2BB204aCf0
5163,15627866,21000,8530325258,21000,0,2,5643,0x98BDd55fd7B988630fF2bFFB059CF20682a5a612,0xb5F31EB9e70f88c5997a243DfB59b7097bcd84bE
5164,15627866,181458,8530325258,179906,1552,394,335,0x1Fa8559e873f698292766790AeCf8080A66433F6,0xC4E0a69ADEb594bF1Eb0221594b94e824E0215A0
5165,15627866,27938,8530325258,27874,64,10,217,0xC02aaA39b223FE8D0A0e5C4F27eAD9083C756Cc2,0xccBeffe27D1b2EA84c530bf267D0B38224394C4b
5166,15627866,46977,8530325258,46489,488,138,182,0x68Df6Bc1df2BdfA09Bb49528718106E547Efe39a,0xBc25CD0f8736060bF8914DB969b38De4C57bFaC6
5167,15627866,72912,8530325258,71968,944,138,15,0xA0b86991c6218b36c1d19D4a2e9Eb0cE3606eB48,0x18bD1d8e0bcC62E4E7066871d9116BD47A338DF5
5168,15627866,120415,8530325258,119767,648,266,78,0x6B7ed5E55e831c67Ba2Ba05773E5F0CbB4BdEA37,0xF2C0272D384393f3DD8F5F9C4691838aBA74C4E8
5169,15627866,36015,8530325258,35751,264,74,108,0xC02aaA39b223FE8D0A0e5C4F27eAD9083C756Cc2,0xFA5F446a75CFcF5D68857d7Fc3B9Cf3AD9efdedB
5170,15627866,146762,8530325258,140174,6588,1802,124,0x00000000006c3852cbEf3e08E8dF289169EdE581,0xB733162a2C281B85274Fa634cD21EC4D86dD583c
5171,15627866,55000,8530325258,55000,0,2,579945,0x2663859Ef9aFB8aEB0bC472663d7c25053660b74,0x74dEc05E5b894b0EfEc69Cdf6316971802A2F9a1
5172,15627866,531065,8530325258,502653,28412,6666,750,0xD152f549545093347A162Dce210e7293f1452150,0x885cb1217070bc7e05661a6B2a906Ce3d9cea705
5173,15627866,149645,8530325258,143045,6600,1802,27,0x00000000006c3852cbEf3e08E8dF289169EdE581,0x19443b60F0047551b16491a65e0A01486a2Cd9a0
5174,15627866,100770,8530325258,97494,3276,1034,262,0x0000000000c2d145a2526bD8C716263bFeBe1A72,0x52EAf342132696563bf4bda8171f586AB2679d5f
5175,15627866,46684,8530325258,46124,560,138,1,0x3E343f43B6429956f84726636C336fbcfa90DA27,0xdd621ed08C2d2c49cd7F0fBD324493f9F0B436e3
5176,15627866,55904,8530325258,54960,944,138,1478,0x011b0beAe3eC5953B4805b064cC78f6F892A99cC,0xa12B0Fa4104569906c018Eb3541e6605ffe8e54b
5177,15627866,133251,8530325258,132311,940,202,157,0xe6A05f25A051a90D5d144C04F783f6999e48e32D,0x2F488546e9Db21444125e5B0914EeadFc05845c4
5178,15627866,21000,8530325258,21000,0,2,9,0xf7F420616e34E8c440808BB15940820072a55231,0x365960A07d50a38abeAd7516572614897145F0ea
5179,15627866,361333,8530325258,358937,2396,714,309,0x000000000000509081d6FCD3ee63e791aD1db763,0x8F1ce698746D93B06152066ED8DBE359245AbA65
5180,15627866,21000,8530325258,21000,0,2,3,0x55b545cf0E9AcEdE2B8b0cb8339eac8476d144CF,0x6eF314FE7C08Cb78D58Df1995dE6CdF2060435F9
5181,15627866,434914,8530325258,433814,1100,330,42,0x08780fb7E580e492c1935bEe4fA5920b94AA95Da,0x64974Bcdb6e3ccA6035804D80550Bc7DFbDc6CfE
5182,15627866,350000,8530325258,347024,2976,650,1108,0xdfb57B6E16DDB97Aeb8847386989f4DCA7202146,0x8D3bea823f22FBfe058577cA01E9a88160E2dd3A
5183,15627866,46267,8530325258,45691,576,74,6,0x283Af0B28c62C092C9727F1Ee09c02CA627EB7F5,0x73005c43c6A82540dabf4115513F5e3A74D5d526
5184,15627866,36027,8530325258,35751,276,74,338,0xC02aaA39b223FE8D0A0e5C4F27eAD9083C756Cc2,0x6e5c2cb2a00FFa3B03B443a9023383d0d076dD6d
5185,15627866,46061,8530325258,45573,488,138,2318,0x3a70B2C9d86Df638EcaC4053607C4c67b9cccE41,0x87CEF391361A4168148333332fBd5D2C621D3252
5186,15627866,46704,8530325258,46216,488,138,241,0x007029dfb0Bc69dF0303E48D3e458eFa3Db6d98f,0x8694918FFA878B8b53c54c11DF41f7BC574Fb2fd
5187,15627866,21000,8530325258,21000,0,2,10,0x7E7D68e06df82Cb949fD0faCDCa3aC841768d67c,0xceB36a0dd5a54Be6221C51d79EF3dac77cfF9eCC
5188,15627866,147062,8530325258,144158,2904,458,397,0x000000000000509081d6FCD3ee63e791aD1db763,0x4C16c40AeBb9c7d3d755AF80b15E843b5A058E00
5189,15627866,167044,8530325258,160456,6588,1802,483,0x00000000006c3852cbEf3e08E8dF289169EdE581,0x263fd42F241E7ab5C2c03D1C01fcb90dc437bA2A
5190,15627866,49175,8530325258,48687,488,138,961,0xD27dcbcC8778a8AB33AAc529Df36a634567Be325,0xB9C1cd3fC666285D3aFFfff4ae4a721E69445DdD
5191,15627866,21000,8530325258,21000,0,2,110,0x89B1Df60159FdB4D87BC6AfC12773cc2a37047Aa,0x08Deb89d3A895f535C8a9f865d93C146Fd7b5dA8
5192,15627866,964152,8530325258,881944,82208,28554,288,0x83C8F28c26bF6aaca652Df1DbBE0e1b56F8baBa2,0x71820Af065e1a8E20Bb75Fdd66Dd89716E69AfD3
5193,15627866,535062,8530325258,531922,3140,906,22,0x68b3465833fb72A70ecDF485E0e4C7bD8665Fc45,0xB715cdB77806d154D4cEf39B7374f98054Bcc298
5194,15627866,112568,8530325258,110520,2048,522,26,0x20362c5B7Ea1beDc84d28deEcd47d6807beBB18a,0x4286262EC04cBE19d85944441a09Ca44C567B27a
5195,15627866,316400,8530325258,309904,6496,1738,2062,0x00000000006c3852cbEf3e08E8dF289169EdE581,0x62B4bCaFe045048916632a35A5DF563790eEBf81
5196,15627866,203347,8530325258,199755,3592,1162,118,0x68b3465833fb72A70ecDF485E0e4C7bD8665Fc45,0xca335Acd543502F97987931D2b3738908375073B
5197,15627866,21000,8530325258,21000,0,2,5,0x6cCB3d618aFC2bB119a071f02Dc0B7D8Ae89cae9,0x01CB0dd9Fa036eB4999b9F277c2ac367C0E74666
5198,15627866,379588,8530325258,378920,668,138,296,0x65f7BA4Ec257AF7c55fd5854E5f6356bBd0fb8EC,0xb1169C6daAc76bAcaf0D8f87641Fc38fbabe569F
5199,15627866,123782,8530325258,122814,968,330,155,0x4e32004D8b81847A670b4a1778ACe4dCF2bBA01E,0x7cc26b600eC01F23209ba6fc80322Af5BD2B7155
5200,15627866,121249,8530325258,120297,952,202,375,0x283f687f87a0052696AaA5Ab7A31694A3a6762C5,0x5Db71204C7D9a9a23359676aE159eD28D2fF4523
5201,15627866,21000,8530325258,21000,0,2,26,0x4D9047E3F22eDbbE39A0DB7A2d29E31e2D312186,0x12550cAec2321d6811178a1CFcD162106154a2EF
5202,15627866,170304,8530325258,141548,28756,9610,1104,0x00000000006c3852cbEf3e08E8dF289169EdE581,0x17e3d8D01624d1a03924228A855D631FBf332b98
5203,15627866,21000,8530325258,21000,0,2,19,0x3703128fC2Dbe818ee4c98AA45EaA87d226134D8,0x1D3d2C5E85485CeAe892b5c16ed09349F29D26e7
5204,15627866,150756,8530325258,150692,64,10,1,0x65c2e54a4c75ff6da7b6B32369c1677250075fb2,0xBA262EbDF9F52E765f54604447aa73FF72E8dFd7
5205,15627866,46114,8530325258,45626,488,138,333,0xE5C7D9A18df4fDc12DB723761A862845612917bA,0xB35D331cDDba23fe7C5724927822A16192578060
5206,15627866,46547,8530325258,46059,488,138,330,0xaE351b8Ae55B69A5007618E598dDe89d0a092c37,0xB21a79AC56ea3314D3141B2019A85cb8a24361B7
5207,15627866,78538,8530325258,77894,644,138,6,0x12b6893cE26Ea6341919FE289212ef77e51688c8,0xAe38aE433Ad2C8276587ef704D5470B824956539
5208,15627866,155931,8530325258,154131,1800,458,339,0x03f7724180AA6b939894B5Ca4314783B0b36b329,0xe9e28b7FA3c972c5Ca4D28e3955386c9217c1eC2
5209,15627866,21000,8530325258,21000,0,2,205,0x61EB61b4356C1766dacC925d78Cb6e1EC7074Fa7,0x9DC24CD822C616986441D1288FEDa80F4A1e4162
5210,15627866,120415,8530325258,119767,648,266,79,0x6B7ed5E55e831c67Ba2Ba05773E5F0CbB4BdEA37,0xF2C0272D384393f3DD8F5F9C4691838aBA74C4E8
5211,15627866,3406248,8530325258,3160048,246200,34494,0,,0x5C0c82e42b7632ce9D92BBC3f0a0A9ab7FA1762c
5212,15627866,210775,8530325258,208403,2372,522,239,0x283Af0B28c62C092C9727F1Ee09c02CA627EB7F5,0x224545C475f8F354D170851CBc4C1E6A32194D59
5213,15627866,21000,8530325258,21000,0,2,319,0xbaE1439Feae8Fa505ca13F6FcEDB7445F5Db1e1F,0xF1A8b59c9466dFc336081C916c449E37A3840a37
5214,15627866,87631,8530325258,86679,952,202,82,0xaE351b8Ae55B69A5007618E598dDe89d0a092c37,0x035bb6b7D76562320dFFb5ec23128ED1541823cf
5215,15627866,129290,8530325258,128706,584,138,3,0x0E1A0c04EBe94cF43478aaBc7E25f82CEddF67aC,0xB9acFcEfa71bD6E51A5f2156Bc0479e2Ef714f6d
5216,15627866,46547,8530325258,46059,488,138,1038,0xaE351b8Ae55B69A5007618E598dDe89d0a092c37,0x560E34132eb3A1Ee9A1AfFf32B04587b84fd02B5
5217,15627866,232927,8530325258,229311,3616,1162,151,0x68b3465833fb72A70ecDF485E0e4C7bD8665Fc45,0x4363A6EE36F9184b7f8CCDd1A737a79d69ff3F8D
5218,15627866,377052,8530325258,373472,3580,1162,3,0x68b3465833fb72A70ecDF485E0e4C7bD8665Fc45,0x960F560D882e89e783F2a5Ece445F8441dD96eC1
5219,15627866,21000,8530325258,21000,0,2,24,0x3DE7DC708259d4cCD0D4861030255f75c172D7F5,0xDD5D450C25681b7894c30091741D4d7fEF320caE
5220,15627866,21000,8222065433,21000,0,2,34,0x974CaA59e49682CdA0AD2bbe82983419A2ECC400,0x2137c705D0b448F4C94CAF801C17b84ef0E4FC8a
5221,15627866,538222,8222065433,536162,2060,522,110,0xEfF92A263d31888d860bD50809A8D171709b7b1c,0x15ABbbF9a511412f2E0546ef16abefbdA2CfA1dB
5222,15627866,21000,8145800000,21000,0,2,52,0x3819f64f282bf135d62168C1e513280dAF905e06,0x7C98A9d061d280481de819D31f49d8A494C7F4c3
5223,15627866,266480,8131325258,264212,2268,650,106625,0xA69babEF1cA67A37Ffaf7a485DfFF3382056e78C,0x9AAb3F81604c683a1a0D14019FBfe15bef7aA1ee
5224,15627866,21000,8061472057,21000,0,2,22,0x974CaA59e49682CdA0AD2bbe82983419A2ECC400,0xc663C43dd3FA56bdb1f09D0457905853364A5852
5225,15627866,105000,8041405054,105000,0,2,138568,0x3aDaDbAde67CfD5e2360b4DA865A256aa8141860,0x974CaA59e49682CdA0AD2bbe82983419A2ECC400
5226,15627866,330678,8041405054,325426,5252,1290,78,0x208522A06e4420092DF8cB05A6823E6C5b81882f,0x52Fb2EB7eAeE2573A9c03aa8d2243ac4B54ED16C
5227,15627866,186865,8041405054,183261,3604,1162,34,0x68b3465833fb72A70ecDF485E0e4C7bD8665Fc45,0xcEA2B5aaE34Dbd6932fD266FdF490b2aC70fd96C
5228,15627866,181476,8030325258,179912,1564,394,987,0x1Fa8559e873f698292766790AeCf8080A66433F6,0x4B25c93cc62e20d32cd73dAe49ea67702308a80e
5229,15627866,270156,8030325258,266348,3808,970,117898,0xa57Bd00134B2850B2a1c55860c9e9ea100fDd6CF,0x26bce6eCb5b10138e4bf14aC0ffcc8727FEF3B2e
5230,15627866,106646,8030325258,105342,1304,330,115,0xA0c68C638235ee32657e8f720a23ceC1bFc77C77,0x88888F31f9aB8e195B7B05d717f4aBaaBaeF33a0
5231,15627866,21000,8030325258,21000,0,2,346923,0x6c7E44ac12158a8B8181fc0BCd68B8AF289d2D90,0x77696bb39917C91A0c3908D577d5e322095425cA
5232,15627866,181476,8030325258,179912,1564,394,165,0x1Fa8559e873f698292766790AeCf8080A66433F6,0x29924bf5f61dE001C2D657981f06C29939DD099a
5233,15627866,181476,8030325258,179912,1564,394,3364,0x1Fa8559e873f698292766790AeCf8080A66433F6,0x1E6c02d4f25DFF92b8355ABBaC1b9522e0a7E8E9
5234,15627866,1105669,8030325258,1103093,2576,714,67,0x221e1B033E10063Ae3Fba737Ce40ef682fbfcCcC,0xEfa7bDD92B5e9CD9dE9b54AC0e3dc60623F1C989
5235,15627866,181476,8030325258,179912,1564,394,439,0x1Fa8559e873f698292766790AeCf8080A66433F6,0x10157e8F70A8a971Fa16aED7982A58FfC8E9bF2c
5236,15627866,175110,8030325258,173546,1564,394,178,0x1Fa8559e873f698292766790AeCf8080A66433F6,0x8b9A729e03b10506C6d774B6eE8c3f47d3a6Cc6C
5237,15627866,55978,8030325258,55034,944,138,490,0x32F19B8c25333bF68FaCe58041858f185c17CF74,0x7862958ee0797a7ABD33A65030fC608a656febB7
5238,15627866,21000,8030325258,21000,0,2,1783206,0x6fD72C7A8D1E521B17F321ec6bfC4F83FF58c1e2,0x503828976D22510aad0201ac7EC88293211D23Da
5239,15627866,181476,8030325258,179912,1564,394,202,0x1Fa8559e873f698292766790AeCf8080A66433F6,0x224617bB5a040a41Eb3a26A0890AC132898b09A9
5240,15627866,21000,8030325258,21000,0,2,8265753,0xDAfc095D560c544d5D37DD4006C87d22fc4F7339,0xb5d85CBf7cB3EE0D56b3bB207D5Fc4B82f43F511
5241,15627866,21000,9030325258,21000,0,2,8265754,0x83d5799862A57855d7b6186c11500120Ca5E2BA9,0xb5d85CBf7cB3EE0D56b3bB207D5Fc4B82f43F511
5242,15627866,21000,8030325258,21000,0,2,469165,0xeb6a0F6CCC904B9A150EC6f7AA8ceC7fd3cE3e07,0xb739D0895772DBB71A89A3754A160269068f0D45
5243,15627866,21000,9030325258,21000,0,2,469166,0x2A24f2568B90370A3ED68aa9B689046CC8335d96,0xb739D0895772DBB71A89A3754A160269068f0D45
5244,15627866,21000,8030325258,21000,0,2,7,0x3C857f9A37261212976665a534D0aa23Ab74E8f3,0x019C75e7335B443d2d0fE04Cc29CEBE6b86093F6
5245,15627866,59056,8030325258,58092,964,394,2355,0x645E9324f4be25be581BB62163cfa86c40b01D07,0xc5009AFEd2D6DA219538aD165998F63B553185B1
5246,15627866,21000,8030325258,21000,0,2,7100801,0xFe30Cc59020fE8519F0B2bd3C75777EB5495d864,0xddfAbCdc4D8FfC6d5beaf154f18B778f892A0740
5247,15627866,175092,8030325258,173540,1552,394,16,0x1Fa8559e873f698292766790AeCf8080A66433F6,0x6322f7909063507a4839655bDFD340285970E0B4
5248,15627866,60739,8000000000,53271,7468,2506,149,0x00000000006c3852cbEf3e08E8dF289169EdE581,0x8C7cCE1F0ed5cF36D24cB8aBa73749a0e0eCb995
5249,15627866,277752,8000000000,274944,2808,842,5,0x68b3465833fb72A70ecDF485E0e4C7bD8665Fc45,0xF33Ca2186b5575F3889FcB4409112EcEDb31eDD7
5250,15627866,208634,7967670033,207446,1188,338,25,0x1111111254fb6c44bAC0beD2854e76F90643097d,0x764aB2911607F6E14497cEC5434687CAaD5E0cAE
5251,15627866,55316,7685200885,54720,596,138,0,0xdAC17F958D2ee523a2206206994597C13D831ec7,0xD72C32D8b3207FD5f672e3f9f49FD6012c1f62D0
5252,15627866,300000,7410982649,299416,584,138,150324,0xdAC17F958D2ee523a2206206994597C13D831ec7,0x1C727a55eA3c11B0ab7D3a361Fe0F3C47cE6de5d
5253,15627866,80000,7410982649,79056,944,138,0,0x7D1AfA7B718fb893dB30A3aBc0Cfc608AaCfeBB0,0xEbBF3Ba0d297e8E08e75eDC8097FEAffC49a0167
5254,15627866,80000,7410982649,79056,944,138,0,0xA0b86991c6218b36c1d19D4a2e9Eb0cE3606eB48,0x3f450ade8483566326b5E379263392c450c9ac5A
5255,15627866,538261,7410982649,536165,2096,522,62,0xEfF92A263d31888d860bD50809A8D171709b7b1c,0x8Ca38A2Ee63BAF18691dFF6A114507Eb81876e5D
5256,15627866,397265,7405263168,378809,18456,5906,13407,0x1111111254fb6c44bAC0beD2854e76F90643097d,0xaa3Cf4A9Bb743f5cB307Fe2c2C8196280bE48CED
5257,15627866,150756,7363489192,150692,64,10,27,0x65c2e54a4c75ff6da7b6B32369c1677250075fb2,0xf407df3F3AaB955aC80DE958dA780105ae2C4D93
5258,15627866,237241,7363489192,235649,1592,402,11,0x1111111254fb6c44bAC0beD2854e76F90643097d,0x30Efd24069Fbef4d19d183e5227Ba9af2413Ea71
5259,15627866,99226,7363489192,98630,596,138,46,0xA0b86991c6218b36c1d19D4a2e9Eb0cE3606eB48,0xA912d194D7760f0F10b9b9784E18Bde67a4beb44
5260,15627866,288883,7223513694,285203,3680,906,0,0x197492CCB4B1acaAAcd43432657A17832E36AB49,0xD7668081eB9cEd76e2248bD64e47256D28d47075
5261,15627866,90000,7217794213,90000,0,2,154371,0x9F28614a0ac721B4479D0270C51798707BC13Dba,0xCBD6832Ebc203e49E2B771897067fce3c58575ac
5262,15627866,54134,7217794213,53562,572,138,252,0x5FaFCd75E814a3912ba5832Cbfed3c914Ee16754,0x2a487Ef02b6Fd2A57225d296392102E635478205
5263,15627867,5049304,17000000000,5042216,7088,1098,287,0x0a39DA505DfB5E0BBc6bd84428281A8ba1bC7753,0x495E889d1A6cEB447a57dcc1C68410299392380c
5264,15627867,90000,14435588426,90000,0,2,157093,0x824B815cd409E58B48F8DA56F3E013F1e31c84FF,0xeB6c4bE4b92a52e969F4bF405025D997703D5383
5265,15627867,21000,14000000000,21000,0,2,1,0x500A746c9a44f68Fe6AA86a92e7B3AF4F322Ae66,0x757fb63cCfaaaF25f8A8e405Eb6A905237f5Ec8b
5266,15627867,100000,13370255592,99392,608,138,33036,0xdAC17F958D2ee523a2206206994597C13D831ec7,0xBd9B34cCbb8db0FDECb532B1EAF5D46f5b673fE8
5267,15627867,350000,12092208086,350000,0,2,6925051,0x72EcC582A550A546B0C37c74B64420a5F7B1dcf4,0x46340b20830761efd32832A74d7169B29FEB9758
5268,15627867,350000,12062107581,350000,0,2,6925052,0x706FF7657E27d8513F4508AB3ad96C6f293eBf49,0x46340b20830761efd32832A74d7169B29FEB9758
5269,15627867,360797,10741681097,330565,30232,5386,127,0xA0c68C638235ee32657e8f720a23ceC1bFc77C77,0x7Ca5e8e735d1714104A534c9F39E2a29ab116139
5270,15627867,106000,10615684199,106000,0,2,1051,0xCac0F1A06D3f02397Cfb6D7077321d73b504916e,0xA1CC352bC94caDdFddaA4D095762F37B2b9bc57A
5271,15627867,53915,10615684199,53427,488,138,633,0x6de7aC835EC6841Af9b94fd1273dB83B8d69e3f7,0x05b044E0Dbe11ab9AF8e3c74aC1b201e6AD68Dea
5272,15627867,139281,10115684199,138841,440,138,496,0x4Ae2Cd1F5B8806a973953B76f9Ce6d5FAB9cdcfd,0xbCa96f4D7129512D195Ebc65D537FC2324835822
5273,15627867,21000,10080000000,21000,0,2,0,0x6dfc34609a05bC22319fA4Cce1d1E2929548c0D7,0x666eC0ad1770783309bC86a3e2CB31DDD4Cd4aE4
5274,15627867,90000,10000000000,90000,0,2,449976,0xbd5c72a675d3ee37980B0b821aCc600e5BcaEf9e,0x077D360f11D220E4d5D831430c81C26c9be7C4A4
5275,15627867,60000,9953154129,57068,2932,586,1,0x52dE8D3fEbd3a06d3c627f59D56e6892B80DCf12,0x5209Bef8B7771952a0092139f67Dcd97e960DD44
5276,15627867,94795,9665684199,94199,596,138,5,0xdAC17F958D2ee523a2206206994597C13D831ec7,0xDcd7C8814a952AEeB977Cd7DDD84BEa087EB0897
5277,15627867,241340,9615684199,237236,4104,1034,1,0xe66B31678d6C16E9ebf358268a790B763C133750,0x177775A4fe61Ae8d91DdCD92E3AC06B19EcB8847
5278,15627867,21000,9615684199,21000,0,2,8804466,0x7C047c955ff110204BAFbBB092bacA543BFc8b2C,0x3cD751E6b0078Be393132286c442345e5DC49699
5279,15627867,1000000,9615684199,998164,1836,458,225,0x7a250d5630B4cF539739dF2C5dAcb4c659F2488D,0x560259a1a735299086661820D6A9da50d82C8E1A
5280,15627867,21000,9615684199,21000,0,2,6578032,0x634859fc9a6D9A8923F0f67f577868726382cBb3,0xeB2629a2734e272Bcc07BDA959863f316F4bD4Cf
5281,15627867,21000,9615684199,21000,0,2,6578033,0xcfceEA55b74924b8D3A04D562B4e11a3892C2a6c,0xeB2629a2734e272Bcc07BDA959863f316F4bD4Cf
5282,15627867,305799,9615684199,303939,1860,458,3928,0x25553828F22bDD19a20e4F12F052903Cb474a335,0x3A56b3b3f778aaA38beBd26d584A900BAbCCadB4
5283,15627867,21000,9615684199,21000,0,2,346924,0xaC7354DD6827cF569C79707a87D660C8Bf89943B,0x77696bb39917C91A0c3908D577d5e322095425cA
5284,15627867,23300,9615684199,23300,0,2,11,0xA9D1e08C7793af67e9d92fe308d5697FB81d3E43,0xf19E2011cA4BD89251CdF5AA8BD7E6b1C562b077
5285,15627867,23300,9615684199,23300,0,2,0,0xA9D1e08C7793af67e9d92fe308d5697FB81d3E43,0xDe5b12891eab03aA07517840F6BcC9fC7a40fEA5
5286,15627867,21000,9615684199,21000,0,2,3,0xddfAbCdc4D8FfC6d5beaf154f18B778f892A0740,0xA28B5EA7E8AAe6F5F9b35aaDaA9bb2cC9e9C3ed5
5287,15627867,23300,9615684199,23300,0,2,0,0xA9D1e08C7793af67e9d92fe308d5697FB81d3E43,0x194ffaa36BA31413a25D9Bcd19610cc6c9CFae87
5288,15627867,21000,9615684199,21000,0,2,13,0xddfAbCdc4D8FfC6d5beaf154f18B778f892A0740,0x08d128F29dB0D6350c10596A46b90A9221faA37A
5289,15627867,21000,9615684199,21000,0,2,8,0xddfAbCdc4D8FfC6d5beaf154f18B778f892A0740,0x9bAfa5A5799C46071253316AAcEB449f6B64Bb35
5290,15627867,21000,9615684199,21000,0,2,14,0xddfAbCdc4D8FfC6d5beaf154f18B778f892A0740,0x9f9cF32E966Ae6B1742759f450AE52653e73Cfe0
5291,15627867,21000,9615684199,21000,0,2,446240,0xddfAbCdc4D8FfC6d5beaf154f18B778f892A0740,0xA090e606E30bD747d4E6245a1517EbE430F0057e
5292,15627867,23300,9615684199,23300,0,2,13,0xA9D1e08C7793af67e9d92fe308d5697FB81d3E43,0x11F4f2F7433cf7f33204988a205eD5D564fa9FE2
5293,15627867,23300,9615684199,23300,0,2,2,0xA9D1e08C7793af67e9d92fe308d5697FB81d3E43,0xd8096612065AA2710eb695d44A226C91d4e5245b
5294,15627867,23300,9615684199,23300,0,2,0,0xA9D1e08C7793af67e9d92fe308d5697FB81d3E43,0x8cB20525bf15147ac50c9329CfDD7b5757aA1Df5
5295,15627867,23300,9615684199,23300,0,2,1,0xA9D1e08C7793af67e9d92fe308d5697FB81d3E43,0x90Bd6e7341Ef3fb67e62777d7eB69490E25e6e4a
5296,15627867,77938,9615684199,77270,668,138,5,0x419c4dB4B9e25d6Db2AD9691ccb832C8D9fDA05E,0x8BD737e1Ed1eF278e11BDB7933226629310af41F
5297,15627867,21000,9615684199,21000,0,2,7,0xddfAbCdc4D8FfC6d5beaf154f18B778f892A0740,0x56c07F7d8d6809E552511b52EEcDFA2A407a4907
5298,15627867,21000,9615684199,21000,0,2,20,0xddfAbCdc4D8FfC6d5beaf154f18B778f892A0740,0x4aC822e45c581B2f089C50E89911aBE7a260CF83
5299,15627867,23300,9615684199,23300,0,2,14928,0xA9D1e08C7793af67e9d92fe308d5697FB81d3E43,0x02d24cAB4f2c3Bf6e6EB07ea07e45F96baccFfE7
5300,15627867,326578,9615684199,324954,1624,394,2,0x7a250d5630B4cF539739dF2C5dAcb4c659F2488D,0xCCA6815482a886227eA5f751445505fbA516215a
5301,15627867,21000,9615684199,21000,0,2,5723,0xddfAbCdc4D8FfC6d5beaf154f18B778f892A0740,0x4675C7e5BaAFBFFbca748158bEcBA61ef3b0a263
5302,15627867,21000,9615684199,21000,0,2,4,0xddfAbCdc4D8FfC6d5beaf154f18B778f892A0740,0x171D4086875c1762F19c8b7984E784df02cb9EEb
5303,15627867,36027,9615684199,35751,276,74,46,0xC02aaA39b223FE8D0A0e5C4F27eAD9083C756Cc2,0x78644036dd87DEF9fe66a95f58fB9D33f172454d
5304,15627867,42000,9615684199,42000,0,2,329532,0xB120bAbF905590d85bE106A8A19D8682aE225c98,0x9430801EBAf509Ad49202aaBC5F5Bc6fd8A3dAf8
5305,15627867,77971,9615684199,77303,668,138,0,0x4a220E6096B25EADb88358cb44068A3248254675,0xCb46b412Dd77d3714A21E1cba7De307b168DD161
5306,15627867,386956,9615684199,381284,5672,1866,505,0x68b3465833fb72A70ecDF485E0e4C7bD8665Fc45,0x91CA602f60d8A7B2fC5610A5f0330078e10eda63
5307,15627867,21000,9560000000,21000,0,2,4,0x51969eC8FD738f311415bd57ceffCECb5751C292,0xB18f99C422Af09aDD0411524AfABFC97AF0bbeF7
5308,15627867,21000,9116684199,21000,0,2,57302,0x1b213D9d7FF0B1Fe5f6C41144D27ABEAc6A54359,0xCfC0F98f30742B6d880f90155d4EbB885e55aB33
5309,15627867,120000,9116684199,119380,620,138,96278,0xdAC17F958D2ee523a2206206994597C13D831ec7,0x14c4017f81675F7aC1321218d4a385a2D3117328
5310,15627867,61604,9116684199,60948,656,138,102639,0xD533a949740bb3306d119CC777fa900bA034cd52,0x2Db1D8CdF1Abe8C70b531a790CDf2FF38aecF652
5311,15627867,21000,9115684199,21000,0,2,352,0xa9D1e48516255f395f5BFc2008f51a45Be09A461,0x3Db4Ff50e300Fb4a4AFBbf511ebc680e69378c3A
5312,15627867,36027,9115684199,35751,276,74,339,0xC02aaA39b223FE8D0A0e5C4F27eAD9083C756Cc2,0x6e5c2cb2a00FFa3B03B443a9023383d0d076dD6d
5313,15627867,21000,9115684199,21000,0,2,1,0x7E563C08a0338Ec68AE414E44c11f13aC26EE89c,0x259289e33575eb34f0D8EfCD1ED7E3a7a12d1738
5314,15627867,178281,9115684199,167297,10984,3466,431,0x74312363e45DCaBA76c59ec49a7Aa8A65a67EeD3,0x012C6934d9e8e1422A48Af53948754b58F373169
5315,15627867,78538,9115684199,77894,644,138,8,0x12b6893cE26Ea6341919FE289212ef77e51688c8,0x11198068ff34a9E8ed4ABF8AE6Dc09Ce4F4DE841
5316,15627867,152869,9115684199,146293,6576,1802,11,0x00000000006c3852cbEf3e08E8dF289169EdE581,0x2993002a2E36Cd09d9708B39c00682Be1dDc31F8
5317,15627867,153223,9115684199,147295,5928,1610,17,0x00000000006c3852cbEf3e08E8dF289169EdE581,0xC225A2cd6F65bE5Ae16c749FBC8175a93aEd22eC
5318,15627867,248642,9115684199,245454,3188,906,166,0x68b3465833fb72A70ecDF485E0e4C7bD8665Fc45,0xa4e5ee3142C8F17797018A729A2007f00a89A27D
5319,15627867,21000,9115684199,21000,0,2,237,0x407b5D55A95c63462d9fdC233e4924A189482637,0x790878D7167cff1c27cb5Fd59d708359be57bFf6
5320,15627867,46103,9115684199,45615,488,138,8170,0x346378C67d0F71343F80299ed8C0407aC2Df05eB,0x7768FBc67afecF2b4Caee9D1841ad14637D13652
5321,15627867,46126,9115684199,45638,488,138,219,0x249aeAa7fA06a63Ea5389b72217476db881294df,0xAfB3116Ce35Db24b4163e0Bb3dA0252240434F56
5322,15627867,500000,9115684199,499784,216,74,802,0xD94C7060808f3c876824E57e685702f3834D2e13,0x45C7811C459a43d0C17EF18F33A2C8921aC4ECf8
5323,15627867,146684,9115684199,140108,6576,1802,380,0x00000000006c3852cbEf3e08E8dF289169EdE581,0x9F96c987f70aa929118e6B333e36a06742785806
5324,15627867,245284,9115684199,241716,3568,1162,393,0x68b3465833fb72A70ecDF485E0e4C7bD8665Fc45,0x4E04223f5dcbf61EdB9D2AA0aa6B4D3C9663a794
5325,15627867,1341608,9115684199,1339584,2024,522,370,0x42106AFb1b7C9F30D37eeB650cE34A26e94234A6,0x907206D1Fb31AeB9E36Fdc98CE09F5B088bE56bF
5326,15627867,100284,9115684199,99332,952,202,214,0x60E4d786628Fea6478F785A6d7e704777c86a7c6,0xa723BCC05F4E0F739D572E7FdFf0b23AF977A8f7
5327,15627867,264691,9115684199,261423,3268,970,26,0x68b3465833fb72A70ecDF485E0e4C7bD8665Fc45,0xDe265BC3cbbE62c8078F9512e906D509446350a0
5328,15627867,51492,9115684199,51004,488,138,5,0x406C60C2e8038a0E90D2f28efF7260CC7Af84EE6,0x0E638C186C9cF41cfaBbc7E8024E0D1987b2011f
5329,15627867,1784554,9115684199,1673990,110564,36042,284,0x83C8F28c26bF6aaca652Df1DbBE0e1b56F8baBa2,0x0e8d6fa80544566470b80cE24FD6B17801229009
5330,15627867,69529,9115684199,68921,608,138,191,0xdAC17F958D2ee523a2206206994597C13D831ec7,0x89934feF37a18d88051012dA526430280Dc4724D
5331,15627867,46140,9115684199,45508,632,138,3,0x04F2694C8fcee23e8Fd0dfEA1d4f5Bb8c352111F,0xAab1Ba4198054D5078aE1c955E2224a6B61103dB
5332,15627867,274579,9115684199,271275,3304,970,167,0x68b3465833fb72A70ecDF485E0e4C7bD8665Fc45,0xF6E701D372846921Fc623fDfE5B14720C2E33acd
5333,15627867,8000000,8661353055,7999936,64,10,15103,0xd84f95a5e6cEE0261cE8AbC4311e980ED82Ee0e0,0xb2AA4a5DF3641D42e72D7F07a40292794dfD07a0
5334,15627867,276946,8615684199,274642,2304,650,131296,0xA69babEF1cA67A37Ffaf7a485DfFF3382056e78C,0x60b86AF869f23aEb552fB7F3CaBD11B829f6Ab2F
5335,15627867,264503,8615684199,233163,31340,5514,116,0xA0c68C638235ee32657e8f720a23ceC1bFc77C77,0x88888F31f9aB8e195B7B05d717f4aBaaBaeF33a0
5336,15627867,3998134,8615684199,3998070,64,10,18,0x11261558B626A440D7A84a0EB92CbF4767b259D8,0x76b36A038cd2086406120b2807258cD7b857308F
5337,15627867,260000,8216764112,259204,796,202,1361,0x995efdaa47530E55deaC72D757A1b344a854393d,0x0af139ac4fcC161cDDa615F7a9Eb28Da38B7668B
5338,15627867,21000,8144197544,21000,0,2,92741,0x72899F655f7c71F6e664CAa9A346a2cd83847f7C,0xF1300cc9c2Cf347f7902742fEC4dF9dbA952fD7b
5339,15627867,21000,8144197544,21000,0,2,92742,0xeC0b1311ef6ECF5baa07133FC0c542d90B380807,0xF1300cc9c2Cf347f7902742fEC4dF9dbA952fD7b
5340,15627867,21000,8041405054,21000,0,2,326,0x4d846dA8257BB0Ebd164EFf513DfF0F0c2C3c0ba,0xdf0C37C3D8D74E652925f00ab25B023F504df101
5341,15627867,46913,8034596478,46317,596,138,0,0x17C8F5aE96487967CE72E78a2A52E0711A87772E,0x1EcDEdD382c068E771f9556109a1518B5609A2c8
5342,15627867,21000,8000000000,21000,0,2,8,0x16D6746d7158432B1206227f3425D7936EDA95d2,0xEe2439BF2434bB3849B3c86357CD493BaECdd39d
5343,15627868,94831,17000000000,94211,620,138,2188232,0xdAC17F958D2ee523a2206206994597C13D831ec7,0x75e89d5979E4f6Fba9F97c104c2F0AFB3F1dcB88
5344,15627868,77356,17000000000,76748,608,138,2188233,0x467719aD09025FcC6cF6F8311755809d45a5E5f3,0x75e89d5979E4f6Fba9F97c104c2F0AFB3F1dcB88
5345,15627868,77356,17000000000,76736,620,138,2188234,0x467719aD09025FcC6cF6F8311755809d45a5E5f3,0x75e89d5979E4f6Fba9F97c104c2F0AFB3F1dcB88
5346,15627868,714789,12345752746,712801,1988,522,569,0x7a250d5630B4cF539739dF2C5dAcb4c659F2488D,0x121Ef52DEf328Ec4f82410acEd31f8e8F1BfA4C9
5347,15627868,21000,12000000000,21000,0,2,91864,0x2087B0C07306A8dAB1BCae7D8608c52eE72A6F6a,0x4E80744fa23cEC76e1621ce0DfACeB4B1D532e12
5348,15627868,222222,12000000000,220658,1564,394,166,0x1Fa8559e873f698292766790AeCf8080A66433F6,0xe5cb3D14F5c34eB371a3A4f01c77955031e368dE
5349,15627868,6051695,9845752746,5724371,327324,45188,0,,0x32bc4c243Fd95d286Ef477B7bD7463DED7f836F6
5350,15627868,59441,9845752746,59377,64,10,3573,0x4545484255248A57396e081FA1d5836395446170,0xCE222910bA7524cADc75DDC7c57Ec5b97E8bFfc9
5351,15627868,38274,10000000000,37606,668,138,2,0x95aD61b0a150d79219dCF64E1E6Cc01f0B64C4cE,0x21dF234BFD8e3408fB7367F0B547E891B172BDA2
5352,15627868,59691,9673766468,57619,2072,522,23,0xE9663ae7D85d8F1Ecee35E54538e846626A63B89,0xCEDd7D764d971a15Be57A42DBD66844D18fe375B
5353,15627868,279954,9345752747,277698,2256,650,93262,0xA69babEF1cA67A37Ffaf7a485DfFF3382056e78C,0xFF82BF5238637B7E5E345888BaB9cd99F5Ebe331
5354,15627868,39928,9345752746,39260,668,138,236,0x321C2fE4446C7c963dc41Dd58879AF648838f98D,0xBBdF63e9F762ae90acF96f01c11106b812973001
5355,15627868,46109,9345752746,45501,608,138,1,0xdAC17F958D2ee523a2206206994597C13D831ec7,0x6bd3b825948c164a9141Da8e5ad7f7194E1F0407
5356,15627868,46097,9345752746,45501,596,138,11,0xdAC17F958D2ee523a2206206994597C13D831ec7,0x24197b03bA6c18399BE52F996BAc29D3E0CA2Ab4
5357,15627868,46097,9345752746,45501,596,138,0,0xdAC17F958D2ee523a2206206994597C13D831ec7,0xC0EfC6032cF09fef7A7C12be21D1914936Ec395F
5358,15627868,46109,9345752746,45501,608,138,0,0xdAC17F958D2ee523a2206206994597C13D831ec7,0xf998341E6321806E569f1C00A416aeECb02eB5b6
5359,15627868,21000,9345752746,21000,0,2,6578034,0x2C7E4565F255e02DEd4fBc37d19182F17d6789f4,0xeB2629a2734e272Bcc07BDA959863f316F4bD4Cf
5360,15627868,46109,9345752746,45501,608,138,2,0xdAC17F958D2ee523a2206206994597C13D831ec7,0xFC7A3AC399B94492A923f27Bd2A60c6F44dc990B
5361,15627868,46097,9345752746,45501,596,138,0,0xdAC17F958D2ee523a2206206994597C13D831ec7,0xFebFcC94750a523034562F67229EaACd5445a4a9
5362,15627868,2000000,9345752746,1994392,5608,1354,171044,0xA9D1e08C7793af67e9d92fe308d5697FB81d3E43,0x7830c87C02e56AFf27FA8Ab1241711331FA86F43
5363,15627868,2000000,9345752746,1992124,7876,1738,171045,0xA9D1e08C7793af67e9d92fe308d5697FB81d3E43,0x7830c87C02e56AFf27FA8Ab1241711331FA86F43
5364,15627868,49516,9345752746,48860,656,138,0,0x4Fabb145d64652a948d72533023f6E7A623C7C53,0x12D4AA45E6D01FbaDd95aAe09c6D8333eBA413B4
5365,15627868,21000,9345752746,21000,0,2,52378,0x5466594f146c2A516D2892dEaef3e38c24Db3a86,0x7c195D981AbFdC3DDecd2ca0Fed0958430488e34
5366,15627868,34589,9345752746,33945,644,138,0,0x0391D2021f89DC339F60Fff84546EA23E337750f,0x701c56BD889815C4c6694619C815a37Ad171bA44
5367,15627868,34806,9345752746,34150,656,138,0,0xE41d2489571d322189246DaFA5ebDe1F4699F498,0x22737C4807c50c1dc16aAc5280BC18a326f94969
5368,15627868,39904,9345752746,39260,644,138,63,0x321C2fE4446C7c963dc41Dd58879AF648838f98D,0x39c2823148240e2B59d9eFC30be1BB385a91DDB1
5369,15627868,34737,9345752746,34069,668,138,0,0xa47c8bf37f92aBed4A126BDA807A7b7498661acD,0x13fe58500923e957d51DF55beeba8956f42171bA
5370,15627868,34845,9345752746,34213,632,138,4,0x4a220E6096B25EADb88358cb44068A3248254675,0x6FBFa4B4B346A2A92b7471b7f77037a00Cb34394
5371,15627868,186765,9345752746,183969,2796,842,3,0x68b3465833fb72A70ecDF485E0e4C7bD8665Fc45,0xCB0f663cDCA60B0A28Cfd6f6bB784A5a2ae49202
5372,15627868,246133,9345752746,240237,5896,1738,650,0x68b3465833fb72A70ecDF485E0e4C7bD8665Fc45,0xE3Bf3e1e0516d21d62800f05aB4fF95c730AbfA7
5373,15627868,21000,9345752746,21000,0,2,13795,0xC68D9D1D3F20037A5dc2418F020211D99FCf0623,0xdAb1a1854214684acE522439684a145E62505233
5374,15627868,62953,9345752746,59309,3644,1098,57,0x36C75D6f4B411787965769D4c24f838c035364B6,0x7d43Fe4a7F0DFCec5C2D2902561F4903b99651a8
5375,15627868,181476,9345752746,179912,1564,394,4,0x1Fa8559e873f698292766790AeCf8080A66433F6,0xc82D5f91c2E63Caa3B9744ee8a97dda15d15E356
5376,15627868,30732,9345752746,30668,64,10,301,0xC02aaA39b223FE8D0A0e5C4F27eAD9083C756Cc2,0xd5481575130a7DeCF4503c81a50152B3753031F9
5377,15627868,500000,9345752746,498224,1776,458,166339,0xa24787320ede4CC19D800bf87B41Ab9539c4dA9D,0xc6bed363b30DF7F35b601a5547fE56cd31Ec63DA
5378,15627868,692269,9225752746,680449,11820,3914,294,0xDEF171Fe48CF0115B1d80b88dc8eAB59176FEe57,0x17D065070486Ca0fC8b4B382b946BE79Fb4fF10D
5379,15627868,21000,9436390309,21000,0,2,158,0xd18d5f59CDb492Ebd21260E5f742377fDF155BDF,0x146f0eF9C1a9C44Dc40a7de2eA900aB3E8c8b0FF
5380,15627868,46097,9200000000,45501,596,138,81,0xdAC17F958D2ee523a2206206994597C13D831ec7,0xB557c812f6f952d85C2E8CfD99b3A0A2Aa727eE6
5381,15627868,201752,8845752746,200064,1688,330,59,0xdC6a731c8f5A58b38bB8Bd34a12e0AEd2A29Fda2,0xdc2b2b206E52966D79EA40B6e34f35bce11644b4
5382,15627868,73188,8845752746,72580,608,138,181,0xA0b86991c6218b36c1d19D4a2e9Eb0cE3606eB48,0xC2606254E1c3bD456B19650c9488F031823a8c77
5383,15627868,173275,8845752746,172639,636,266,139,0x812Dc49fFdEF65D60A3dd479418e0175E4E7709c,0x811420E3da1659a6699f353bD5659010B45fbB9c
5384,15627868,46193,8845752746,45621,572,138,28,0xF7b8aabC98D169020b9EE716FC55541cF3e8B55B,0x5E1a6D27f59Cd8e3853a49f0787E3421c5A992Ce
5385,15627868,21000,8845752746,21000,0,2,145,0x45A97fbA55191Fb65870E4d02914A7578c17925d,0x2f8e0f91Df5A26783633910bA9Ed4B3b7b7883E3
5386,15627868,21000,8845752746,21000,0,2,26,0x982ea4ff0170536f34996539a79024735DDF9643,0xa906d5E13DE34007d7Fa95e09F0511692A939a5E
5387,15627868,321294,8845752746,316454,4840,1546,400,0x68b3465833fb72A70ecDF485E0e4C7bD8665Fc45,0xD7bCBf8B462e5CE6C0Dfb72d55957E8dD4A99A93
5388,15627868,106053,8845752746,102189,3864,1034,41,0xe8C18687E9879094847bD45B3c7373f1241ea86d,0xF949160DD4C6e1e3b36C04ad6748F35bE714a5d8
5389,15627868,96672,8845752746,96268,404,138,51,0x2b591e99afE9f32eAA6214f7B7629768c40Eeb39,0xf1c7A19406B5B91Bf7EcA5287Df8F186de7d8Ae4
5390,15627868,186659,8845752746,180071,6588,1802,231,0x00000000006c3852cbEf3e08E8dF289169EdE581,0xe2eFE1dc92E4228030b8A033DDb8cD25a4d94292
5391,15627868,48573,8845752746,47953,620,138,0,0xdAC17F958D2ee523a2206206994597C13D831ec7,0x211C46F06000901d427ce51ABecB463A2c026e14
5392,15627868,21000,8845752746,21000,0,2,85,0x8318777F8b8A1e81243Abb5e58B3483D2138F257,0x966ca8f23BAB6a8A2aF6f3e806c2A6e47440bc57
5393,15627868,61495,8845752746,53271,8224,2506,12204,0x00000000006c3852cbEf3e08E8dF289169EdE581,0xF98Ef509679b367270B5256f65D780295E446a16
5394,15627868,179819,8845752746,169287,10532,3402,331,0x00000000006c3852cbEf3e08E8dF289169EdE581,0xB21a79AC56ea3314D3141B2019A85cb8a24361B7
5395,15627868,21000,8845752746,21000,0,2,7,0x46b46931423e711D051e264020ACad89c0e147Bd,0x80eD3D73D530f570709c88E43E30F37b8d02045F
5396,15627868,27938,8845752746,27874,64,10,598,0xC02aaA39b223FE8D0A0e5C4F27eAD9083C756Cc2,0x11C03b0E147af0e527A7f8BdFEc94987Fc5C579D
5397,15627868,148995,8845752746,146311,2684,714,3303,0x3db76cc3673FeF9b454562DF53188Ac3147826f8,0x5ACaf7C064F609c1ac40648F200d1160cB3b054f
5398,15627868,21000,8840000000,21000,0,2,5,0xE36067a4c51ff6Cb7Fb6F97D1931bb27a468960B,0xc3FE7b8d4aBd70B9882Fa1b600e8F336af219dA4
5399,15627868,46109,8345752746,45501,608,138,16525,0xdAC17F958D2ee523a2206206994597C13D831ec7,0x4B23d52eFf7C67F5992C2aB6D3f69b13a6a33561
5400,15627868,46097,8345752746,45501,596,138,0,0xdAC17F958D2ee523a2206206994597C13D831ec7,0x4D71C9aa3A81294ec0a4151a16b97e04146Fb5BD
5401,15627868,46109,8345752746,45501,608,138,0,0xdAC17F958D2ee523a2206206994597C13D831ec7,0xdE05916084BA88F1EF419F391B36609B1648Be14
5402,15627868,46121,8345752746,45501,620,138,0,0xdAC17F958D2ee523a2206206994597C13D831ec7,0x65eBE6e591f5ACe20D59686FFaF40D937FA9240F
5403,15627868,34807,8345752746,34127,680,138,7467,0x95aD61b0a150d79219dCF64E1E6Cc01f0B64C4cE,0xBD9Fdfe98324C75ce3f46639aCFa5E735b1163E4
5404,15627868,34754,8345752746,34074,680,138,2,0x6B175474E89094C44Da98b954EedeAC495271d0F,0x7C70707328acba9Bac824c86f648C3e1bC367992
5405,15627868,34521,8345752746,33853,668,138,0,0x4d224452801ACEd8B2F0aebE155379bb5D594381,0x54EB542A149c3c8f6A66ABaB2c9532a4910B4B39
5406,15627868,34807,8345752746,34127,680,138,0,0x95aD61b0a150d79219dCF64E1E6Cc01f0B64C4cE,0x0925cb64Dba09874e23d7913Dd033A8599445428
5407,15627868,48792,8345752746,48184,608,138,61,0xA0b86991c6218b36c1d19D4a2e9Eb0cE3606eB48,0x0007AE86ec165A00E2F33385a6D8F23f16EBC13b
5408,15627868,175092,8345752746,173540,1552,394,10,0x1Fa8559e873f698292766790AeCf8080A66433F6,0xfFC42c19966D0f2999a01960D66C22aED6bC9673
5409,15627868,48792,8345752746,48184,608,138,0,0xA0b86991c6218b36c1d19D4a2e9Eb0cE3606eB48,0x1Cf9CCAb6dD187919517F34a19591A802e54017E
5410,15627868,48792,8345752746,48184,608,138,0,0xA0b86991c6218b36c1d19D4a2e9Eb0cE3606eB48,0xf77f8e6dceE2B45642D757462aECAE95C18b1516
5411,15627868,48792,8345752746,48184,608,138,6,0xA0b86991c6218b36c1d19D4a2e9Eb0cE3606eB48,0xdf3a217F92FE696E59991f100fDbf621CC8121f7
5412,15627868,48792,8345752746,48184,608,138,4,0xA0b86991c6218b36c1d19D4a2e9Eb0cE3606eB48,0x1e7709152a4a2FfE7FEBc5395CB6190DC522541f
5413,15627868,48792,8345752746,48184,608,138,6,0xA0b86991c6218b36c1d19D4a2e9Eb0cE3606eB48,0x3ac08BDD2AB1B61B8fA8F71FfcB2778def3EBe33
5414,15627868,191077,8061472057,190177,900,266,86,0xd588b586D61C826A0e87919b3D1a239206d58bf2,0x710E29C9c3bD8904Eb3d993b05E1bE418Bc715aa
5415,15627868,155748,8000000000,155544,204,74,2,0x7F9306FC1978938d5C1C57Bf6044dc67E07eeB8a,0x85058F47fD08fA896D2030De4404e711C1256F85
5416,15627868,186529,7684334651,185201,1328,402,17,0x11111112542D85B3EF69AE05771c2dCCff4fAa26,0x10282a0E8302C529A772FFC6B37D91Db4A6Da871
5417,15627868,417124,7684334651,413496,3628,1162,107,0x68b3465833fb72A70ecDF485E0e4C7bD8665Fc45,0x957e185cC1a2451E84109D5AAB815ffEdE9F5903
5418,15627868,2000000,7939573634,1997928,2072,522,323,0x7a250d5630B4cF539739dF2C5dAcb4c659F2488D,0x158318657de819928C935ae3436Ae2a796bcd681
5419,15627869,300000,83000000000,299344,656,138,2219,0x320623b8E4fF03373931769A31Fc52A4E78B5d70,0x0a2cbEC00f420aF69D8216de28Bb450E002752AC
5420,15627869,500000,50000000000,497964,2036,522,16,0x7a250d5630B4cF539739dF2C5dAcb4c659F2488D,0xBcb958331862BeD5e3aF56695583F9ec2C6C7ff9
5421,15627869,21000,45000000000,21000,0,2,32,0x069Acf904f610Cbf8ef1540349092852e46b4E95,0x5668F9a2E966E7A0d539dBd97be2DafBF53Cc6Ac
5422,15627869,200000,29920000000,199392,608,138,1205080,0xdAC17F958D2ee523a2206206994597C13D831ec7,0xFfec0067F5a79CFf07527f63D83dD5462cCf8BA4
5423,15627869,5049560,17000000000,5042424,7136,1098,288,0x0a39DA505DfB5E0BBc6bd84428281A8ba1bC7753,0x495E889d1A6cEB447a57dcc1C68410299392380c
5424,15627869,21000,14000000000,21000,0,2,2,0x500A746c9a44f68Fe6AA86a92e7B3AF4F322Ae66,0x3e4d1dfA6e55e021ff2c2E039478d2308fB0591c
5425,15627869,50000,12074242278,50000,0,2,7342,0x69a9FD6279F5074661a4575B2d99961ABeF0D38D,0xde279a5cD86860Cd3D039AA1B74bc29E74cABB12
5426,15627869,50000,12074242278,50000,0,2,7343,0x69a9FD6279F5074661a4575B2d99961ABeF0D38D,0xde279a5cD86860Cd3D039AA1B74bc29E74cABB12
5427,15627869,50000,12074242278,50000,0,2,7344,0x69a9FD6279F5074661a4575B2d99961ABeF0D38D,0xde279a5cD86860Cd3D039AA1B74bc29E74cABB12
5428,15627869,50000,12074242278,50000,0,2,7345,0x69a9FD6279F5074661a4575B2d99961ABeF0D38D,0xde279a5cD86860Cd3D039AA1B74bc29E74cABB12
5429,15627869,400000,12074242278,398248,1752,458,793,0x7a250d5630B4cF539739dF2C5dAcb4c659F2488D,0xbe7779Ab38864cF0a60D44264E9389f9e10A9051
5430,15627869,400000,12074242278,398260,1740,458,523,0x7a250d5630B4cF539739dF2C5dAcb4c659F2488D,0x0Df42b5857A28665f6F5e76900Db7A0bd3AaE26a
5431,15627869,400000,12074242278,398248,1752,458,396,0x7a250d5630B4cF539739dF2C5dAcb4c659F2488D,0x73Cea9B76E7127a67AC0BA66b47Ee32eB7d65541
5432,15627869,400000,12074242278,398248,1752,458,319,0x7a250d5630B4cF539739dF2C5dAcb4c659F2488D,0xaC2c6cc66aa0cF5e348dF2759477b42fF5EEcfD5
5433,15627869,52006,12000000000,51302,704,138,4050,0x761D38e5ddf6ccf6Cf7c55759d5210750B5D60F3,0xD9408f29026E32852AFf8C5C9C8Ea834b44b4e1C
5434,15627869,48780,11074242278,48184,596,138,1,0xA0b86991c6218b36c1d19D4a2e9Eb0cE3606eB48,0x3ff5Add193e54c0192F0C6088E7a574036E64Ae9
5435,15627869,34497,11074242278,33853,644,138,0,0x4d224452801ACEd8B2F0aebE155379bb5D594381,0x4cfdB2D6427c303861e58e61d44454aE9a7B722C
5436,15627869,34806,11074242278,34150,656,138,0,0xE41d2489571d322189246DaFA5ebDe1F4699F498,0x3200951bC16a7b8fbcCA205807206c4Fb21d3e30
5437,15627869,48792,11074242278,48184,608,138,5,0xA0b86991c6218b36c1d19D4a2e9Eb0cE3606eB48,0x32b8A02Cb631b24b72fc48D9390D9741b895D9d8
5438,15627869,48792,11074242278,48184,608,138,71,0xA0b86991c6218b36c1d19D4a2e9Eb0cE3606eB48,0xA9fAf2C0d7894f7632332F207a3EdEEb00fD0Ff4
5439,15627869,48792,11074242278,48184,608,138,0,0xA0b86991c6218b36c1d19D4a2e9Eb0cE3606eB48,0x1B935AbAA4f59DBc9dAC18B476B7b44E762A7E1D
5440,15627869,39904,11074242278,39260,644,138,0,0x321C2fE4446C7c963dc41Dd58879AF648838f98D,0xAa37f3FDBdd320dd065FEE9ac7cdB99C07367CEa
5441,15627869,34739,11074242278,34107,632,138,176,0x3C4B6E6e1eA3D4863700D7F76b36B7f3D3f13E3d,0x738af2eD74E0D8b93A6f59Fa22018f097209ca44
5442,15627869,48780,11074242278,48184,596,138,15,0xA0b86991c6218b36c1d19D4a2e9Eb0cE3606eB48,0x793D3461aFe173476a7d79D14b1a1ADA602A4F02
5443,15627869,48792,11074242278,48184,608,138,0,0xA0b86991c6218b36c1d19D4a2e9Eb0cE3606eB48,0x70DF31484A89529efD5C9CE39f3b8A0f17e22Aa5
5444,15627869,37449,11074242278,36829,620,138,311336,0xA0b73E1Ff0B80914AB6fe0444E65848C4C34450b,0xb7f830845E9F385372AE6fB160Aa968908F5BFBC
5445,15627869,191041,11000000000,190165,876,266,1392,0xd588b586D61C826A0e87919b3D1a239206d58bf2,0xC22d03e13B888Dabb33A1575e4F6542f0e996622
5446,15627869,21000,10224276711,21000,0,2,49,0xCBD6832Ebc203e49E2B771897067fce3c58575ac,0x634624E269E2C2BD412577884805fE23aC39AAD4
5447,15627869,90000,10000000000,89392,608,138,2,0xA0b86991c6218b36c1d19D4a2e9Eb0cE3606eB48,0x3CfF1F2e36480EFdAFb56989D3d1C8F837ddC874
5448,15627869,237501,10000000000,223253,14248,3274,17397,0x43D037A562099A4C2c95b1E2120cc43054450629,0x385954F07f4612a6299B5385d275907CBEE7fA1F
5449,15627869,21000,10000000000,21000,0,2,0,0x96c764Dbe7dCb64B48E2d003Ef96c7d4bf3A088a,0x91AEbE554181980920aB73436D9AC748959e3f07
5450,15627869,159405,9574242278,158833,572,138,15,0x9f7605743c0cE20B6ac749C6783af6CCC1200c6D,0x2bE66B8F7e9b087a0210F955c2d9Ce580d8Efa7F
5451,15627869,46603,9574242278,45659,944,138,226,0xD309A8d0498Cc73f53481e46094DC0d3aaB0d9dd,0x560259a1a735299086661820D6A9da50d82C8E1A
5452,15627869,21000,9436390309,21000,0,2,1,0x9DD259C7edBCB814833C595D510A1eCCe680bC6E,0x4a54625894FfEc7Ae8C2aaedA0C2a2c32de56B49
5453,15627869,21500,9370647162,21500,0,2,11516,0xe3D85B71dB8bFf2d26300C343031887154129279,0xb0BaA65689611c9D04Bb5ED2732d8b9970583360
5454,15627869,8000000,9370647162,7996448,3552,1034,15104,0x303C390799c9cD997EBe08b8d42C8a2Da1a2890f,0xb2AA4a5DF3641D42e72D7F07a40292794dfD07a0
5455,15627869,60000,9370647162,59444,556,202,34114,0x41c69c8ffb4049fc393ed68Ec0Ce66c37f8CF7a0,0xe8463A6d371581d3E40315daD7dbAB85f1492da8
5456,15627869,85000,9274242278,84332,668,138,614727,0x016ee7373248a80BDe1fD6bAA001311d233b3CFa,0x3C02290922a3618A4646E3BbCa65853eA45FE7C6
5457,15627869,106256,9120000000,105304,952,202,0,0xefaDc46BB78B01195a1E12C82A584Caf5403585C,0xA4788a906CB428e371E28443AAc5bEfC314e5B71
5458,15627869,42016,9120000000,41348,668,138,21,0x514910771AF9Ca656af840dff83E8264EcF986CA,0xC4BB029B9F616AFB4A346Dd78205bAa2d368b9bd
5459,15627869,46109,9074242278,45501,608,138,0,0xdAC17F958D2ee523a2206206994597C13D831ec7,0x918960ED7D81689D52B355239269070bc0040D54
5460,15627869,207128,9074242278,207128,0,2,4708703,0xEbEdB72D69A11a38F932bF6Fdd5E2F3097CD559D,0x28C6c06298d514Db089934071355E5743bf21d60
5461,15627869,207128,9074242278,207128,0,2,4232337,0x96BE105Dc71C3E907911DCaBa9acE448F2E36314,0xDFd5293D8e347dFe59E90eFd55b2956a1343963d
5462,15627869,207128,9074242278,206484,644,138,4468951,0x514910771AF9Ca656af840dff83E8264EcF986CA,0x21a31Ee1afC51d94C2eFcCAa2092aD1028285549
5463,15627869,250000,9074242278,249404,596,138,0,0x881D4032abe4188e2237eFCD27aB435E81FC6bb1,0xA2D94301EB9819b85e4c272485C2eE96Cff4b15d
5464,15627869,250000,9074242278,249048,952,202,0,0x881D4032abe4188e2237eFCD27aB435E81FC6bb1,0x271E412683Af079db4146E340AD6b8b7259310a7
5465,15627869,250000,9074242278,249416,584,138,0,0x881D4032abe4188e2237eFCD27aB435E81FC6bb1,0x2328A4EF885B92f0649844Bacc320de7C25943d6
5466,15627869,250000,9074242278,249404,596,138,0,0x881D4032abe4188e2237eFCD27aB435E81FC6bb1,0x29D0657Ae845ac1315688a5326E314a7443976E5
5467,15627869,250000,9074242278,249416,584,138,0,0x881D4032abe4188e2237eFCD27aB435E81FC6bb1,0x3316d3Bee4898D6807A446a644e601e3fB9D1717
5468,15627869,250000,9074242278,249048,952,202,0,0x881D4032abe4188e2237eFCD27aB435E81FC6bb1,0x8B350539175c4f90e462542bA61A79518CDfD92c
5469,15627869,207128,9074242278,207128,0,2,1679528,0xB6B0794E9987788B58cB981D2c81f81BE617972d,0x4976A4A02f38326660D17bf34b431dC6e2eb2327
5470,15627869,207128,9074242278,207128,0,2,4468952,0xeDf8ccF2f842920A0C52F648167C6ecdF72edFAF,0x21a31Ee1afC51d94C2eFcCAa2092aD1028285549
5471,15627869,42000,9074242278,42000,0,2,329533,0xAE0ce594af221EC60a77eF682d5AfF40b7117C93,0x9430801EBAf509Ad49202aaBC5F5Bc6fd8A3dAf8
5472,15627869,207128,9074242278,206520,608,138,4468953,0xA0b86991c6218b36c1d19D4a2e9Eb0cE3606eB48,0x21a31Ee1afC51d94C2eFcCAa2092aD1028285549
5473,15627869,383871,9074242278,379555,4316,1098,1,0xe66B31678d6C16E9ebf358268a790B763C133750,0x5d8136d87AFfeDd8Fb5deAaB49E01100fC437643
5474,15627869,483000,9074242278,479712,3288,842,1020,0x1B72d900eE50CA200097003100001F30aE00495b,0xAFD3d6Adda8630D22Bd87816d23B57E2eabAC17c
5475,15627869,161814,9074242278,159966,1848,458,17,0xd9e1cE17f2641f24aE83637ab66a2cca9C378B9F,0x1E6e1927C5D5E669da806d1279C23D55eC1A955D
5476,15627869,39865,9074242278,39801,64,10,3574,0x37861cCdDB1e36a9Dc732eb12ea570438173f0b6,0xCE222910bA7524cADc75DDC7c57Ec5b97E8bFfc9
5477,15627869,181476,9074242278,179912,1564,394,2097,0x1Fa8559e873f698292766790AeCf8080A66433F6,0x744b3be67b43756fEEFFC24ccd9dD56987Ea22EC
5478,15627869,21000,9074242278,21000,0,2,14,0x7545a74eb835556E43528c4aC7e2150387128c3d,0x3b24fF3b6068F7B415629C371F098385c0346A21
5479,15627869,146238,9074242278,143466,2772,842,167,0x68b3465833fb72A70ecDF485E0e4C7bD8665Fc45,0xCBd4608Eef38d3f0F018910224be08f3666A6052
5480,15627869,21000,9074242278,21000,0,2,6,0x8B9E822704b92F0D1f6895B14Aacb4B20388d14E,0xdB1f451AB8A8D3CC8119932b0B59d5766db554D6
5481,15627869,156221,8943392827,154257,1964,522,147,0x53e0e51b5Ed9202110D7Ecd637A4581db8b9879F,0x9594c0e587257e3fC75F7cCFde6B01D159853754
5482,15627869,21000,8724242278,21000,0,2,84,0x3588d9d60C1AD05DD05aB94A78BAC0393ddF8c90,0x15895049360569d5197D719391DEE7cb4bE2C1C7
5483,15627869,42001,8575242278,41345,656,138,11321,0x514910771AF9Ca656af840dff83E8264EcF986CA,0x9a66BE55e24654cBa203E9b170b48bB302449289
5484,15627869,21000,8575242278,21000,0,2,102640,0x8B93fBd873a00B2F80EDAeff104Add1813aE2627,0x2Db1D8CdF1Abe8C70b531a790CDf2FF38aecF652
5485,15627869,46135,8574242278,45647,488,138,140,0x1Fa8559e873f698292766790AeCf8080A66433F6,0xe7212b0A006B52b1b0Bf3f8e7BAe55c2Cd678e35
5486,15627869,145403,8574242278,145199,204,74,3,0xB092Ec81F41c619EEa434357477ea8A4b1455755,0xC3b367eae57E0754865ca8A803078834c1936754
5487,15627869,46613,8574242278,46125,488,138,61,0x00000000001ba87a34F0d3224286643B36646D81,0xBeEa584B3F032D0cA801202832E731d6F53C1A79
5488,15627869,287257,8574242278,284945,2312,522,228,0x283Af0B28c62C092C9727F1Ee09c02CA627EB7F5,0x57679F905F9618d50a638cc1fe272003A831cec1
5489,15627869,163297,8574242278,154549,8748,2762,170,0x00000000006c3852cbEf3e08E8dF289169EdE581,0x7e8913Db1348dC032c98d8c052C4772EEe58e026
5490,15627869,72866,8574242278,71006,1860,458,105,0xFbdDaDD80fe7bda00B901FbAf73803F2238Ae655,0x17c852867106C351516D4ccC2bd5810D49B224B2
5491,15627869,108950,8574242278,108746,204,74,13,0x32E542dDc355e12bd52fa48ba986b662acA177B4,0x5baE1F5d5Ba8eF8466370F6cf083560aAa139C23
5492,15627869,166745,8574242278,160145,6600,1802,136,0x00000000006c3852cbEf3e08E8dF289169EdE581,0x6aCb75E3bcAf3FEA600c7EB13Ce3278C47A342c8
5493,15627869,21000,8574242278,21000,0,2,40,0x778cB85B6D8a48817C25E6714d3e0E03517e5C3b,0x8c797E42327A27Ef3EfA75C8EaC72DB2344d2D2e
5494,15627869,53484,8574242278,53292,192,74,80,0x3cC0cf7447c7185e711Fd8fe8E230739456846A5,0x845e4c043a868Ab4145c158C6F92336f193832AE
5495,15627869,21000,8574242278,21000,0,2,486,0x6a614e1089611c6577F690EbbE934786b84A097D,0x4961324ADa486E1Be592B6f73046458e2BBDF82a
5496,15627869,167968,8574242278,165292,2676,842,226,0x68b3465833fb72A70ecDF485E0e4C7bD8665Fc45,0x3EB4BD4e17f51b09Bfa3E842b90d5293404376b6
5497,15627869,108384,8574242278,107208,1176,266,30157,0x765277EebeCA2e31912C9946eAe1021199B39C61,0x65A8F07Bd9A8598E1b5B6C0a88F4779DBC077675
5498,15627869,1228749,8574242278,1228405,344,138,2130,0xF403C135812408BFbE8713b5A23a04b3D48AAE31,0x10c16c7B8b1DDCFE65990ec822DE4379dd8a86dE
5499,15627869,185394,8574242278,178626,6768,1802,2,0x00000000006c3852cbEf3e08E8dF289169EdE581,0x01fC01eF79926f9802e6ffBaBdaFf8cdaED6C68E
5500,15627869,46193,8574242278,45621,572,138,29,0xF7b8aabC98D169020b9EE716FC55541cF3e8B55B,0x5E1a6D27f59Cd8e3853a49f0787E3421c5A992Ce
5501,15627869,72866,8574242278,71006,1860,458,161,0xFbdDaDD80fe7bda00B901FbAf73803F2238Ae655,0xB78F8440a21a3128439BE04ac257703EE549a41E
5502,15627869,174526,8574242278,172466,2060,522,27,0xd9e1cE17f2641f24aE83637ab66a2cca9C378B9F,0x4286262EC04cBE19d85944441a09Ca44C567B27a
5503,15627869,1000000,8574242278,999404,596,138,4121136,0x467719aD09025FcC6cF6F8311755809d45a5E5f3,0x0D0707963952f2fBA59dD06f2b425ace40b492Fe
5504,15627869,47172,8574242278,46232,940,202,24,0xCFE50e49ec3E5eb24cc5bBcE524166424563dD4E,0x99cdb33Df8726F1952af7f60a02e70436241d499
5505,15627869,21000,8574242278,21000,0,2,9,0x57E349CbEdcfBA90BE4928130BA12fBb2F388083,0x9216E0883C16bBf935A1715D18e2FbFaE696d4E3
5506,15627869,740000,8574242278,729184,10816,2506,16704,0xb2aD164c008Da54FCEaC79Ef18C0a8fE2d935865,0xE3cd128883f2954D78923487B67Ea7C4F25C7C46
5507,15627869,21000,8574242278,21000,0,2,24,0x33D5c4135624B42e2F70051074319142a947Ea9d,0xEbdB527d3CE736c389167AB8B82a62651C7E9e95
5508,15627869,21000,8574242278,21000,0,2,4,0x998236fcf8A811f83e479F267b8FDa636ed0d8bd,0x5aBFF9d99c04AAc50059aAEA2ef8CB4A9896F951
5509,15627869,51571,8574242278,50951,620,138,409,0x467719aD09025FcC6cF6F8311755809d45a5E5f3,0x9360cb09D73a7908F6692165868374DE5d955886
5510,15627869,99244,8574242278,98636,608,138,343,0xA0b86991c6218b36c1d19D4a2e9Eb0cE3606eB48,0x7121e8Ddf854e024dc1C2c75bFdC64D1050196bB
5511,15627869,21000,8574242278,21000,0,2,17,0x74D11dFe31630357f4e2892c64a99572d39367aC,0x7C400b04851C467a5dda76ce4abC54F309e14F29
5512,15627869,363400,8574242278,357712,5688,1802,27313,0xC36442b4a4522E871399CD717aBDD847Ab11FE88,0x6dD91BdaB368282dc4Ea4f4beFc831b78a7C38C0
5513,15627869,21000,8574242278,21000,0,2,1,0x5A47cfd12BC3583Cd59280026e71E5a5506d2348,0x1D64503f690549EF1c8366B537ffD9dB146CA144
5514,15627869,21000,8574242278,21000,0,2,16,0xE49403558aE1Cd6C82791A82dE88b4dccc7e3d5e,0xf48E977751858e37912Ff443c6F4F3cd5057A3A6
5515,15627869,21000,8199316266,21000,0,2,1,0x52A258ED593C793251a89bfd36caE158EE9fC4F8,0xca2FB709258572227A237a557C689dB10A1190cf
5516,15627869,46097,8074242278,45501,596,138,0,0xdAC17F958D2ee523a2206206994597C13D831ec7,0xe0a4Bb128eD0c2D5f07d5589A0F157435f5f892b
5517,15627869,46097,8074242278,45501,596,138,0,0xdAC17F958D2ee523a2206206994597C13D831ec7,0xcF66aE3Ef0899bc0ed516147F1e6F1A8BE1c073b
5518,15627869,46109,8074242278,45501,608,138,7,0xdAC17F958D2ee523a2206206994597C13D831ec7,0x15821Eb7Ce4654DD2fCB47AF30Eb7D15D0196735
5519,15627869,46109,8074242278,45501,608,138,19,0xdAC17F958D2ee523a2206206994597C13D831ec7,0x70C3c168F477dEA08232F9e81CEF898C1dF06B82
5520,15627869,46097,8074242278,45501,596,138,0,0xdAC17F958D2ee523a2206206994597C13D831ec7,0xCae36Ce7b369376DbFA77CFa5FEd3086688f417c
5521,15627869,46097,8074242278,45501,596,138,18567,0xdAC17F958D2ee523a2206206994597C13D831ec7,0x90E18a6920985DBACc3d76Cf27a3F2131923C720
5522,15627869,46097,8074242278,45501,596,138,14657,0xdAC17F958D2ee523a2206206994597C13D831ec7,0xBc8Ec259E3026aE0D87bc442D034d6882ce4a35C
5523,15627869,181476,8074242278,179912,1564,394,65,0x1Fa8559e873f698292766790AeCf8080A66433F6,0xcd8D0c3668b46cBd61F5Dcedaab0e52E01561A3c
5524,15627869,46097,8074242278,45501,596,138,12876,0xdAC17F958D2ee523a2206206994597C13D831ec7,0x6c8dd0e9cC58c07429e065178d88444B60e60b80
5525,15627869,181476,8074242278,179912,1564,394,3,0x1Fa8559e873f698292766790AeCf8080A66433F6,0x5Cd13D57598f1314e2f06A1208149E9E5aAa698f
5526,15627869,40009,8074242278,39365,644,138,0,0xC18360217D8F7Ab5e7c516566761Ea12Ce7F9D72,0xE5ADF7D03C42FB7e536994949ef6884121Dea985
5527,15627869,289890,8074242278,286662,3228,1034,25,0x68b3465833fb72A70ecDF485E0e4C7bD8665Fc45,0xf426346B8d7E8a3f64352443A3F6329c358f2D8F
5528,15627869,382976,8074242278,378160,4816,1546,108,0x68b3465833fb72A70ecDF485E0e4C7bD8665Fc45,0x8ffc399De3A87CbA90f0645826Bd16f0cb0585Fe
5529,15627869,102263,8074242278,100935,1328,330,117,0xA0c68C638235ee32657e8f720a23ceC1bFc77C77,0x88888F31f9aB8e195B7B05d717f4aBaaBaeF33a0
5530,15627869,47516,8074242278,46492,1024,202,263781,0x3506424F91fD33084466F402d5D97f05F8e3b4AF,0x7Bd8EFab672250de65ba4bA3BC6C3aA08120A1c3
5531,15627869,181476,8074242278,179912,1564,394,482,0x1Fa8559e873f698292766790AeCf8080A66433F6,0x0ebbAC9817029d4b302734b15B97bE1A02EB9B60
5532,15627869,69579,8074242278,68635,944,138,766,0x153f2044Feace1eB377C6e1CF644d12677Bd86fd,0xB4cEF3CA34db5A5ea3116dcd924d318bCbD7Ad17
5533,15627869,49175,8074242278,48687,488,138,291,0xD27dcbcC8778a8AB33AAc529Df36a634567Be325,0x9A85650B98e01E2F49866219c8B20daFb2020529
5534,15627869,49175,8074242278,48687,488,138,238,0xD27dcbcC8778a8AB33AAc529Df36a634567Be325,0x64760416E3B9f2be92942EE312Fd0934f4a261B7
5535,15627869,49175,8074242278,48687,488,138,227,0xD27dcbcC8778a8AB33AAc529Df36a634567Be325,0x12abAD6c64dFe1F545AEF578186014D62Da14E08
5536,15627869,49175,8074242278,48687,488,138,217,0xD27dcbcC8778a8AB33AAc529Df36a634567Be325,0xbd459B18dE787264aD8A4e8559003b9cB4c82558
5537,15627869,49175,8074242278,48687,488,138,158,0xD27dcbcC8778a8AB33AAc529Df36a634567Be325,0xF3eef106DE3B170B6b6efE67E2dCef710922191E
5538,15627869,49175,8074242278,48687,488,138,142,0xD27dcbcC8778a8AB33AAc529Df36a634567Be325,0xF08Ead4E6E41446Ee802C73D5df501bD44fdd995
5539,15627869,49175,8074242278,48687,488,138,1859,0xD27dcbcC8778a8AB33AAc529Df36a634567Be325,0x2c1c2a1Da1566266a49507c867dC5D62A6a536da
5540,15627869,49175,8074242278,48687,488,138,390,0xD27dcbcC8778a8AB33AAc529Df36a634567Be325,0x3654d399Ecd217C7F4329ede78E459C0D37E29e9
5541,15627869,49175,8074242278,48687,488,138,347,0xD27dcbcC8778a8AB33AAc529Df36a634567Be325,0xd35dc720A877bd46dA40f7cdf512E2845A310c2B
5542,15627869,49175,8074242278,48687,488,138,171,0xD27dcbcC8778a8AB33AAc529Df36a634567Be325,0x010F7f46BAd4F1Db5c9ed0C12526b08C5e845F1B
5543,15627869,49175,8074242278,48687,488,138,418,0xD27dcbcC8778a8AB33AAc529Df36a634567Be325,0x1947706FfB1ff7E5C4Da85f992e04081B1045E1D
5544,15627869,49175,8074242278,48687,488,138,629,0xD27dcbcC8778a8AB33AAc529Df36a634567Be325,0x2Ea9A81eF9F2E1615B1D27526a745d72d592CE15
5545,15627869,21000,8030325258,21000,0,2,21,0xF1196c033f24779cfd2C1AA8b1E9eB51Fc4b5AF6,0x0d2cAD56e15aEd87a2bBc56ef17Db89793a75A85
5546,15627869,408706,8030325258,407550,1156,394,94,0x1efB6a3125B509983c1AD95e8015D1E93398997D,0x072B6AaC774fFe93371f8085D4a082EA8d92db3B
5547,15627869,469689,8000000000,463953,5736,1802,247,0xC36442b4a4522E871399CD717aBDD847Ab11FE88,0xC2ed974d394916b3E26D74BDdB631781AA85dF57
5548,15627869,230808,8000000000,228160,2648,714,2,0xb2e7C59e3BFec19bBBb0e33c0899BE7F15667f95,0xDCd8b1247810f9BCd050EffB622B6f9eE01bc899
5549,15627869,329277,7808872635,327065,2212,586,65,0x89078be8004Fb238630C2E156DF7d3bA56e590EF,0x99CCE83Ab2e046E0e08d8aE0797f1c6f46956ec9
5550,15627869,225849,7808872635,223789,2060,522,111,0xEfF92A263d31888d860bD50809A8D171709b7b1c,0x15ABbbF9a511412f2E0546ef16abefbdA2CfA1dB
5551,15627869,21000,7808872635,21000,0,2,584,0x15F8733104b67F17158c417d32172Eea56C3b61D,0x8aEF89129806B23C7930DFdf2B46E22ae1849c49
5552,15627869,73170,7579645800,72574,596,138,365,0xA0b86991c6218b36c1d19D4a2e9Eb0cE3606eB48,0x287544938d9011394634B48e9Fc1d8192EAc3e19
5553,15627869,21096,7410982649,21000,96,14,113,0xf43E12bFB359F4824C8781a519CEEf0b64290647,0x55d0608527a0Eeb29d6E7Cd4068150aa09f2A94C
5554,15627869,100000,7267430714,99392,608,138,705878,0xdAC17F958D2ee523a2206206994597C13D831ec7,0x6dfc34609a05bC22319fA4Cce1d1E2929548c0D7
5555,15627869,331744,7267430714,161652,170092,21472,183247,0x5E4e65926BA27467555EB562121fac00D24E9dD2,0x6887246668a3b87F54DeB3b94Ba47a6f63F32985
5556,15627869,21000,7261711233,21000,0,2,29,0x6B9353bF4f90aBdb218979b7596fAFc3C6c6aC64,0x1B33bFCa21bfdE70d66B2Eca56c3A9C3e9d20A40
5557,15627869,93400,7261711233,91812,1588,394,61,0xa909871F46d2cD8Fb015d176483Ffc3C330DCDA4,0xcc8992DcA072330ACC2E0DCC13d67edf27ddCf32
5558,15627869,23100,7217794213,23100,0,2,5,0x4270cd21614B026D7c6106d4E54893980da2BF7a,0x03E0b42574933ed68a8C3291b6eD20e598AAaD1e
5559,15627869,21000,7217794213,21000,0,2,42,0x974CaA59e49682CdA0AD2bbe82983419A2ECC400,0x54C3E7E0eA7faF2A6b909Dc2A98360B36fc6F145
5560,15627869,21000,7217794213,21000,0,2,80,0x974CaA59e49682CdA0AD2bbe82983419A2ECC400,0x1D097903477090831527b07c63C4179D5289386C
5561,15627869,21000,7217794213,21000,0,2,40,0x974CaA59e49682CdA0AD2bbe82983419A2ECC400,0x076D9888C0D7A752451a7931fD50D28dC4D3ad3F
5562,15627870,276949,31868648232,264869,12080,3858,26,0x1111111254fb6c44bAC0beD2854e76F90643097d,0xC1e4f8Dca5D91DE30d8427Af68aA2D45C6bcFCE1
5563,15627870,420000,30000000000,419380,620,138,1226078,0xdAC17F958D2ee523a2206206994597C13D831ec7,0x5041ed759Dd4aFc3a72b8192C143F72f4724081A
5564,15627870,21000,24000000000,21000,0,2,1,0xBd6950E133ddfD72F19A90a755BaB3Da03260cc1,0x71824CAd59abA1Ce273415fd410E5653cB87ccA0
5565,15627870,200797,16868648232,197145,3652,1162,862,0x68b3465833fb72A70ecDF485E0e4C7bD8665Fc45,0x0a2eB196bFf5573F456D47A9fA26208a24BB5996
5566,15627870,222222,12000000000,220658,1564,394,165,0x1Fa8559e873f698292766790AeCf8080A66433F6,0x88Bc1393d31Ed5a6413CF9AC41d8ed081bbCEF81
5567,15627870,90000,12000000000,89392,608,138,12622,0x05237E2bd2dfAb39a135d254cABAE94b183C8baD,0xFd25F5A3415e29f0AeeB5746E5D513DE67169225
5568,15627870,60803,11868648232,53271,7532,2514,68,0x00000000006c3852cbEf3e08E8dF289169EdE581,0x74Cd0e1a5EaA975b2426d1fa2CB1D88dA3DbEFaA
5569,15627870,259818,11717452233,257502,2316,650,106626,0xA69babEF1cA67A37Ffaf7a485DfFF3382056e78C,0x9AAb3F81604c683a1a0D14019FBfe15bef7aA1ee
5570,15627870,100000,11713308952,99380,620,138,181436,0x473037de59cf9484632f4A27B509CFE8d4a31404,0x6238872A0Bd9F0E19073695532a7Ed77ce93C69E
5571,15627870,350000,11704729731,350000,0,2,6925053,0xee265Ef07E7FccF796798D1A70Df82164c61458D,0x46340b20830761efd32832A74d7169B29FEB9758
5572,15627870,21000,11000000000,21000,0,2,2325,0x07159b9e3BA83F7b06516b0F2253b014D7F7c20b,0xce0df2BA6c2BD425F3Ffbbea708F0B5f21ae1e6a
5573,15627870,500000,10868648232,498728,1272,266,34377,0x3666f603Cc164936C1b87e207F36BEBa4AC5f18a,0xa6a688F107851131F0E1dce493EbBebFAf99203e
5574,15627870,184275,10868648232,182679,1596,230,5329,0x9507c04B10486547584C37bCBd931B2a4FeE9A41,0x474a6FaF2178982bE06028f0e1256af98910d9BE
5575,15627870,500000,10868648232,498632,1368,266,141510,0xb8901acB165ed027E32754E0FFe830802919727f,0x710bDa329b2a6224E4B44833DE30F38E7f81d564
5576,15627870,73345,10612348387,72725,620,138,4709924,0xdAC17F958D2ee523a2206206994597C13D831ec7,0x2FAF487A4414Fe77e2327F0bf4AE2a264a776AD2
5577,15627870,46097,10000000000,45501,596,138,16,0xdAC17F958D2ee523a2206206994597C13D831ec7,0x307eF6Fd908B12a3249252aabf2daEb0df62F617
5578,15627870,457164,10000000000,451380,5784,1802,61,0xC36442b4a4522E871399CD717aBDD847Ab11FE88,0x680CfEA894cD0Bd8491c348795fa791F7386d235
5579,15627870,21000,10000000000,21000,0,2,10,0x6E5f29d49613D72038Fa1f96E710624632B028e5,0xd18d5f59CDb492Ebd21260E5f742377fDF155BDF
5580,15627870,21000,9868648232,21000,0,2,0,0xD91664F23a70374107c7128975Ed3FD37ACeF304,0xCf7Fcc6a529ceE18f0370F8B3c6065F6C4aB5fa1
5581,15627870,122412,9868648232,121672,740,138,192815,0xDBd324B73f6f85bf9013B75C442021303b635Ff9,0x19f494583c7C933be7B0eE58104DDaFac1E8aDfA
5582,15627870,21000,9868648232,21000,0,2,5609,0xCA10Cd8731b053dd375b4ceA64f3F3F1133c8CE7,0x2Cc3941D7E7a3Fa5d55D75b25748e497e4F83C46
5583,15627870,21000,9868648232,21000,0,2,5610,0xdFD135B9a7Fa7CC0f39c0f5121B516ff1BCe870C,0x2Cc3941D7E7a3Fa5d55D75b25748e497e4F83C46
5584,15627870,60000,9370647162,59444,556,202,37655,0x902F09715B6303d4173037652FA7377e5b98089E,0x339d413CCEfD986b1B3647A9cfa9CBbE70A30749
5585,15627870,230000,9240000000,229404,596,138,22,0xdAC17F958D2ee523a2206206994597C13D831ec7,0xb9e83009aa3E15Ac4a6fC255C3642D8f66B9725c
5586,15627870,21000,9079648232,21000,0,2,195477,0x137375FeB18ba2BA491406c691Ccf5D5fBea2602,0xB287eaC48aB21c5FB1d3723830d60b4c797555B0
5587,15627870,65000,9000000000,64392,608,138,0,0xdAC17F958D2ee523a2206206994597C13D831ec7,0x2d64AcAB7C9578A9e226643d4D1B2b2a76E721f3
5588,15627870,39603,8868648232,39351,252,74,370,0xC02aaA39b223FE8D0A0e5C4F27eAD9083C756Cc2,0x9AB5657982689c38eDC358004e8cAB744aA710b0
5589,15627870,77596,8868648232,67852,9744,1418,72,0xcA335E086de6b546e152A8C67BdB20656750872f,0x5012e2f6b9d81e96622BFA2F2764fcB406d8e6C1
5590,15627870,70000,8868648232,69392,608,138,530,0xdAC17F958D2ee523a2206206994597C13D831ec7,0xf5491f793D47A6Ea22f5e0B9AD3990CF66c4b40B
5591,15627870,70000,8868648232,69320,680,138,15046,0x95aD61b0a150d79219dCF64E1E6Cc01f0B64C4cE,0xD16E4cdb153B2DCc617061174223a6D4BFaE53f5
5592,15627870,51547,8868648232,50951,596,138,928,0x467719aD09025FcC6cF6F8311755809d45a5E5f3,0x770EDb43ECC5BCbE6f7088e1049fC42B2d1B195C
5593,15627870,46547,8868648232,46059,488,138,2610,0xaE351b8Ae55B69A5007618E598dDe89d0a092c37,0x24245e6c515187aB9b103BD278dAd0d5A08EdBaA
5594,15627870,140073,8868648232,138521,1552,394,42,0x1Fa8559e873f698292766790AeCf8080A66433F6,0x8530cdB7BB122B146B745A05C27F11e1937ef813
5595,15627870,140088,8868648232,138524,1564,394,42,0x1Fa8559e873f698292766790AeCf8080A66433F6,0x7E60D9593F34b983a4B48D6f5241ABBbE00b3c73
5596,15627870,140088,8868648232,138524,1564,394,49,0x1Fa8559e873f698292766790AeCf8080A66433F6,0x78Ba4a0A7CF71fd7211c1dD6174fa22114211417
5597,15627870,21000,8868648232,21000,0,2,2759942,0xeBee231322292c9a75C928d1F6EA183951F0A473,0x267be1C1D684F78cb4F6a176C4911b741E4Ffdc0
5598,15627870,140088,8868648232,138524,1564,394,39,0x1Fa8559e873f698292766790AeCf8080A66433F6,0x25FAA2E226241Fe045806a4FACf57e472145185b
5599,15627870,21000,8868648232,21000,0,2,2759943,0xcBe9968613D9F7733B7C17FcdC6E9921FF3A157a,0x267be1C1D684F78cb4F6a176C4911b741E4Ffdc0
5600,15627870,140088,8868648232,138524,1564,394,35,0x1Fa8559e873f698292766790AeCf8080A66433F6,0x6C5430c14Cd56BdBcA56E0F2CE0C94D248D35347
5601,15627870,140088,8868648232,138524,1564,394,40,0x1Fa8559e873f698292766790AeCf8080A66433F6,0xFFAC342103D23f594BBb3eC14c26DF62ee29D8d4
5602,15627870,140088,8868648232,138524,1564,394,39,0x1Fa8559e873f698292766790AeCf8080A66433F6,0x9C0DEC7759508Ac03DE1b116FDe170561f4E82F3
5603,15627870,140073,8868648232,138521,1552,394,38,0x1Fa8559e873f698292766790AeCf8080A66433F6,0x46E723A38D41fFFeE8f5644D3DAB0E3C6041924F
5604,15627870,52210,8868648232,51530,680,138,6,0x95aD61b0a150d79219dCF64E1E6Cc01f0B64C4cE,0xC98936bf940E0118125EC689Fb3471342d0F204f
5605,15627870,140088,8868648232,138524,1564,394,40,0x1Fa8559e873f698292766790AeCf8080A66433F6,0xadD7b8Cba47761D6a5E9D22Bca31d1E37eC829F3
5606,15627870,140088,8868648232,138524,1564,394,39,0x1Fa8559e873f698292766790AeCf8080A66433F6,0x24AF2791A5AEA103e23280AaD15650C3de297b4e
5607,15627870,50000,8868648232,49056,944,138,0,0xdAC17F958D2ee523a2206206994597C13D831ec7,0xC58A6D80C98D07f56A598A97d275DA3b65eB9870
5608,15627870,140088,8868648232,138524,1564,394,40,0x1Fa8559e873f698292766790AeCf8080A66433F6,0xAaac79F8A7871fB672bA9a3e9cb0AC84C65816a1
5609,15627870,140088,8868648232,138524,1564,394,31,0x1Fa8559e873f698292766790AeCf8080A66433F6,0xa0F88717Bc577E4A25BD89ec1ac716e510B3FD11
5610,15627870,21000,8868648232,21000,0,2,52,0x48Cfbfcf6FC0531C3C59AE04C78Ebc02b7128b8B,0x91478211Cf25a6a7C07435Df12b7b1CF9f8DcbD7
5611,15627870,140088,8868648232,138524,1564,394,0,0x1Fa8559e873f698292766790AeCf8080A66433F6,0xEF928ccF78B76A98686eDA092aBfC321e05611E8
5612,15627870,60842,8868648232,59898,944,138,4,0x4Fabb145d64652a948d72533023f6E7A623C7C53,0x323656F6f6c8A97048a20E4De2225C134FC7Bf78
5613,15627870,140088,8868648232,138524,1564,394,16,0x1Fa8559e873f698292766790AeCf8080A66433F6,0xF0716d60356c058BfE7B4DFE3839F88b64342B8c
5614,15627870,331952,8868648232,327088,4864,1546,481,0x68b3465833fb72A70ecDF485E0e4C7bD8665Fc45,0x8764885033215F2fdfE7A2CF3a6430E14FA5BdB2
5615,15627870,140088,8868648232,138524,1564,394,0,0x1Fa8559e873f698292766790AeCf8080A66433F6,0x5AAC710703a01C4E17c41d2A7b219faf94E559d1
5616,15627870,140088,8868648232,138524,1564,394,16,0x1Fa8559e873f698292766790AeCf8080A66433F6,0x483685051853532ac51532209AD086B49B533B64
5617,15627870,257636,8868648232,252452,5184,1292,5,0x881D40237659C251811CEC9c364ef91dC08D300C,0x323656F6f6c8A97048a20E4De2225C134FC7Bf78
5618,15627870,140088,8868648232,138524,1564,394,5,0x1Fa8559e873f698292766790AeCf8080A66433F6,0x537D37ebE583142b6D5Fec56Ed02C4225F657D8c
5619,15627870,140088,8868648232,138524,1564,394,0,0x1Fa8559e873f698292766790AeCf8080A66433F6,0xd7073dd48F701Bd1f2F764441b5bBd5e1fe58aba
5620,15627870,140088,8868648232,138524,1564,394,5,0x1Fa8559e873f698292766790AeCf8080A66433F6,0x1955A6555Dc6BDD5dc529E35e0e02B1A095DC2C1
5621,15627870,140088,8868648232,138524,1564,394,12,0x1Fa8559e873f698292766790AeCf8080A66433F6,0xF910f25585af453Cef0Da6591C108672f02373F5
5622,15627870,140073,8868648232,138521,1552,394,25,0x1Fa8559e873f698292766790AeCf8080A66433F6,0xd5a515Ff7C0a46dce9FA0F713c3B00dcB73BcF09
5623,15627870,140088,8868648232,138524,1564,394,12,0x1Fa8559e873f698292766790AeCf8080A66433F6,0x2A3e86C924235dda42769D4e212E324B3bD121E6
5624,15627870,140088,8868648232,138524,1564,394,5,0x1Fa8559e873f698292766790AeCf8080A66433F6,0x5Be5905167F69B2B517a2613DF35991EfcA3ab61
5625,15627870,140088,8868648232,138524,1564,394,0,0x1Fa8559e873f698292766790AeCf8080A66433F6,0xBD1d3e0842D1e32D1d751adD0906517530264677
5626,15627870,140088,8868648232,138524,1564,394,25,0x1Fa8559e873f698292766790AeCf8080A66433F6,0x5Dfb44e9af81Bf290B75c0F1f7d3A44d622FA3C6
5627,15627870,140088,8868648232,138524,1564,394,12,0x1Fa8559e873f698292766790AeCf8080A66433F6,0x74648f4484c1e1D4860BaFdD5af11a2A330558c3
5628,15627870,140088,8868648232,138524,1564,394,12,0x1Fa8559e873f698292766790AeCf8080A66433F6,0x132d254D9b5966FD0C8078f747b81042f0c901D0
5629,15627870,140073,8868648232,138521,1552,394,12,0x1Fa8559e873f698292766790AeCf8080A66433F6,0x1B187f5BD9452400AF4549Ca94D2373B63E4ad25
5630,15627870,140088,8868648232,138524,1564,394,0,0x1Fa8559e873f698292766790AeCf8080A66433F6,0x6763796357c2D9eF88579A021868222F54E99067
5631,15627870,140088,8868648232,138524,1564,394,31,0x1Fa8559e873f698292766790AeCf8080A66433F6,0x9572208C73E2EB324cD2E669eCc405Ec7E540D3d
5632,15627870,140088,8868648232,138524,1564,394,32,0x1Fa8559e873f698292766790AeCf8080A66433F6,0x21fa35CA99eF5DB157eb3232928412D235BC5148
5633,15627870,140088,8868648232,138524,1564,394,12,0x1Fa8559e873f698292766790AeCf8080A66433F6,0x9621DD2D3Bfba115a6d6b49912330C2F5cdB3F3c
5634,15627870,140088,8868648232,138524,1564,394,26,0x1Fa8559e873f698292766790AeCf8080A66433F6,0x4Baca8Bcb96D04aEDAfF986CF1a3EDC1d782D779
5635,15627870,140088,8868648232,138524,1564,394,5,0x1Fa8559e873f698292766790AeCf8080A66433F6,0x11a08c37FC6C89CC1F87081969c9174ab4c0124B
5636,15627870,140088,8868648232,138524,1564,394,0,0x1Fa8559e873f698292766790AeCf8080A66433F6,0xe21EF81Fbc67f99cA982505B7A9Fff25dD6A5D90
5637,15627870,140088,8868648232,138524,1564,394,12,0x1Fa8559e873f698292766790AeCf8080A66433F6,0x65b88757359cd11EC7Dc646BcdE4A1630CA9BD44
5638,15627870,140088,8868648232,138524,1564,394,12,0x1Fa8559e873f698292766790AeCf8080A66433F6,0xCd4AD36163fAa9c233CfB0ea4e38f2b67f205dAB
5639,15627870,140088,8868648232,138524,1564,394,12,0x1Fa8559e873f698292766790AeCf8080A66433F6,0xeB0d71436178d29366Bae0aE4080a1ca45979c4D
5640,15627870,140088,8868648232,138524,1564,394,0,0x1Fa8559e873f698292766790AeCf8080A66433F6,0x0d1dCA0feC37CfB0a5C73763ecc118d0A80Da264
5641,15627870,140088,8868648232,138524,1564,394,12,0x1Fa8559e873f698292766790AeCf8080A66433F6,0x8478712fB4318a79e66dCd2B172024681d83289a
5642,15627870,140088,8868648232,138524,1564,394,31,0x1Fa8559e873f698292766790AeCf8080A66433F6,0xD2929138D887c8399fa7e9f0739E5584eDbEaB8F
5643,15627870,140073,8868648232,138521,1552,394,27,0x1Fa8559e873f698292766790AeCf8080A66433F6,0x52F0332598088E399ad502001bD7F048980cc6D8
5644,15627870,140088,8868648232,138524,1564,394,5,0x1Fa8559e873f698292766790AeCf8080A66433F6,0xBf2493E2B2D08620eEbef238B0C3E8ce8F7aA1C2
5645,15627870,140088,8868648232,138524,1564,394,5,0x1Fa8559e873f698292766790AeCf8080A66433F6,0x56900aA4668De0Edf910c5c608A10aD1977273cA
5646,15627870,140073,8868648232,138521,1552,394,0,0x1Fa8559e873f698292766790AeCf8080A66433F6,0xc8625c5fd6651fAa5986BA89D97fBd2F2B453b88
5647,15627870,140073,8868648232,138521,1552,394,12,0x1Fa8559e873f698292766790AeCf8080A66433F6,0x94fE4878513330ebC7CDe5Ba3C07a8f766b3559B
5648,15627870,140073,8868648232,138521,1552,394,12,0x1Fa8559e873f698292766790AeCf8080A66433F6,0x0527beb38da888F88Deb2B5927ea41132B5377f6
5649,15627870,243215,8868648232,237995,5220,1484,27,0x881D40237659C251811CEC9c364ef91dC08D300C,0x9f061809F63DcF81C50281859A0bc185Bed07F93
5650,15627870,140088,8868648232,138524,1564,394,12,0x1Fa8559e873f698292766790AeCf8080A66433F6,0x4a1dDC63b351B58313eb47D6F2E705488068Eb28
5651,15627870,140088,8868648232,138524,1564,394,5,0x1Fa8559e873f698292766790AeCf8080A66433F6,0xe98F21FdBeC89B1346306e8AEB13D16167bfB767
5652,15627870,140088,8868648232,138524,1564,394,0,0x1Fa8559e873f698292766790AeCf8080A66433F6,0x1B7eFCF4f771beb88fb7F5C186867D7573bE2aC4
5653,15627870,140088,8868648232,138524,1564,394,5,0x1Fa8559e873f698292766790AeCf8080A66433F6,0xFd44f1836Fb9f513354234bef108D3cD9c535cb6
5654,15627870,140088,8868648232,138524,1564,394,12,0x1Fa8559e873f698292766790AeCf8080A66433F6,0x2e5fBFC5c7337562fB77e373Ec24D869C87ABeBE
5655,15627870,140088,8868648232,138524,1564,394,5,0x1Fa8559e873f698292766790AeCf8080A66433F6,0x963B830B815998C1EE5Df6F67d3095E4C66Ad0d7
5656,15627870,140088,8868648232,138524,1564,394,25,0x1Fa8559e873f698292766790AeCf8080A66433F6,0x4DFdcae3a4f7ab543a6329AeF3C76A5ec22c77bC
5657,15627870,140088,8868648232,138524,1564,394,0,0x1Fa8559e873f698292766790AeCf8080A66433F6,0xeD36b9b455F95FFe0117c48F4F05Bb2006b10B3c
5658,15627870,140073,8868648232,138521,1552,394,0,0x1Fa8559e873f698292766790AeCf8080A66433F6,0x71Cd128551c8B8b11c843e91Ce2Cb94E0C0fA31C
5659,15627870,140088,8868648232,138524,1564,394,12,0x1Fa8559e873f698292766790AeCf8080A66433F6,0xBe8f24F0B7C7Da483033Af1Aee8752a90F51b826
5660,15627870,140088,8868648232,138524,1564,394,29,0x1Fa8559e873f698292766790AeCf8080A66433F6,0x091EA3B1F9FED6eCa002e4cb9bd9736EADDAA4Ea
5661,15627870,140088,8868648232,138524,1564,394,0,0x1Fa8559e873f698292766790AeCf8080A66433F6,0x8902B83c1Dde5C036fCa16Eb632B970d29a16D10
5662,15627870,140088,8868648232,138524,1564,394,0,0x1Fa8559e873f698292766790AeCf8080A66433F6,0x7Ebe3a14d75292f7464B59A66A679A8f2c63D884
5663,15627870,140088,8868648232,138524,1564,394,12,0x1Fa8559e873f698292766790AeCf8080A66433F6,0x37Aa7E5e910C6222757B887003974523F7Ab6896
5664,15627870,140088,8868648232,138524,1564,394,12,0x1Fa8559e873f698292766790AeCf8080A66433F6,0xe4Aa3EFC89cF2b915Ce8f811496593FE7a465243
5665,15627870,140073,8868648232,138521,1552,394,5,0x1Fa8559e873f698292766790AeCf8080A66433F6,0x001ba3A5428648f09bA6084cBdD8cD02598826ff
5666,15627870,70000,8868648232,69404,596,138,10,0xdAC17F958D2ee523a2206206994597C13D831ec7,0x989eA556e52f0988BB74aFfee0E26a2CEa18d682
5667,15627870,21000,8868648232,21000,0,2,34063,0xe3792A9c235D434B702023b33F03C48C41631090,0x126ACCDe9fA7cDc6Cc8dcaAe1f5071baAE8a732a
5668,15627870,21000,8868648232,21000,0,2,34064,0x8C91f8496d9a8ce2FF452D5FC286b9FA44CF8Dae,0x126ACCDe9fA7cDc6Cc8dcaAe1f5071baAE8a732a
5669,15627870,21000,8868648232,21000,0,2,34065,0xADB6faf8b2c9e78A9A1780e7fe26Ce3E74cDe674,0x126ACCDe9fA7cDc6Cc8dcaAe1f5071baAE8a732a
5670,15627870,77250,8868648232,76298,952,202,0,0xFf8bf98d2F7AD3bBF454B4a73B9B4E898230bD10,0xC68D9D1D3F20037A5dc2418F020211D99FCf0623
5671,15627870,90000,8868648232,90000,0,2,93927,0xbE56C177E41a2B8a37216b7816231b1C19B20594,0xf89d7b9c864f589bbF53a82105107622B35EaA40
5672,15627870,547152,8528648232,535708,11444,3210,0,0x3b3ae790Df4F312e745D270119c6052904FB6790,0x10Ec59fE8bBb5C889822Fa67BdCf449F11e8DA0B
5673,15627870,55978,8418648232,55034,944,138,61,0xd4cB651749953988647eEE9b51DDB8DB5aeb3410,0x13A1901cF5469df731427FF67cEefE3E02c94e08
5674,15627870,21000,8418648232,21000,0,2,14,0x5fbA95e5Ef2B0603dcF29C88AAa7511cdF77c84A,0x08F5Cf100d3EF812878B5eFa813CBC333eC9ceE2
5675,15627870,297054,8368648233,293294,3760,970,122592,0xa57Bd00134B2850B2a1c55860c9e9ea100fDd6CF,0x1c8F6A5F009E051CaB9C3851ca2DA2c936b2775A
5676,15627870,240724,8368648233,237036,3688,970,100937,0xa57Bd00134B2850B2a1c55860c9e9ea100fDd6CF,0x431B5A84aCC1297Eda88259f300262F1bc3A74f3
5677,15627870,249010,8368648232,246590,2420,522,55,0x283Af0B28c62C092C9727F1Ee09c02CA627EB7F5,0x3ACA969EB5FC9612187d1C9537f7FC012F2ed6a5
5678,15627870,36015,8368648232,35751,264,74,111,0xC02aaA39b223FE8D0A0e5C4F27eAD9083C756Cc2,0xee0E61623a7142883D92Bf98980C3F58a409b1C8
5679,15627870,149759,8368648232,143327,6432,1802,344,0x00000000006c3852cbEf3e08E8dF289169EdE581,0xd643aD32B6A7A8b14ecb6c4A5C0eFbFa7379e8D6
5680,15627870,129537,8368648232,129201,336,74,254,0xE25C43B59c04030bd9BB393f77D9F7DA1bdb73b9,0xD631Bc52b1b69Bd79151be24B7d004e0Bc33f8aB
5681,15627870,223618,8368648232,220846,2772,842,80,0x68b3465833fb72A70ecDF485E0e4C7bD8665Fc45,0x7f37147A7d9C60F1E956Af4629fF98bd22f99E58
5682,15627870,46791,8368648232,46219,572,138,130,0xbef7Dcc0335Ec876e2DC530b883F34c8807d61fc,0x23457d60Ff39D3E7a35C74160E4637061B97CF38
5683,15627870,21000,8368648232,21000,0,2,0,0xAa6ccDA870B6b6fdF97907766470156b13abFBd7,0x1cCA53b755082f428a64F4Fa4c8e146F63887441
5684,15627870,46109,8368648232,45621,488,138,30,0xF7b8aabC98D169020b9EE716FC55541cF3e8B55B,0x5E1a6D27f59Cd8e3853a49f0787E3421c5A992Ce
5685,15627870,289318,8368648232,286946,2372,522,45,0x283Af0B28c62C092C9727F1Ee09c02CA627EB7F5,0x80626F32C252EB332C1963F21836969f6c03629E
5686,15627870,21000,8368648232,21000,0,2,2,0x91e6568c0233d80fB5F36dc2F8a4ecb4B35c3ebd,0xAEc4341c0C612753D52aB971a5FAc44f56433D75
5687,15627870,188856,8368648232,186096,2760,842,212,0x68b3465833fb72A70ecDF485E0e4C7bD8665Fc45,0x4f102e320c8046242eEbaD43A6174678CCe1e8CC
5688,15627870,21000,8368648232,21000,0,2,1,0x5786A1d21A1103536a6EB22851cc61f290008936,0xe47EB455456f0393C9b5Ebc33fB17648baf0e8e5
5689,15627870,21000,8368648232,21000,0,2,3,0xd50d8df8f5aD747899B8b23fa0dC1c166c82dE12,0x6491f8F19f7CB02CA98f26601A2eDF9a8f31E513
5690,15627870,46179,8368648232,45691,488,138,9,0x2f71eaF179404BfbA0C2Eb32947D0cd341bb1672,0x2c522236579771899F8a933f5c267960F02AdCd9
5691,15627870,199960,8368648232,196696,3264,1034,542,0x68b3465833fb72A70ecDF485E0e4C7bD8665Fc45,0x1B69c4A788aD8f940e624341AB45c731D01190De
5692,15627870,424104,8368648232,422320,1784,522,29,0xDba68f07d1b7Ca219f78ae8582C213d975c25cAf,0x9D36f87b841fbf59Df518F84487260933282F229
5693,15627870,21000,8368648232,21000,0,2,99,0xcfB51fE53802628bF1d0d9Bc6d5D24e9EEaD9251,0xDFB1e63A77A5Ef8FC82c378967a2e7e756A28597
5694,15627870,21000,8368648232,21000,0,2,35,0xc6029a9aaCd7d79e568426933dB4978a6A747A84,0x53262e524BC130eDE3E1cb01002236bEf45Cd8F8
5695,15627870,46368,8368648232,45880,488,138,10834,0x364f4eF26f167713329F7DefFA7AFF2Bc95024Ec,0xd5a9C4a92dDE274e126f82b215Fccb511147Cd8e
5696,15627870,278821,8368648232,278617,204,74,469,0x55f1C36Bb7aE0d7D6caE97902E30A2306686Ec73,0x36151eF8bF252eB963235fd76245B98580D595F0
5697,15627870,200000,8368648232,199380,620,138,0,0xA0b86991c6218b36c1d19D4a2e9Eb0cE3606eB48,0x7302e9577D815a301121412D26Ce0a1824198b40
5698,15627870,127890,8368648232,127262,628,202,2,0x084b1c3C81545d370f3634392De611CaaBFf8148,0x057505990F3BB16a912c65D5E4E7918e4C370ee7
5699,15627870,55636,8368648232,54692,944,138,187,0xC02aaA39b223FE8D0A0e5C4F27eAD9083C756Cc2,0x6BfE59e8fEaDDfBdBb97F7Da8c6B4550a8bD4ffd
5700,15627870,21000,8368648232,21000,0,2,286,0x0F5CF80Ae0E3009A074F69f951e39D1d74Eb82a8,0x8798727D84765aB8b81e49E55cD77Caa4F43A1A3
5701,15627870,21000,8368648232,21000,0,2,305,0x2aE2e17B2fE587EF678f6D809f30B9Fb2084C7f6,0x711fBEA37f771F872B0050ce7eF3E58E9BC6667e
5702,15627870,47285,8368648232,46345,940,202,4,0xF7b8aabC98D169020b9EE716FC55541cF3e8B55B,0x45961a72C9e85Ee9219cE3Cad47a1B537B7FE970
5703,15627870,341707,8368648232,336215,5492,1482,1,0x68b3465833fb72A70ecDF485E0e4C7bD8665Fc45,0xE66FfaE0AB6bfb46237f985FbbB52D5595fF1e12
5704,15627870,144983,8368648232,138383,6600,1802,501,0x00000000006c3852cbEf3e08E8dF289169EdE581,0x1176aeCd6a4C18d15629674Aef878658051E2f19
5705,15627870,405231,8368648232,401639,3592,1162,627,0x68b3465833fb72A70ecDF485E0e4C7bD8665Fc45,0x40eB6EB3d007702BAB7E4624E60C72042FE00309
5706,15627870,46103,8368648232,45615,488,138,1368,0x34Bc797F40Df0445c8429d485232874B15561728,0x109440CBe5b508A7063ca126c88b0F81D3829575
5707,15627870,99226,8368648232,98630,596,138,52,0xA0b86991c6218b36c1d19D4a2e9Eb0cE3606eB48,0x0bC5A93B761A3f2d1754695552Dc9c1c677b1e4E
5708,15627870,159830,8368648232,153254,6576,1802,194,0x00000000006c3852cbEf3e08E8dF289169EdE581,0xda4c111B94cC6ffF12bAaCA83D615AC5489b314A
5709,15627870,289318,8368648232,286946,2372,522,325,0x283Af0B28c62C092C9727F1Ee09c02CA627EB7F5,0x78d3D4ed8386e51b60c58ae916302d96E5c0F845
5710,15627870,200000,8368648232,193412,6588,1802,166,0x00000000006c3852cbEf3e08E8dF289169EdE581,0x827cda8f8A1782040af691B73747AbE2Eeee980b
5711,15627870,217274,8368648232,210634,6640,1810,3196,0x00000000006c3852cbEf3e08E8dF289169EdE581,0xAB4ce2a08cBeA809692218DD7841F681B80069A9
5712,15627870,337686,8160000000,336386,1300,202,6,0x7d2768dE32b0b80b7a3454c06BdAc94A69DDc7A9,0xC449f20078A3d4C19c6627BBc6A1b6e2C7FF12b0
5713,15627870,21000,8061472057,21000,0,2,18,0xDBd69Fbd4CDAF50a9189e5Aa5b9fe01bD3B8C8a3,0x3752CFd860b068cBc165DCE300Ff48bA4Dc80a59
5714,15627870,197316,8000000000,195468,1848,458,276,0x7a250d5630B4cF539739dF2C5dAcb4c659F2488D,0x80957e1cb928685AF3b034D4E811dDA69C159947
5715,15627870,48780,8000000000,48184,596,138,21,0xA0b86991c6218b36c1d19D4a2e9Eb0cE3606eB48,0x89314b58c9F874a589997A690C2840A556766A64
5716,15627870,593920,8000000000,590768,3152,1098,404,0xc71930B83cbAbfeb35BeDaAF2122e41595179B14,0xe5F55468585ef91CF1a87aa3aF4c830FA7AE78dE
5717,15627870,49175,7868648232,48687,488,138,352,0xD27dcbcC8778a8AB33AAc529Df36a634567Be325,0xfE0286d8EFc905Da0477D4BB9ce75A8D18C1Fa4E
5718,15627870,250000,7868648232,250000,0,2,45337095,0x00248A40552803fF81fE3e08c980E05A6DF3eD0a,0xEA674fdDe714fd979de3EdF0F56AA9716B898ec8
5719,15627870,250000,7868648232,250000,0,2,45337096,0xA14DC4435EB5141019BaCF09E5ff82EeFd218944,0xEA674fdDe714fd979de3EdF0F56AA9716B898ec8
5720,15627870,250000,7868648232,250000,0,2,45337097,0xFb4Fa05d767e9b4EE33CdaE81fc152a21E3A933B,0xEA674fdDe714fd979de3EdF0F56AA9716B898ec8
5721,15627870,250000,7868648232,250000,0,2,45337098,0x008c5bE53c1Bf932D0B070c1928B1340966fb0a5,0xEA674fdDe714fd979de3EdF0F56AA9716B898ec8
5722,15627870,250000,7868648232,250000,0,2,45337099,0x7b6C6eF24823c75c9cF438c08ed65461Eb584142,0xEA674fdDe714fd979de3EdF0F56AA9716B898ec8
5723,15627870,250000,7868648232,250000,0,2,45337100,0x14A940F33861e89f1cBb96Cf945444e2f4063faa,0xEA674fdDe714fd979de3EdF0F56AA9716B898ec8
5724,15627870,250000,7868648232,250000,0,2,45337101,0x1c540c9Ef9cAA6E316B195b4FEe7297450d7613B,0xEA674fdDe714fd979de3EdF0F56AA9716B898ec8
5725,15627870,94814,7868648232,94206,608,138,0,0xdAC17F958D2ee523a2206206994597C13D831ec7,0xED01c1a2B93749dD3d204D019986daBC2a36aFA7
5726,15627870,250000,7868648232,250000,0,2,45337102,0x49cE8663E3F9F1B7bc0BAc3b89255171fB381e11,0xEA674fdDe714fd979de3EdF0F56AA9716B898ec8
5727,15627870,250000,7868648232,250000,0,2,45337103,0x2a8dcD2dfe19AfC0Eb0792fDD8435A34Eeb5a532,0xEA674fdDe714fd979de3EdF0F56AA9716B898ec8
5728,15627870,181476,7868648232,179912,1564,394,125,0x1Fa8559e873f698292766790AeCf8080A66433F6,0x1e180BE3FC177ca7FbBb9Ac6Bf45a48309390B69
5729,15627870,113310,7868648232,113106,204,74,349,0x5D004ddB5D92938dAF8448b9eac1CaA593cd26Ca,0x26DC5D39Bd7A8bc2d792dcAAAC55FE6DCef25593
5730,15627870,250000,7868648232,250000,0,2,45337104,0xCD5b8deFea067c6AF2AA7317d8b409263eF3aABE,0xEA674fdDe714fd979de3EdF0F56AA9716B898ec8
5731,15627870,113310,7868648232,113106,204,74,350,0x5D004ddB5D92938dAF8448b9eac1CaA593cd26Ca,0x26DC5D39Bd7A8bc2d792dcAAAC55FE6DCef25593
5732,15627870,181458,7868648232,179906,1552,394,3178,0x1Fa8559e873f698292766790AeCf8080A66433F6,0xfD2204757Ab46355e60251386F823960AcCcEfe7
5733,15627870,181476,7868648232,179912,1564,394,910,0x1Fa8559e873f698292766790AeCf8080A66433F6,0x631794a6eed2d23087aF0182CD6d56B0304b8cDB
5734,15627870,113310,7868648232,113106,204,74,351,0x5D004ddB5D92938dAF8448b9eac1CaA593cd26Ca,0x26DC5D39Bd7A8bc2d792dcAAAC55FE6DCef25593
5735,15627870,168487,7868648232,165739,2748,842,99,0x68b3465833fb72A70ecDF485E0e4C7bD8665Fc45,0x5fc44F8aA10cE9f02DaC0C247038Cb5F24869409
5736,15627870,113310,7868648232,113106,204,74,352,0x5D004ddB5D92938dAF8448b9eac1CaA593cd26Ca,0x26DC5D39Bd7A8bc2d792dcAAAC55FE6DCef25593
5737,15627870,181476,7868648232,179912,1564,394,108,0x1Fa8559e873f698292766790AeCf8080A66433F6,0x7E3E8E243BD07918F996F7c42AA0B14Fb7dFE0C5
5738,15627870,113310,7868648232,113106,204,74,353,0x5D004ddB5D92938dAF8448b9eac1CaA593cd26Ca,0x26DC5D39Bd7A8bc2d792dcAAAC55FE6DCef25593
5739,15627870,21000,7868648232,21000,0,2,263,0x7e04334Fa17E5421F13794B93E9488f94CF8c6C9,0x1B352185145d1aEBCB151F7C28257682c3375336
5740,15627870,113310,7868648232,113106,204,74,354,0x5D004ddB5D92938dAF8448b9eac1CaA593cd26Ca,0x26DC5D39Bd7A8bc2d792dcAAAC55FE6DCef25593
5741,15627870,113310,7868648232,113106,204,74,355,0x5D004ddB5D92938dAF8448b9eac1CaA593cd26Ca,0x26DC5D39Bd7A8bc2d792dcAAAC55FE6DCef25593
5742,15627870,113310,7868648232,113106,204,74,356,0x5D004ddB5D92938dAF8448b9eac1CaA593cd26Ca,0x26DC5D39Bd7A8bc2d792dcAAAC55FE6DCef25593
5743,15627870,416127,7834590412,404071,12056,3858,48,0x1111111254fb6c44bAC0beD2854e76F90643097d,0x1F03F0d05CBA219a32E3A4c851de61614226096E
5744,15627870,21000,7808872635,21000,0,2,0,0x64aCf4Bd261e264AF1186C91b29aa3B3262c52b4,0xAe31Ce872C5923e6229e5CdBf6f2c1a05e39ABEB
5745,15627870,370107,7554816325,365279,4828,1546,3496,0x68b3465833fb72A70ecDF485E0e4C7bD8665Fc45,0x8C0BD42871560151705F3d0a2d6714e0bd8c4a06
5746,15627870,181458,7554816325,179906,1552,394,45,0x1Fa8559e873f698292766790AeCf8080A66433F6,0x843b8bA3Ad6E61E983702C22D1FD7fD80900236F
5747,15627870,80000,7554816325,79056,944,138,0,0xdAC17F958D2ee523a2206206994597C13D831ec7,0x674f2768b9C1a920BFD121181C0cff0e1689C756
5748,15627870,66836,7217794213,65892,944,138,265,0xA0b86991c6218b36c1d19D4a2e9Eb0cE3606eB48,0x24D0Da18B2E4F2681ad1183Bee248E7B9e8e6b58
5749,15627870,292112,7077711811,268268,23844,5258,23856,0x5427FEFA711Eff984124bFBB1AB6fbf5E3DA1820,0xbfa2F68bf9Ad60Dc3cFB1cEF04730Eb7FA251424
5750,15627870,288883,7030325258,285203,3680,906,0,0x197492CCB4B1acaAAcd43432657A17832E36AB49,0xD0e62CecF5d65a26Fe88582422bCBE2E741b7a99
5751,15627870,25054,7000000000,25054,0,2,1,0xACE5f8CDe5819EaEbCfe6C836A2122DeccAe7Abe,0x9Cd3c511d34Ef6DC03A2EDA5747a6fb5EAa0735a
5752,15627870,21000,7000000000,21000,0,2,0,0x60A9DF7a3f453D63129089b1149E6d97a73f2c00,0xEE4C722Da0aD1e2c4A2fe961E98dBc036Ff3197a
5753,15627870,191077,7000000000,190177,900,266,831,0xd588b586D61C826A0e87919b3D1a239206d58bf2,0x18772056026D50300ad9A23e153d20409abFd827
5754,15627870,244398,7000000000,243966,432,74,11,0xa6439Ca0FCbA1d0F80df0bE6A17220feD9c9038a,0x85B8bEac4A0b4E375f8A79463B983126e655bAdb
5755,15627870,191077,6981502968,190177,900,266,870,0xd588b586D61C826A0e87919b3D1a239206d58bf2,0x9FC319E0259DE9D57AAb2249e1792AB97Db3A901
5756,15627870,191077,8017479201,190177,900,266,871,0xd588b586D61C826A0e87919b3D1a239206d58bf2,0x9FC319E0259DE9D57AAb2249e1792AB97Db3A901
5757,15627870,329919,6981502968,328559,1360,586,155,0xed5D5108b66E1bC04b123415372504afcB987309,0xc7186ED47C1B14281c0bD3Dc1A0dE03bfcb8F700
5758,15627870,263959,6981502968,261543,2416,586,8,0xd9e1cE17f2641f24aE83637ab66a2cca9C378B9F,0xf27aa87C718f271eD3D7E03b1F28Bf60bDdD72B0
5759,15627870,35535,6926865179,34915,620,138,3580,0xdAC17F958D2ee523a2206206994597C13D831ec7,0x4938df248CFd0F259c561Fa5c1d95Af32275DD8e
5760,15627871,21000,41267442237,21000,0,2,0,0x02C0678e744CE7F72E84e512ed7d11613713fc98,0x681e88c1F4fc79c5bBFfc3f601cCe4AeBf886513
5761,15627871,21000,41267442237,21000,0,2,1,0x10879a9D926E8b7cFbBD3b51102b06029b0340EB,0x681e88c1F4fc79c5bBFfc3f601cCe4AeBf886513
5762,15627871,21000,37259886575,21000,0,2,0,0x90d6a8d0b4940c24c52599a51CA513d276754941,0xa4EB0fD56fCEA10ad082dc54319e6aBe11004f6F
5763,15627871,21000,37259886575,21000,0,2,1,0x2078a939bEfC324Ee524b1B469C60e25d3be5E76,0xa4EB0fD56fCEA10ad082dc54319e6aBe11004f6F
5764,15627871,227908,31566238303,225432,2476,472,83032,0x0000000000007F150Bd6f54c40A34d7C3d5e9f56,0x0336E78E4D09b8A6A84D34d0fD103452dE57A7A3
5765,15627871,31405,31230819023,31405,0,2,48495,0x4dC9e781Fef18fa4Dc5217A5Ee1156f668B5aF55,0x4dC9e781Fef18fa4Dc5217A5Ee1156f668B5aF55
5766,15627871,293768,27819633000,282372,11396,3018,488,0x617Dee16B86534a5d792A4d7A62FB491B544111E,0xf9e3b9153dDd7738740cF115b4Fc3d418BF1AcE7
5767,15627871,500014,12160548232,498154,1860,458,57992,0xe1f08D771FB7B248B3266B7F79A9eAfBA3147c2D,0xbbd9c433a71c21C774aA3f437d2bd5f48E5efd5F
5768,15627871,222222,12000000000,220658,1564,394,158,0x1Fa8559e873f698292766790AeCf8080A66433F6,0x4921dD9cF5c93c5ecf26CBefCd9a03A575F8b021
5769,15627871,600000,12128329613,598000,2000,522,33402,0xE592427A0AEce92De3Edee1F18E0157C05861564,0x30c5312d9CF0d873994f000e72F1cbf561D0209C
5770,15627871,181476,12128329613,179912,1564,394,155,0x1Fa8559e873f698292766790AeCf8080A66433F6,0x8aDc99E70EFeC36665F21Fb4768f881a1f3037a7
5771,15627871,572944,11416766208,564536,8408,2442,7307,0x68b3465833fb72A70ecDF485E0e4C7bD8665Fc45,0x9915498d248B56963678B69b95Aaf08A2C0A4A23
5772,15627871,98945,11000000000,97633,1312,202,6,0x57f1887a8BF19b14fC0dF6Fd9B2acc9Af147eA85,0x03cc71FBe5E1620f5a3D9aC2135642260ADC82bb
5773,15627871,63000,10872029768,63000,0,2,2710053,0x044D8B7E7d10C2E312A83C69039fec810C79a547,0xC098B2a3Aa256D2140208C3de6543aAEf5cd3A94
5774,15627871,90000,10512645414,90000,0,2,784410,0x8a9b4E3055aAf3853f50439ae3Fd83992DcfE522,0xcaD621da75a66c7A8f4FF86D30A2bF981Bfc8FdD
5775,15627871,279241,9900000000,276113,3128,906,6,0x68b3465833fb72A70ecDF485E0e4C7bD8665Fc45,0x781C4c1696339F8207BD95BD742A0b116Cd175f4
5776,15627871,46707,10128329613,46219,488,138,1222,0xbef7Dcc0335Ec876e2DC530b883F34c8807d61fc,0x33E9b221b0F1a631F7BF5f84A904869dFd5fdB6C
5777,15627871,46707,10128329613,46219,488,138,1479,0xbef7Dcc0335Ec876e2DC530b883F34c8807d61fc,0xd32979b5221D88E183cC41AdE64c137527AE16c0
5778,15627871,46707,10128329613,46219,488,138,1169,0xbef7Dcc0335Ec876e2DC530b883F34c8807d61fc,0x1400DE18E743A7CBe405D1634e11e5b776479106
5779,15627871,46707,10128329613,46219,488,138,1205,0xbef7Dcc0335Ec876e2DC530b883F34c8807d61fc,0xbF03669db282459bc0b3a0C47109f519943C7AA3
5780,15627871,77611,9600000000,76955,656,138,29,0x27c1bA4F85b8dC1c150157816623A6Ce80b7F187,0x9A00cD27Dd3d88DF2A41F42718bb08EcB399C3ec
5781,15627871,150756,9628329613,150692,64,10,5,0x65c2e54a4c75ff6da7b6B32369c1677250075fb2,0xE204D78997Ea1c174F2b7C01bBcC191d7E0749cd
5782,15627871,69000,9528329613,68512,488,138,154,0xF3a1befc9643F94551c24A766Afb87383ef64dD4,0xE04450369Eb71d281b4859A3Ca5aaCE22b27837f
5783,15627871,169203,9528329613,167367,1836,458,2428,0x7a250d5630B4cF539739dF2C5dAcb4c659F2488D,0x90C5CA57deF96cf5c651333D2033b8B16cC138cB
5784,15627871,220897,9448010812,218277,2620,424,16446,0xED77777586D73C58EB4D6BEBDF9c85C2d5F56C2d,0x5f0df4aE784dB40B2D5460Aa4415A662527e43Cf
5785,15627871,21000,9090000000,21000,0,2,0,0x6dfc34609a05bC22319fA4Cce1d1E2929548c0D7,0x80451a67fb53c0A181e2A425A594f1274Bb71AfD
5786,15627871,21000,9090000000,21000,0,2,0,0x6dfc34609a05bC22319fA4Cce1d1E2929548c0D7,0x9E4410Eb95cdCD868dF41c7E6c16B83Cd3ad13B3
5787,15627871,21000,9334329613,21000,0,2,274872,0xcA244751b6bf4B4eF7E849ee816B91d799815138,0x389044F3ac7472060A0618116e3624A5f0f20F28
5788,15627871,90000,9000000000,90000,0,2,449977,0x44f47B09Bcb4532a3492D1bB3000ff582A7b21C3,0x077D360f11D220E4d5D831430c81C26c9be7C4A4
5789,15627871,253005,9000000000,248677,4328,1290,6,0xB88F61E6FbdA83fbfffAbE364112137480398018,0x840ff2F2Fa178cb46f3871A992eE6Eb908b3190e
5790,15627871,70000,8888887454,68964,1036,202,17609,0x0944D5848BD9F60A34Ba92aEa300d4286696Eb76,0x5629eb360B54E146323F8aa34546796029bd78f6
5791,15627871,207128,9128329613,206520,608,138,4468954,0xdAC17F958D2ee523a2206206994597C13D831ec7,0x21a31Ee1afC51d94C2eFcCAa2092aD1028285549
5792,15627871,42000,9128329613,42000,0,2,329534,0x2eBE4366B903741fd8927be380B8a9D2a391F913,0x9430801EBAf509Ad49202aaBC5F5Bc6fd8A3dAf8
5793,15627871,49175,9128329613,48687,488,138,1410,0x7f738Ad7072187909384B2ffBaEEdC3C1DA1b686,0xcF8d3063e7074B38f4548A7e2798CE2D498A8Ee2
5794,15627871,21000,9128329613,21000,0,2,1,0x6bcc43d50963363767C112Fc6365714ddc6631B6,0x5b5427AfA29340dBbA63992C3dCCc4B3f6D14C3C
5795,15627871,207128,9128329613,207128,0,2,4708704,0xAC3595a528b0E8C5EC44D0c2C4eE8E22FbebA693,0x28C6c06298d514Db089934071355E5743bf21d60
5796,15627871,207128,9128329613,207128,0,2,1679529,0xC233Ba744629b4004cF3d573f67A45F49cfE3C08,0x4976A4A02f38326660D17bf34b431dC6e2eb2327
5797,15627871,207128,9128329613,207128,0,2,3492279,0xDa7AB0C15b74327EF904919bD075aC503C4fF905,0x56Eddb7aa87536c09CCc2793473599fD21A8b17F
5798,15627871,207128,9128329613,207128,0,2,4232338,0x979207f06Ac3b3Ef08577fE818271a1B3E012689,0xDFd5293D8e347dFe59E90eFd55b2956a1343963d
5799,15627871,21000,9128329613,21000,0,2,33,0xD9418F1e5e78eb9991F09F44578aE694D1Ebbff4,0x55a06bc56221087be919582Eed16A51954423a2a
5800,15627871,230820,9128329613,227568,3252,1034,346,0x68b3465833fb72A70ecDF485E0e4C7bD8665Fc45,0xd45ebE9C038F63A1689B9334ECe9550972029B43
5801,15627871,191077,9128329613,190177,900,266,590,0xd588b586D61C826A0e87919b3D1a239206d58bf2,0x66298837Aa0079C0D1a4ff7549F2Aac8A79c383e
5802,15627871,207128,9128329613,207128,0,2,4468955,0x1132D9B04E8b2Acc46125a35CB51dc3d40476cc2,0x21a31Ee1afC51d94C2eFcCAa2092aD1028285549
5803,15627871,46547,9128329613,46059,488,138,29,0xaE351b8Ae55B69A5007618E598dDe89d0a092c37,0x2F5Ccdc5AEA3a53ED8587F4238e96B6420D2357A
5804,15627871,260016,9128329613,256388,3628,1162,1630,0x68b3465833fb72A70ecDF485E0e4C7bD8665Fc45,0x3ed83cc4C2fA5a66de778ca4C8A77FE66c42193E
5805,15627871,181476,9128329613,179912,1564,394,191,0x1Fa8559e873f698292766790AeCf8080A66433F6,0xe18aD1545242eCd1d793b06779277275a2F1aeF1
5806,15627871,8000000,8720916856,7999936,64,10,15105,0x4feE6F009C29C223C48C84a97B82971Cf7409898,0xb2AA4a5DF3641D42e72D7F07a40292794dfD07a0
5807,15627871,151460,8628329613,150216,1244,330,1,0x98154Ab124E93038bd8Af8409b171815A4d8Df7a,0x211C46F06000901d427ce51ABecB463A2c026e14
5808,15627871,46267,8628329613,45691,576,74,194,0x283Af0B28c62C092C9727F1Ee09c02CA627EB7F5,0xE4b7007D5D6F8cc6A7Db51A3602773d6842AA9Ed
5809,15627871,200000,8628329613,199344,656,138,0,0x514910771AF9Ca656af840dff83E8264EcF986CA,0x48B5D88E43AAa483FA33B1cd70E294ba0A694dF5
5810,15627871,21000,8628329613,21000,0,2,165,0x92c9B5A421Bd9E85B7Ab275088c249b8A32F7Ce4,0x375Dae8e3F7c60AdfFa7db18590Dcdf6F0de2223
5811,15627871,99132,8628329613,98928,204,74,560,0x48193776062991c2fE024D9c99C35576A51DaDe0,0xBc86dA04ab1A0926bAA23e0C1F49F75A31EAeCd1
5812,15627871,71709,8628329613,69513,2196,458,438,0x74312363e45DCaBA76c59ec49a7Aa8A65a67EeD3,0x923b14ad2c5eCde9A549Ce11e3EeD4790B3766EA
5813,15627871,178746,8628329613,171590,7156,1930,28,0x00000000006c3852cbEf3e08E8dF289169EdE581,0x19443b60F0047551b16491a65e0A01486a2Cd9a0
5814,15627871,188870,8628329613,186098,2772,842,279,0x68b3465833fb72A70ecDF485E0e4C7bD8665Fc45,0x906eA1f28992B948f6FEbBfD44E6541B13a3d0dF
5815,15627871,46704,8628329613,46216,488,138,94,0xbd3F82a81c3F74542736765cE4FD579D177b6bC5,0x8465699fe77e4680b7d78f4Db18eB772ecEAd20A
5816,15627871,582204,8628329613,578364,3840,1226,16,0xC36442b4a4522E871399CD717aBDD847Ab11FE88,0x18bD1d8e0bcC62E4E7066871d9116BD47A338DF5
5817,15627871,162083,8628329613,155483,6600,1802,22,0x00000000006c3852cbEf3e08E8dF289169EdE581,0x97640D58FBC2677B1dc33f3eeb0128bdfFf9f5E9
5818,15627871,94813,8628329613,94205,608,138,1,0xdAC17F958D2ee523a2206206994597C13D831ec7,0xdCb6F2F24908C33e46f099b24eeE62fB7772805B
5819,15627871,21000,8628329613,21000,0,2,8,0x1232A18C318E5b33af9933edD81BB7BC8e6A1838,0x80eD3D73D530f570709c88E43E30F37b8d02045F
5820,15627871,21000,8628329613,21000,0,2,26,0x5202D4e5bFC13405F93F4C1cF6dbe5209FcEA10F,0xd026B2109c2341E2d3445e0A6D6b41A022F318f3
5821,15627871,27938,8628329613,27874,64,10,2245,0xC02aaA39b223FE8D0A0e5C4F27eAD9083C756Cc2,0x81269781E647eb0843Dc3a8fEbC55a38cE69B4eB
5822,15627871,75542,8628329613,75302,240,74,493,0xf11ED77fD65840b64602526DDC38311E9923c81B,0x08d8604a1C24fd74b85366aeafB01186D49708AF
5823,15627871,21000,8628329613,21000,0,2,96,0x8A38c3f48a8f9779D44591b492b3FF0A5B4Cf58E,0x7e315d2b078d2Db33c4d7Ab3cf73294e0242E493
5824,15627871,55936,8628329613,54992,944,138,689,0x62E971f69193e20adFA64f13594ee8654fC508aB,0x51115F73F927fCf13ef6f27f6bAA170156d44489
5825,15627871,307218,8628329613,304834,2384,522,8,0x283Af0B28c62C092C9727F1Ee09c02CA627EB7F5,0x5f7e5f3f08c836c092B216667a82a61eE9eceEDA
5826,15627871,55897,8628329613,54953,944,138,35,0x0148015047923173cc1a4bC384D5CcC8b8B21a9C,0x59E0a840b22192a54E1c4DebFF9a90fbf34E6860
5827,15627871,84961,8628329613,84757,204,74,203,0x55f1C36Bb7aE0d7D6caE97902E30A2306686Ec73,0x5bAB06Aab8aEcD0E60c8287391233F2285ad7071
5828,15627871,46382,8628329613,45726,656,138,46,0xC631bE100F6Cf9A7012C23De5a6ccb990EAFC133,0x490f9d4eb6Bb1439146902c1eFfbE118880d4E8b
5829,15627871,21000,8628329613,21000,0,2,340,0x9E295f465136F48b518126cC6ef714d82E43F67B,0x6e5c2cb2a00FFa3B03B443a9023383d0d076dD6d
5830,15627871,200000,8628329613,199416,584,138,0,0xA0b86991c6218b36c1d19D4a2e9Eb0cE3606eB48,0x50e9eee45E2bAA80075fcA9cb77279b3fe2aAa06
5831,15627871,227043,8628329613,226839,204,74,85,0xa6561830c0Ff7C7c52E85cf062e01740Af216e01,0x7EdE7d2de92305601617DfDA66c16e7dcF0fCD8A
5832,15627871,60778,8628329613,60094,684,266,4,0x12DEb1Cb5732E40Dd55B89aBB6D5C31dF13A6e38,0xB9acFcEfa71bD6E51A5f2156Bc0479e2Ef714f6d
5833,15627871,99244,8628329613,98636,608,138,12,0xA0b86991c6218b36c1d19D4a2e9Eb0cE3606eB48,0xC1cFFfc345aC315cF695c628d9BB7548Fa5CDe06
5834,15627871,60767,8628329613,53271,7496,2514,40,0x00000000006c3852cbEf3e08E8dF289169EdE581,0x9f53742B9Ae27B9e6BAc028FcA8D82E20AB23202
5835,15627871,21000,8628329613,21000,0,2,132,0x050C1C3D2E802dD6208Acee28806CC65f35F9327,0xdc7fC79AFd7E07368e9fA57E91e47047b712d621
5836,15627871,290171,8628329613,289195,976,202,1105,0xA422CA380bd70EeF876292839222159E41AAEe17,0x8149DC18D39FDBa137E43C871e7801E7CF566D41
5837,15627871,83808,8628329613,83236,572,138,18,0x5CC5B05a8A13E3fBDB0BB9FcCd98D38e50F90c38,0xa0DEfb94C58E0e03cdd8E580F35fB64097fe9F9d
5838,15627871,143265,8628329613,136689,6576,1802,71,0x00000000006c3852cbEf3e08E8dF289169EdE581,0x546367D801a949107A95Cd1D591C741078598fF3
5839,15627871,159842,8628329613,153254,6588,1802,1105,0x00000000006c3852cbEf3e08E8dF289169EdE581,0x17e3d8D01624d1a03924228A855D631FBf332b98
5840,15627871,85219,8628329613,84551,668,138,19,0x12f649A9E821F90BB143089a6e56846945892ffB,0x76b36A038cd2086406120b2807258cD7b857308F
5841,15627871,46185,8628329613,45697,488,138,539,0x9b3B6974531d8AA15A87908FFd821A64863Ede5B,0x86339A63B82A4Fb5e1EA888EEA7c760b9662f1C2
5842,15627871,240543,8628329613,237795,2748,842,197,0x68b3465833fb72A70ecDF485E0e4C7bD8665Fc45,0x3dE360223Ee281E7baEA41CB9BaAc4DdE16eD157
5843,15627871,99262,8628329613,98642,620,138,6,0xA0b86991c6218b36c1d19D4a2e9Eb0cE3606eB48,0x5a3850a9159d64275D46fbEEceF7101b852c349C
5844,15627871,46149,8628329613,45661,488,138,2945,0xEaA1851Cc3a0e7e684f722f35C8A8266f0A49e0C,0x73Cf1b62C6e27d4Fc84Ec076aa1Ea30bF87df483
5845,15627871,406591,8628329613,406159,432,74,2971,0x65f7BA4Ec257AF7c55fd5854E5f6356bBd0fb8EC,0xf3e11d89b07e738F31dE12e8D8CFa0EAc7867A37
5846,15627871,21000,8628329613,21000,0,2,616,0xEF92F0FE3447fC5cABE898883b6f768b1b3085A0,0xE6B976cC584fAfb20fDAE0172e9f92Ac72F564e3
5847,15627871,46267,8628329613,45691,576,74,229,0x283Af0B28c62C092C9727F1Ee09c02CA627EB7F5,0x57679F905F9618d50a638cc1fe272003A831cec1
5848,15627871,71709,8628329613,69513,2196,458,439,0x74312363e45DCaBA76c59ec49a7Aa8A65a67EeD3,0x923b14ad2c5eCde9A549Ce11e3EeD4790B3766EA
5849,15627871,207128,9128329613,206544,584,138,4708705,0x2260FAC5E5542a773Aa44fBCfeDf7C193bc2C599,0x28C6c06298d514Db089934071355E5743bf21d60
5850,15627872,210832,191276703997,209720,1112,156,5560,0xb9aa14b6774dbc9F84B15e7fF659c0dbA0D9ddF5,0xc4c162e5E2475675cf07f4c851659d0f4266c224
5851,15627872,250000,53000000000,250000,0,2,18571,0x0Fd3969084A5d855C9fc5fB21c005F372161CCbf,0x41b309236C87b1bc6FA8Eb865833E44158Fa991a
5852,15627872,243664,26000000000,241652,2012,522,2,0x25553828F22bDD19a20e4F12F052903Cb474a335,0x14a0b8309B0B0Ce2A63A265d587562CD98F61775
5853,15627872,21000,20000000000,21000,0,2,207224,0x9490a57f2066DCc4378ad390132f3aA84f8Aca19,0x72BCFA6932FeACd91CB2Ea44b0731ed8Ae04d0d3
5854,15627872,90000,20000000000,90000,0,2,221109,0x1f68053cD925D467852CFecF78bd836F33F0e4A1,0x28FFE35688fFFfd0659AEE2E34778b0ae4E193aD
5855,15627872,548482,15555385908,543030,5452,778,24947,0x767AF52d988D1241A346851a1B39cCd11357376E,0xD1b72A8Ae97f51D7bd4Af257A124175688924001
5856,15627872,90000,14123673336,90000,0,2,157094,0x8A2228755C8a6d5d8d1cE3dc2A5C223b537ff34d,0xeB6c4bE4b92a52e969F4bF405025D997703D5383
5857,15627872,195059,13683715521,192999,2060,522,349,0x7a250d5630B4cF539739dF2C5dAcb4c659F2488D,0x788296BAb7c874416c34BB5d7Bc0eb2170c97334
5858,15627872,2000000,13673715521,1998024,1976,522,637,0x7a250d5630B4cF539739dF2C5dAcb4c659F2488D,0x903D13d2BC4D187ab5316a76c45CC971Dda6e226
5859,15627872,590866,12267430714,590426,440,138,8,0xDad08B9401358D3398aC796ae130653550d74bc5,0xC11bc2100DB1D307d9fa25b19A1A59412D03EBa2
5860,15627872,287025,12183045600,283149,3876,1226,252,0x5e4A9330C3Aa634153cD3b256c90e3558AeAFD2e,0x5172D80d43136202d8CAEB96b8cD3f3A81823850
5861,15627872,222222,12000000000,220658,1564,394,162,0x1Fa8559e873f698292766790AeCf8080A66433F6,0xcb227ab74D7C16e1313f713890e89671299946d5
5862,15627872,140088,11773715521,138524,1564,394,3608,0x1Fa8559e873f698292766790AeCf8080A66433F6,0x142465967d1d29df61B2C53B421a31Fbf7091DA2
5863,15627872,140088,11673715521,138524,1564,394,4828,0x1Fa8559e873f698292766790AeCf8080A66433F6,0x81BB44f2B0D308384340B117eb249224eaCa5972
5864,15627872,66467,11020000000,65059,1408,394,11,0x0eFf88E66eB717F8F7e0701345f1Cc119b487f86,0x9DFBde7a488921629c2DF73b33bfA86AC4Ee0C70
5865,15627872,191041,11000000000,190165,876,266,1393,0xd588b586D61C826A0e87919b3D1a239206d58bf2,0xC22d03e13B888Dabb33A1575e4F6542f0e996622
5866,15627872,54184,11000000000,53612,572,138,233,0xD27dcbcC8778a8AB33AAc529Df36a634567Be325,0xf01A782e4C326a9C449263Fb21B773D2274d9E70
5867,15627872,350000,10892566850,350000,0,2,6925054,0x22CcB9D27437A4b4Ca7BC1A3a673048F684F06Fc,0x46340b20830761efd32832A74d7169B29FEB9758
5868,15627872,21000,10826691320,21000,0,2,1569061,0xb8bE8f2d7Bb8a309A3C85ca2474CA2a07018A52a,0xAe45a8240147E6179ec7c9f92c5A18F9a97B3fCA
5869,15627872,21000,10826691320,21000,0,2,1569062,0xEa4406222b8AaF64FD9cFB885b6404a46E175119,0xAe45a8240147E6179ec7c9f92c5A18F9a97B3fCA
5870,15627872,105775,10800000000,104835,940,202,172429,0xf23051a4C5d5A84d0fDeA123Fc597998326fe2a3,0xE052113bd7D7700d623414a0a4585BCaE754E9d5
5871,15627872,52966,10690817572,52534,432,74,155626,0x9bb5E82Cc1E6Aca5dfB6350FC89F3800C9b7e004,0xcDd37Ada79F589c15bD4f8fD2083dc88E34A2af2
5872,15627872,500000,10673715521,498608,1392,266,2133,0x22B1Cbb8D98a01a3B71D034BB899775A76Eb1cc2,0xd8781cA9163E9f132A4D8392332E64115688013a
5873,15627872,168508,10658823301,167736,772,106,13641,0x5C57Ac8dC5D8589DAB9d422993ED3DE8CC244151,0x4D521577f820525964C392352bB220482F1Aa63b
5874,15627872,40000,10592755002,40000,0,2,86,0xDda7690F497C81812AcAf6CCd5FCE6e573CD45F3,0xDda7690F497C81812AcAf6CCd5FCE6e573CD45F3
5875,15627872,66854,10473715521,65842,1012,202,355152,0x514910771AF9Ca656af840dff83E8264EcF986CA,0x7abE0cE388281d2aCF297Cb089caef3819b13448
5876,15627872,76221,10417415676,75233,988,202,4709925,0xdAC17F958D2ee523a2206206994597C13D831ec7,0x2FAF487A4414Fe77e2327F0bf4AE2a264a776AD2
5877,15627872,63000,10417415676,63000,0,2,4709926,0x92C47ec94e57daE44Cae11a465D72990e614eE33,0x2FAF487A4414Fe77e2327F0bf4AE2a264a776AD2
5878,15627872,69084,10417415676,68060,1024,202,4709927,0xdBdb4d16EdA451D0503b854CF79D55697F90c8DF,0x2FAF487A4414Fe77e2327F0bf4AE2a264a776AD2
5879,15627872,76533,10417415676,75509,1024,202,4709928,0x320623b8E4fF03373931769A31Fc52A4E78B5d70,0x2FAF487A4414Fe77e2327F0bf4AE2a264a776AD2
5880,15627872,76548,10417415676,75512,1036,202,4709929,0x320623b8E4fF03373931769A31Fc52A4E78B5d70,0x2FAF487A4414Fe77e2327F0bf4AE2a264a776AD2
5881,15627872,21000,10108036825,21000,0,2,17,0xCBD6832Ebc203e49E2B771897067fce3c58575ac,0xee265Ef07E7FccF796798D1A70Df82164c61458D
5882,15627872,100000,10058031322,99368,632,138,1050387,0x4a220E6096B25EADb88358cb44068A3248254675,0xf16E9B0D03470827A95CDfd0Cb8a8A3b46969B91
5883,15627872,90000,10058031322,90000,0,2,784411,0xA0AEF95618167fBBCf880789a78C4Bb3AB48aa08,0xcaD621da75a66c7A8f4FF86D30A2bF981Bfc8FdD
5884,15627872,90000,10058031322,90000,0,2,784412,0x6e647645c851CAbed1F1Bcd59706a73B3F0238b8,0xcaD621da75a66c7A8f4FF86D30A2bF981Bfc8FdD
5885,15627872,100000,10058031322,99392,608,138,368500,0xdAC17F958D2ee523a2206206994597C13D831ec7,0xeC30d02f10353f8EFC9601371f56e808751f396F
5886,15627872,233670,10058031322,233242,428,138,5,0xC7757805B983eE1b6272c1840c18e66837dE858E,0x0eC70AcdcDB05C1F512A1c9237708663BBAe7172
5887,15627872,250048,9673715521,247988,2060,522,87,0x7a250d5630B4cF539739dF2C5dAcb4c659F2488D,0x5688bCe725aF46e3058D144045BA7FBe1c16A592
5888,15627872,50000,9447659928,50000,0,2,476120,0xf35E219aCE2252d6B1c5Cb105ed3Fa0E37173c69,0x4d846dA8257BB0Ebd164EFf513DfF0F0c2C3c0ba
5889,15627872,140073,9273715521,138521,1552,394,5278,0x1Fa8559e873f698292766790AeCf8080A66433F6,0x888C65C45923D565dEe48B6E98ae5ED9b668D635
5890,15627872,55904,9073715521,54960,944,138,2429,0x011b0beAe3eC5953B4805b064cC78f6F892A99cC,0x90C5CA57deF96cf5c651333D2033b8B16cC138cB
5891,15627872,1115476,9000000000,1115412,64,10,1,0x65c2e54a4c75ff6da7b6B32369c1677250075fb2,0x0312f537DE4108b93E965F062d36AEFD07e4F51D
5892,15627872,51919,9000000000,51251,668,138,0,0x95aD61b0a150d79219dCF64E1E6Cc01f0B64C4cE,0x8ca51499937A5eDf04c7A9ab782274BaecCcbFe7
5893,15627872,77570,9000000000,76890,680,138,166,0x557B933a7C2c45672B610F8954A3deB39a51A8Ca,0x190fb3B4118e5633820184fE9217049A88f07FCF
5894,15627872,90000,9000000000,90000,0,2,449978,0x952788DbB045c454F1E5e820485F9a1d0373BdF9,0x077D360f11D220E4d5D831430c81C26c9be7C4A4
5895,15627872,100000,8900000000,99024,976,202,705879,0xdAC17F958D2ee523a2206206994597C13D831ec7,0x6dfc34609a05bC22319fA4Cce1d1E2929548c0D7
5896,15627872,21000,8879715521,21000,0,2,261874,0x6c7C127EDfccb1288936b2df71293DB41DD021A0,0xBBd0D4d067d5aF2065B1B6fD936d93237Ae1c56C
5897,15627872,21000,8813715521,21000,0,2,4,0x0f657918941a3eaE99aC6D91FC97d61E8B324173,0x5eD2f187C030833caF4e79ccF27AE3efc45C4282
5898,15627872,8000000,8791943320,7999936,64,10,15106,0xE9c88E882c2f7c6E0a73948af824Bd9E82A9A7E6,0xb2AA4a5DF3641D42e72D7F07a40292794dfD07a0
5899,15627872,21000,8673715521,21000,0,2,34066,0x93d0d1A8c0B16AbdF02b85D4a3cE7ada53C28238,0x126ACCDe9fA7cDc6Cc8dcaAe1f5071baAE8a732a
5900,15627872,500000,8673715521,498272,1728,458,1262739,0xa24787320ede4CC19D800bf87B41Ab9539c4dA9D,0x89e51fA8CA5D66cd220bAed62ED01e8951aa7c40
5901,15627872,500000,8673715521,498260,1740,458,1262740,0xa24787320ede4CC19D800bf87B41Ab9539c4dA9D,0x89e51fA8CA5D66cd220bAed62ED01e8951aa7c40
5902,15627872,248886,8673715521,246138,2748,842,401,0x68b3465833fb72A70ecDF485E0e4C7bD8665Fc45,0xa0638a858F527F3954cda9b3F1B9CA652144C9Ae
5903,15627872,49542,8673715521,49478,64,10,4,0xC02aaA39b223FE8D0A0e5C4F27eAD9083C756Cc2,0x4d6DCBEA6bDE4C7D80392a68E093a1EF949764d6
5904,15627872,39617,8673715521,39353,264,74,131,0xC02aaA39b223FE8D0A0e5C4F27eAD9083C756Cc2,0x6A50896247dEbf458394BD5ec52E91a5Eee045B5
5905,15627872,60760,8673715521,59816,944,138,51,0xA0b86991c6218b36c1d19D4a2e9Eb0cE3606eB48,0xd2CF43C8a4c73BE17d48C925B6F5e0A653A4ee1A
5906,15627872,51571,8673715521,50951,620,138,1018,0x467719aD09025FcC6cF6F8311755809d45a5E5f3,0x27CccC678b2F6C374d7a57862d96378C87e1E3F2
5907,15627872,21000,8673715521,21000,0,2,178,0x4B758c64B83DaD8Fea640428DF0aFddb7C97Cd3F,0x200256825A76c089069014Cef039B81d26e3142d
5908,15627872,56659,8673715521,55715,944,138,308,0x19f1a46cAee231A7d95226355cC67FC790f5487b,0xeC11Cae419177e6ecE61c6C35DBD0F8e08B89982
5909,15627872,323064,8673715521,313680,9384,2636,52,0x881D40237659C251811CEC9c364ef91dC08D300C,0xd2CF43C8a4c73BE17d48C925B6F5e0A653A4ee1A
5910,15627872,70000,8673715521,69392,608,138,531,0xdAC17F958D2ee523a2206206994597C13D831ec7,0xf5491f793D47A6Ea22f5e0B9AD3990CF66c4b40B
5911,15627872,85000,8673715521,84512,488,138,356,0xD27dcbcC8778a8AB33AAc529Df36a634567Be325,0xe3b4fd29770d5C55c7E015099520F76cD84B1AF8
5912,15627872,39617,8673715521,39353,264,74,332,0xC02aaA39b223FE8D0A0e5C4F27eAD9083C756Cc2,0xB21a79AC56ea3314D3141B2019A85cb8a24361B7
5913,15627872,261788,8673715521,243348,18440,4554,13,0x00000000006c3852cbEf3e08E8dF289169EdE581,0x1f41509DC6F3777EF62b20645a0dc58D77c3dB51
5914,15627872,49268,8673715521,48780,488,138,256,0xfA751Bb98E49a2a8113de92d21C2266d5655f274,0x95C1641433B03F4b48EB1189711931B2f9af8970
5915,15627872,266230,8673715521,262926,3304,970,148,0x68b3465833fb72A70ecDF485E0e4C7bD8665Fc45,0x9fDADe20451c6ef695bc5511c793CBa40cc656c4
5916,15627872,39603,8673715521,39351,252,74,137,0xC02aaA39b223FE8D0A0e5C4F27eAD9083C756Cc2,0xAe52971Dd40b364337065f36b5F7066b495f37AD
5917,15627872,70000,8673715521,69404,596,138,170,0xdAC17F958D2ee523a2206206994597C13D831ec7,0x79A1709Bc5A772a53a47766acF8CDab939D64d43
5918,15627872,21000,8673715521,21000,0,2,13796,0x8b14A1A527104512A446453d31dD6bE3b8cB3451,0xdAb1a1854214684acE522439684a145E62505233
5919,15627872,42000,8673715521,42000,0,2,329535,0x5e4694B766295cDF14BEebD719D51622DA7036DB,0x9430801EBAf509Ad49202aaBC5F5Bc6fd8A3dAf8
5920,15627872,30732,8673715521,30668,64,10,71,0xC02aaA39b223FE8D0A0e5C4F27eAD9083C756Cc2,0x9363831ac86713fF856A9B5F044B706e796510F3
5921,15627872,383959,8673715521,380995,2964,650,7,0x7a250d5630B4cF539739dF2C5dAcb4c659F2488D,0x017052d0B1aCE8C9faafD0bB5D7Acf37F5058CC0
5922,15627872,225721,8643715521,224301,1420,394,1,0x3b3ae790Df4F312e745D270119c6052904FB6790,0x538a29b825Ccfa936aD83d629c4F51c8253227ca
5923,15627872,574629,8533715521,562785,11844,3914,295,0xDEF171Fe48CF0115B1d80b88dc8eAB59176FEe57,0x17D065070486Ca0fC8b4B382b946BE79Fb4fF10D
5924,15627872,1544638,6673715521,1541610,3028,778,106627,0xa57Bd00134B2850B2a1c55860c9e9ea100fDd6CF,0x9AAb3F81604c683a1a0D14019FBfe15bef7aA1ee
5925,15627872,199556,8173715521,196784,2772,842,5405,0x68b3465833fb72A70ecDF485E0e4C7bD8665Fc45,0x1057B6adB95680C811c256A393F5C523d94fd6a6
5926,15627872,1544638,6673715521,1540906,3732,1034,106628,0xa57Bd00134B2850B2a1c55860c9e9ea100fDd6CF,0x9AAb3F81604c683a1a0D14019FBfe15bef7aA1ee
5927,15627872,21000,8430074999,21000,0,2,100439,0xBf13160a14F44d8a87D81A611997F44615EB2853,0x5Ecddc1AC099074ae965D140A7c62bd71B7Fc80a
5928,15627872,40105,8397557611,40105,0,2,6996,0xFB2875efe1AA73F02d48046Fb2faD0308bc01E5d,0xFB2875efe1AA73F02d48046Fb2faD0308bc01E5d
5929,15627872,174903,8323715521,171251,3652,1162,11,0x68b3465833fb72A70ecDF485E0e4C7bD8665Fc45,0xF162fC5D1174449137E0536923495F3bD9a1380c
5930,15627872,77244,8223715521,76588,656,138,37,0xA14E051Af256157ce093Aa54CB3b2f775358F559,0xB55C74D5BB6E0D22C0dEBa450222D45B8153eBF1
5931,15627872,21000,8174715521,21000,0,2,57303,0x1b213D9d7FF0B1Fe5f6C41144D27ABEAc6A54359,0xCfC0F98f30742B6d880f90155d4EbB885e55aB33
5932,15627872,120000,8174715521,119392,608,138,96279,0xdAC17F958D2ee523a2206206994597C13D831ec7,0x14c4017f81675F7aC1321218d4a385a2D3117328
5933,15627872,120000,8174715521,119392,608,138,8450,0xdAC17F958D2ee523a2206206994597C13D831ec7,0xebc18d25d8122da21F73A6BcB78971671f21F6Ff
5934,15627872,120000,8174715521,119380,620,138,57304,0xdAC17F958D2ee523a2206206994597C13D831ec7,0xCfC0F98f30742B6d880f90155d4EbB885e55aB33
5935,15627872,55636,8173715521,54692,944,138,188,0xC02aaA39b223FE8D0A0e5C4F27eAD9083C756Cc2,0x6BfE59e8fEaDDfBdBb97F7Da8c6B4550a8bD4ffd
5936,15627872,51547,8173715521,50951,596,138,929,0x467719aD09025FcC6cF6F8311755809d45a5E5f3,0x770EDb43ECC5BCbE6f7088e1049fC42B2d1B195C
5937,15627872,157481,8173715521,155609,1872,842,525,0x7239F01C663f3c9fD7A44cB2BC8d19B67bdD1336,0xa8771fD60920f165Fb4E4CFCA2Cb1ab055f9ED53
5938,15627872,61547,8173715521,53271,8276,2514,1530,0x00000000006c3852cbEf3e08E8dF289169EdE581,0x27Ef8d1E586dE28A82fAfC30183c00982D8c73F3
5939,15627872,46267,8173715521,45691,576,74,97,0x283Af0B28c62C092C9727F1Ee09c02CA627EB7F5,0x9612948DDa9d8A62736e1D234cF86Cf76096e0c0
5940,15627872,73170,8173715521,72574,596,138,112,0xA0b86991c6218b36c1d19D4a2e9Eb0cE3606eB48,0x5Dc4bFC95024398d11366308300F6Fa7Db3a53ee
5941,15627872,383430,8173715521,375418,8012,1098,1787,0x000000000000509081d6FCD3ee63e791aD1db763,0x954021052072c6B6d8E1fEb5FA2C093CBA72a344
5942,15627872,200000,8173715521,199404,596,138,0,0xA0b86991c6218b36c1d19D4a2e9Eb0cE3606eB48,0xa51E7979A6679C14f45E0ddAd75adE4779683863
5943,15627872,72866,8173715521,71006,1860,458,106,0xFbdDaDD80fe7bda00B901FbAf73803F2238Ae655,0x17c852867106C351516D4ccC2bd5810D49B224B2
5944,15627872,527169,8173715521,499837,27332,8778,1859,0xaE9C73fd0Fd237c1c6f66FE009d24ce969e98704,0x97bDd734FcA8456dE0c98a7820f0F3907EF1BD83
5945,15627872,21000,8173715521,21000,0,2,152,0xd50d8df8f5aD747899B8b23fa0dC1c166c82dE12,0x4363A6EE36F9184b7f8CCDd1A737a79d69ff3F8D
5946,15627872,84961,8173715521,84757,204,74,204,0x55f1C36Bb7aE0d7D6caE97902E30A2306686Ec73,0x5bAB06Aab8aEcD0E60c8287391233F2285ad7071
5947,15627872,46267,8173715521,45691,576,74,347,0x283Af0B28c62C092C9727F1Ee09c02CA627EB7F5,0xd3AfEA7C924cBbFe8C3B514cefb6dbd505788Fa3
5948,15627872,166733,8173715521,160145,6588,1802,674,0x00000000006c3852cbEf3e08E8dF289169EdE581,0x99E8A13E77CEC29a3C64cEA54A82a53A22496917
5949,15627872,201752,8173715521,200064,1688,330,65,0x0f654cd49bEaB461084501c7f6bCC8702d5DF130,0x9fB5B74d61be3524AFC21c0d6c18BcD8ef6c05f6
5950,15627872,21000,8173715521,21000,0,2,247,0x2cF962479895De592aE1f1d338caED65949c99E1,0x7F9E6ED093a6c34726F9250320bfC50AdBC9fa82
5951,15627872,21000,8173715521,21000,0,2,663,0xbc201464494963C6504E98c8D30fAdfED818fF94,0xBCa5F00f856538dDFa1aC416221232fDbBb60f13
5952,15627872,163094,8173715521,162142,952,202,3483,0x0c2E57EFddbA8c768147D1fdF9176a0A6EBd5d83,0xC458e1a4eC03C5039fBF38221C54Be4e63731E2A
5953,15627872,60811,8173715521,53271,7540,2506,955,0x00000000006c3852cbEf3e08E8dF289169EdE581,0x20C3EDc13C70310B97f60419DBC68BD58219B59F
5954,15627872,21000,8173715521,21000,0,2,4,0x04C182bEA25660049Ea5241fbe36c8fAe1afA071,0x6eF314FE7C08Cb78D58Df1995dE6CdF2060435F9
5955,15627872,77463,8173715521,76795,668,138,15,0x111111111117dC0aa78b770fA6A738034120C302,0x4A7E25BF1A61f59c4F31BD7A2Ed11eb56348ad14
5956,15627872,79508,8173715521,77284,2224,586,50,0xCFbFaC74C26F8647cBDb8c5caf80BB5b32E43134,0xCD8F79C321807C14827e2f1D6F86Ff08c82c5fA0
5957,15627872,21000,8173715521,21000,0,2,26,0x0C7337c62a61d031e8DA71a419887Ea77a10f51e,0x764aB2911607F6E14497cEC5434687CAaD5E0cAE
5958,15627872,55897,8173715521,54953,944,138,36,0x0148015047923173cc1a4bC384D5CcC8b8B21a9C,0x59E0a840b22192a54E1c4DebFF9a90fbf34E6860
5959,15627872,27938,8173715521,27874,64,10,27,0xC02aaA39b223FE8D0A0e5C4F27eAD9083C756Cc2,0xFdFC25B88cd6C828cAd0866cAaE3ceEBCd725bA9
5960,15627872,142868,8173715521,136424,6444,1802,290,0x00000000006c3852cbEf3e08E8dF289169EdE581,0xf87D7673F19323daf4759E5A6e0cF658255BA63E
5961,15627872,21000,8173715521,21000,0,2,92,0xC97B83f31A3AF82FFAE7fEc5cbc8302306c9a191,0x128D2B740E9fDed3B56C81D2352Ce8a296336b77
5962,15627872,195483,8173715521,188855,6628,1810,763,0x00000000006c3852cbEf3e08E8dF289169EdE581,0x88E5FAE699aE1e31A25Df304CD20f1F6DaF8f5B5
5963,15627872,143289,8173715521,136689,6600,1802,72,0x00000000006c3852cbEf3e08E8dF289169EdE581,0x546367D801a949107A95Cd1D591C741078598fF3
5964,15627872,55984,8173715521,55040,944,138,489,0xB7c9E99Da8A857cE576A830A9c19312114d9dE02,0x04Aa48f7e1e5011FAAe6A19723ce79e5421f645c
5965,15627872,306246,8173715521,303886,2360,522,60,0x283Af0B28c62C092C9727F1Ee09c02CA627EB7F5,0x16869FdB8AdaD248330EBF7a1F19859Cecb491bE
5966,15627872,60739,8173715521,53271,7468,2506,188,0x00000000006c3852cbEf3e08E8dF289169EdE581,0x32d9E641035dF1129A37F6fA1d6962C62AF2e20d
5967,15627872,36015,8173715521,35751,264,74,672,0xC02aaA39b223FE8D0A0e5C4F27eAD9083C756Cc2,0x9829C7157889EE198cBc40208a8ABb29b3Ad2A2d
5968,15627872,59378,8173715521,52558,6820,2122,107,0x00000000006c3852cbEf3e08E8dF289169EdE581,0x625257BA5C717a532e2fB6e677d71A219E2f8d53
5969,15627872,71709,8173715521,69513,2196,458,440,0x74312363e45DCaBA76c59ec49a7Aa8A65a67EeD3,0x923b14ad2c5eCde9A549Ce11e3EeD4790B3766EA
5970,15627872,45399,8173715521,44447,952,202,400,0xC86664e7d2608f881f796ee8E24FA9d4d7598406,0x7D3E5dD617EAF4A3d42EA550C41097086605c4aF
5971,15627872,94795,8173715521,94199,596,138,1,0xdAC17F958D2ee523a2206206994597C13D831ec7,0x896220C8954C15546781078b6C77A6d858BC4D6d
5972,15627872,165795,8173715521,155215,10580,3402,1,0x00000000006c3852cbEf3e08E8dF289169EdE581,0x8Ffd896d92bB853DB153bc13446a6CFdca42b9c9
5973,15627872,45038,8173715521,44974,64,10,407,0xC02aaA39b223FE8D0A0e5C4F27eAD9083C756Cc2,0xef11Ff64b7CB7621a99fFeE16FcE1227fA5dc7BA
5974,15627872,280689,8173715521,274265,6424,1738,26,0x00000000006c3852cbEf3e08E8dF289169EdE581,0x06E5Db3CEc03BD20Cc1B560fEE9572E2E7F9Bc47
5975,15627872,734675,8173715521,728547,6128,2058,1382,0x67f57d9C4dc6fbEE423B15B6bBe488c3896AfBc3,0x33de5f7c0dcFfBbC399b603FF539250a2c132E3c
5976,15627872,149881,8173715521,143621,6260,1674,524,0x00000000006c3852cbEf3e08E8dF289169EdE581,0x67be0553cea5dc478098D96964E26adF31C24e01
5977,15627872,150756,8173715521,150692,64,10,1,0x65c2e54a4c75ff6da7b6B32369c1677250075fb2,0x332aA26630Ed7eE1DA279235D4179DD07f89d395
5978,15627872,119581,8173715521,107445,12136,2314,262,0x8B1631ab830d11531aE83725fDa4D86012eCCd77,0xAC465fF0D29d973A8D2Bae73DCF6404dD05Ae2c9
5979,15627872,67786,8173715521,66842,944,138,103,0x3D658390460295FB963f54dC0899cfb1c30776Df,0x29AFa8C4ceaE4E91695bdE9F0C280f729c5030FB
5980,15627872,46106,8173715521,45618,488,138,123,0x373fFDf2a50003fb7E10282cF50e03921828e1a7,0x6184F98F11C2b5631070Aab65f3E15E932FE4340
5981,15627872,199930,8173715521,193330,6600,1802,1,0x00000000006c3852cbEf3e08E8dF289169EdE581,0xd74A2d6D6F57a93d9815cB38dD73f32361C86D81
5982,15627872,175971,8173715521,173199,2772,842,113,0x68b3465833fb72A70ecDF485E0e4C7bD8665Fc45,0x3864e0699a3d50b734A2C801cf92CE2A8906Dc3a
5983,15627872,76984,8173715521,76388,596,138,35,0x083D41d6DD21EE938f0c055CA4fb12268DF0EfaC,0x03abBb58DfE52B58CaFd50239AB0606D8C2E1cAe
5984,15627872,190922,8173715521,187270,3652,1162,8,0x68b3465833fb72A70ecDF485E0e4C7bD8665Fc45,0x4270cd21614B026D7c6106d4E54893980da2BF7a
5985,15627872,27938,8173715521,27874,64,10,803,0xC02aaA39b223FE8D0A0e5C4F27eAD9083C756Cc2,0x90e984118aa0E7c8EbFf4e644C62cC8986ee6d17
5986,15627872,57322,8173715521,55582,1740,458,2496,0x495f947276749Ce646f68AC8c248420045cb7b5e,0x810657D67c68CF7299f7EcBc321b293ee064C5DF
5987,15627872,182882,8173715521,176126,6756,1802,0,0x00000000006c3852cbEf3e08E8dF289169EdE581,0xB73CE5a0A8CEcd2C89c48f786c05440F533cB406
5988,15627872,21000,8173715521,21000,0,2,17,0x6d7062d828af8F6Fec628B2d5e1384EeA88aAcCa,0xf48E977751858e37912Ff443c6F4F3cd5057A3A6
5989,15627872,224854,8173715521,222106,2748,842,128,0x68b3465833fb72A70ecDF485E0e4C7bD8665Fc45,0xFc30c771c795b4d23A44B861d91A542365f21e33
5990,15627872,36003,8173715521,35751,252,74,723,0xC02aaA39b223FE8D0A0e5C4F27eAD9083C756Cc2,0x6393Ea33B25528D50Df724460C4465187EAd1403
5991,15627872,347850,8173715521,344222,3628,1162,41,0x68b3465833fb72A70ecDF485E0e4C7bD8665Fc45,0x3394D05981B19208FD2c9e968ee8f402d1712622
5992,15627872,222084,8173715521,218516,3568,1162,37,0x68b3465833fb72A70ecDF485E0e4C7bD8665Fc45,0x59E0a840b22192a54E1c4DebFF9a90fbf34E6860
5993,15627872,46270,8173715521,45698,572,138,1268,0xbaf13560F86d65E7a3b982BFC8838791CBc8f3af,0x7c03C6FC64293c460bE652F4015aD232E695aC8e
5994,15627872,204792,8173715521,203572,1220,330,162,0x26FC1f11E612366d3367fc0cbFfF9e819da91C8d,0x618BAfB947e11955DB7aa4473809eA739253f6E9
5995,15627872,405274,8173715521,401646,3628,1162,1206,0x68b3465833fb72A70ecDF485E0e4C7bD8665Fc45,0x083c48E7021E8177E86B4Aa323022241867fa693
5996,15627872,46076,8173715521,45588,488,138,699,0x57f1887a8BF19b14fC0dF6Fd9B2acc9Af147eA85,0x7C741eD01EE259fEBa4B7F9CaC114F48bCAfACf3
5997,15627872,288174,8173715521,285838,2336,522,940,0x283Af0B28c62C092C9727F1Ee09c02CA627EB7F5,0x0af691F5533C2d1FBeca5Cb86705307f225F8bd3
5998,15627872,21000,8000000000,21000,0,2,125,0x3D49B36Ba897ba8693c3A86834c5906a07bf1a0B,0x12c7D85153656bBF835a5F8bAd7eAa0d29b7a468
5999,15627872,21000,8000000000,21000,0,2,85,0x3D49B36Ba897ba8693c3A86834c5906a07bf1a0B,0xf9656E4CbE52b3524D80eb59d2774141725f57Ef
6000,15627872,21000,8000000000,21000,0,2,178,0x3D49B36Ba897ba8693c3A86834c5906a07bf1a0B,0x404e9cf95f3d511C61b2818188bDcd869fF8f227
6001,15627872,21000,8000000000,21000,0,2,41,0x3D49B36Ba897ba8693c3A86834c5906a07bf1a0B,0x7E1be5206Ad034166a6c580341b7Bed88F7A4903
6002,15627872,21000,8000000000,21000,0,2,150,0x3D49B36Ba897ba8693c3A86834c5906a07bf1a0B,0x657EeFA1c1e92D2c96552f2dE66Dd19a1651fab4
6003,15627872,21000,8000000000,21000,0,2,82,0x3D49B36Ba897ba8693c3A86834c5906a07bf1a0B,0x4d3E565f3c46311d841480E279f7619F7D6CCf94
6004,15627872,21000,8000000000,21000,0,2,50,0x3D49B36Ba897ba8693c3A86834c5906a07bf1a0B,0x8135aF04E84d286B2E39F918E41BA98DB4260d3B
6005,15627872,21000,8000000000,21000,0,2,75,0x3D49B36Ba897ba8693c3A86834c5906a07bf1a0B,0x6a66f6fB8F90ee5cA59d5968a697d9E9831603F8
6006,15627872,21000,8000000000,21000,0,2,133,0x3D49B36Ba897ba8693c3A86834c5906a07bf1a0B,0x1ce1c81169aD21c6c708F9dd5FAF194312F96a33
6007,15627872,21000,8000000000,21000,0,2,55,0x3D49B36Ba897ba8693c3A86834c5906a07bf1a0B,0xD1dDe40d4935f72168153b81e3A232Dc5dF49212
6008,15627872,21000,8000000000,21000,0,2,140,0x3D49B36Ba897ba8693c3A86834c5906a07bf1a0B,0x21B66365dD941f108dd0b5f8c50Ec3B444Bb9fc0
6009,15627872,21000,8000000000,21000,0,2,80,0x3D49B36Ba897ba8693c3A86834c5906a07bf1a0B,0xbe7A15891E80ce89a92B78391d67d5E1d7c12Feb
6010,15627872,21000,8000000000,21000,0,2,34,0x3D49B36Ba897ba8693c3A86834c5906a07bf1a0B,0xB4a2ad0Cf40d7492eE8DECaDF7d7c54a27E301ad
6011,15627872,21000,8000000000,21000,0,2,79,0x3D49B36Ba897ba8693c3A86834c5906a07bf1a0B,0xAa93082778c267A84Ba17223FB9F3B847Bc212F6
6012,15627872,21000,8000000000,21000,0,2,169,0x3D49B36Ba897ba8693c3A86834c5906a07bf1a0B,0xf2d0827cfa73586622b4792A05C54cE93415128F
6013,15627872,21000,8000000000,21000,0,2,50,0x3D49B36Ba897ba8693c3A86834c5906a07bf1a0B,0x8e6f7AafDAe237ca7b41B3C09F2991BcbD409D15
6014,15627872,21000,8000000000,21000,0,2,104,0x3D49B36Ba897ba8693c3A86834c5906a07bf1a0B,0xa101310c57587CCe39f121DD984C982BFD2aa1fC
6015,15627872,21000,8000000000,21000,0,2,84,0x3D49B36Ba897ba8693c3A86834c5906a07bf1a0B,0xDE9A55f002E4B2022cc36a005376f8E4dC696ed7
6016,15627872,21000,8000000000,21000,0,2,135,0x3D49B36Ba897ba8693c3A86834c5906a07bf1a0B,0x95EB9649e6464C11a7A670f95240f15B2956061F
6017,15627872,21000,8000000000,21000,0,2,271,0x3D49B36Ba897ba8693c3A86834c5906a07bf1a0B,0x8453C13fCe49Eb243eFFAE9701E60bDB8F23e5B7
6018,15627872,21000,8000000000,21000,0,2,79,0x3D49B36Ba897ba8693c3A86834c5906a07bf1a0B,0xCd1402D61DAcF080500Ede1bE46e0Fe64f8183bF
6019,15627872,21000,8000000000,21000,0,2,372,0x3D49B36Ba897ba8693c3A86834c5906a07bf1a0B,0x7FcBDfE0c23835cE13e11b1E126d5ce67685125C
6020,15627872,21000,8000000000,21000,0,2,136,0x3D49B36Ba897ba8693c3A86834c5906a07bf1a0B,0x2f387e9d19E033032A269Bbafd2E409813BdD1DD
6021,15627872,21000,8000000000,21000,0,2,74,0x3D49B36Ba897ba8693c3A86834c5906a07bf1a0B,0xb745D76e06514C3442540AA1EF49e8b182298087
6022,15627872,21000,8000000000,21000,0,2,71,0x3D49B36Ba897ba8693c3A86834c5906a07bf1a0B,0x25b6Fb8F67955F019710e24EDDd21B5ADBA0FE97
6023,15627872,21000,8000000000,21000,0,2,121,0x3D49B36Ba897ba8693c3A86834c5906a07bf1a0B,0x29BE329A1736edEe75B47560b781B81D6d4D2024
6024,15627872,21000,8000000000,21000,0,2,389,0x3D49B36Ba897ba8693c3A86834c5906a07bf1a0B,0x7d34711b3b65ed77A56df0801b5e27Fc7D4e609C
6025,15627872,21000,8000000000,21000,0,2,29,0x3D49B36Ba897ba8693c3A86834c5906a07bf1a0B,0x2f258952415fD2C88C4AC85A39087ab2aD0C0D50
6026,15627872,21000,8000000000,21000,0,2,28,0x3D49B36Ba897ba8693c3A86834c5906a07bf1a0B,0x2B002EfdE31A231B6Dfc823c61C46A4f873066A9
6027,15627872,21000,8000000000,21000,0,2,63,0x3D49B36Ba897ba8693c3A86834c5906a07bf1a0B,0xb7282D05E8Cd298Aca46E7481F691a879368E0Df
6028,15627872,21000,8000000000,21000,0,2,72,0x3D49B36Ba897ba8693c3A86834c5906a07bf1a0B,0x265723d5c4BB2fA51b46AF403671921a97D1479f
6029,15627872,21000,8000000000,21000,0,2,78,0x3D49B36Ba897ba8693c3A86834c5906a07bf1a0B,0x7462fc81E3A231206abBCde53E376b004A64AfA4
6030,15627872,21000,8000000000,21000,0,2,66,0x3D49B36Ba897ba8693c3A86834c5906a07bf1a0B,0x160CDBeE3c7B2A7D54b27bcB48171Db30109CA46
6031,15627872,21000,8000000000,21000,0,2,34,0x3D49B36Ba897ba8693c3A86834c5906a07bf1a0B,0x3A5C0fFEA8B67b1967f2395B99703AC411617b69
6032,15627872,21000,8000000000,21000,0,2,78,0x3D49B36Ba897ba8693c3A86834c5906a07bf1a0B,0x599d2a7AFd5eB65E53E78782f4E249D9F388176a
6033,15627872,21000,8000000000,21000,0,2,103,0x3D49B36Ba897ba8693c3A86834c5906a07bf1a0B,0xa40FA1449445F06632D4C2F0978F17331D66a237
6034,15627872,21000,8000000000,21000,0,2,81,0x3D49B36Ba897ba8693c3A86834c5906a07bf1a0B,0xD12b3F62908e778651a7D9eB50F685cf77EE633d
6035,15627872,21000,8000000000,21000,0,2,83,0x3D49B36Ba897ba8693c3A86834c5906a07bf1a0B,0x7d0FB017f17403CEf6eC45F72B8EEB49DA634019
6036,15627872,21000,8000000000,21000,0,2,100,0x3D49B36Ba897ba8693c3A86834c5906a07bf1a0B,0xb1454fb42F1F2139E09A225F5f978D2BeE749bdF
6037,15627872,21000,8000000000,21000,0,2,40,0x3D49B36Ba897ba8693c3A86834c5906a07bf1a0B,0x93e8bd9Df187C32f3DCC5a458348aae9D82670b2
6038,15627872,21000,8000000000,21000,0,2,72,0x3D49B36Ba897ba8693c3A86834c5906a07bf1a0B,0x49784E206410e590572005934FaC4270a80cfE08
6039,15627872,21000,8000000000,21000,0,2,95,0x3D49B36Ba897ba8693c3A86834c5906a07bf1a0B,0x044FFC22BED8c00a1e865aB5A069Db647fe74F5C
6040,15627872,21000,8000000000,21000,0,2,76,0x3D49B36Ba897ba8693c3A86834c5906a07bf1a0B,0xC0a3Ff075A2C0Ca59c845DD9271Dd44c2B4A9c59
6041,15627872,21000,8000000000,21000,0,2,76,0x3D49B36Ba897ba8693c3A86834c5906a07bf1a0B,0x3895e61c6e52be59763e62cF0bE1a359B88aaed4
6042,15627872,21000,8000000000,21000,0,2,79,0x3D49B36Ba897ba8693c3A86834c5906a07bf1a0B,0x227cc0Dfa21CF6Af7fd472C7ee76c339c378C34E
6043,15627872,21000,8000000000,21000,0,2,75,0x3D49B36Ba897ba8693c3A86834c5906a07bf1a0B,0x3C5fA3Ce1914Ab22630C80F36081B4F9996F9849
6044,15627872,21000,8000000000,21000,0,2,77,0x3D49B36Ba897ba8693c3A86834c5906a07bf1a0B,0x5Bc2695CbFE3c8a5b41cAAFB6c9b19ECa9C0b468
6045,15627872,21000,8000000000,21000,0,2,73,0x3D49B36Ba897ba8693c3A86834c5906a07bf1a0B,0x2BB1Ac5f70Cf0cEE238a35336c105FC88321652d
6046,15627872,21000,8000000000,21000,0,2,99,0x3D49B36Ba897ba8693c3A86834c5906a07bf1a0B,0x4114b04638F02f120e4Db5e5C7D326057C916155
6047,15627872,66097,7984752916,65501,596,138,0,0xdAC17F958D2ee523a2206206994597C13D831ec7,0xeC0b1311ef6ECF5baa07133FC0c542d90B380807
6048,15627872,66097,7984752916,65501,596,138,0,0xdAC17F958D2ee523a2206206994597C13D831ec7,0x72899F655f7c71F6e664CAa9A346a2cd83847f7C
6049,15627872,479277,7929440355,458365,20912,6738,538,0x1111111254fb6c44bAC0beD2854e76F90643097d,0xa57C927dF5b836D203560A5B568aF75831939Eed
6050,15627872,300229,7883717721,295329,4900,1420,5158,0x881D40237659C251811CEC9c364ef91dC08D300C,0x3b17e0beC7d1a0348410F7706c5E775b029Bd875
6051,15627872,21000,7808872635,21000,0,2,68,0x912fD21d7a69678227fE6d08C64222Db41477bA0,0xf6a7c1D8dF3B2f32775a9886EA496f3B54E75436
6052,15627872,113310,7673715521,113106,204,74,357,0x5D004ddB5D92938dAF8448b9eac1CaA593cd26Ca,0x26DC5D39Bd7A8bc2d792dcAAAC55FE6DCef25593
6053,15627872,113310,7673715521,113106,204,74,358,0x5D004ddB5D92938dAF8448b9eac1CaA593cd26Ca,0x26DC5D39Bd7A8bc2d792dcAAAC55FE6DCef25593
6054,15627872,192685,7673715521,185869,6816,1802,648,0x00000000006c3852cbEf3e08E8dF289169EdE581,0xB4FE3483b8b094241215Ca7467C7F06ca5aF598F
6055,15627872,113310,7673715521,113106,204,74,359,0x5D004ddB5D92938dAF8448b9eac1CaA593cd26Ca,0x26DC5D39Bd7A8bc2d792dcAAAC55FE6DCef25593
6056,15627872,188870,7673715521,186098,2772,842,51,0x68b3465833fb72A70ecDF485E0e4C7bD8665Fc45,0x4D84fA2Ff21E328080930565Ecaeca6FE52E6ee5
6057,15627872,113310,7673715521,113106,204,74,360,0x5D004ddB5D92938dAF8448b9eac1CaA593cd26Ca,0x26DC5D39Bd7A8bc2d792dcAAAC55FE6DCef25593
6058,15627872,150756,7673715521,150692,64,10,2,0x65c2e54a4c75ff6da7b6B32369c1677250075fb2,0x74C0566816e426a92B03DAB83c1dB3960a022Dfa
6059,15627872,181476,7673715521,179912,1564,394,109,0x1Fa8559e873f698292766790AeCf8080A66433F6,0x7E3E8E243BD07918F996F7c42AA0B14Fb7dFE0C5
6060,15627872,113310,7673715521,113106,204,74,361,0x5D004ddB5D92938dAF8448b9eac1CaA593cd26Ca,0x26DC5D39Bd7A8bc2d792dcAAAC55FE6DCef25593
6061,15627872,200000,7673715521,199404,596,138,0,0xA0b86991c6218b36c1d19D4a2e9Eb0cE3606eB48,0x1203a61d05B99b0c3D3A93CBF7CA6c4dCC686510
6062,15627872,56902,7673715521,56838,64,10,15,0xB092Ec81F41c619EEa434357477ea8A4b1455755,0xea7e049c3dB1BFEAFE8D801334ce770F8426c0E8
6063,15627872,113310,7673715521,113106,204,74,362,0x5D004ddB5D92938dAF8448b9eac1CaA593cd26Ca,0x26DC5D39Bd7A8bc2d792dcAAAC55FE6DCef25593
6064,15627872,213123,7673715521,212627,496,202,388,0x3864b787e498BF89eDFf0ED6258393D4CF462855,0x0F615319D7CeeD5801faF6b13C9034DE9223a3eC
6065,15627872,113310,7673715521,113106,204,74,363,0x5D004ddB5D92938dAF8448b9eac1CaA593cd26Ca,0x26DC5D39Bd7A8bc2d792dcAAAC55FE6DCef25593
6066,15627872,206871,7673715521,203631,3240,1034,94,0x68b3465833fb72A70ecDF485E0e4C7bD8665Fc45,0xa53014Ef4bBBE76cB30C0D183B300F9550b14cAC
6067,15627872,113310,7673715521,113106,204,74,364,0x5D004ddB5D92938dAF8448b9eac1CaA593cd26Ca,0x26DC5D39Bd7A8bc2d792dcAAAC55FE6DCef25593
6068,15627872,181458,7673715521,179906,1552,394,109,0x1Fa8559e873f698292766790AeCf8080A66433F6,0x11A490dC9E53000aC7918b59734B4220266DbA51
6069,15627872,142090,7673715521,137426,4664,1290,0,0x20F780A973856B93f63670377900C1d2a50a77c4,0x776eF9896CA7984EE3f713219FA4dD92c160bCe1
6070,15627872,181476,7673715521,179912,1564,394,1048,0x1Fa8559e873f698292766790AeCf8080A66433F6,0xb142AC3a305df594F44D518Fd2B504da2B6Af6Fb
6071,15627872,678424,7673715521,678092,332,138,767,0x64cff2e42ea7f2283c31Ba6d108a4038454168b5,0xB4cEF3CA34db5A5ea3116dcd924d318bCbD7Ad17
6072,15627872,21000,7673715521,21000,0,2,57,0x94c6872683E03D44eA5D22fD48E33f525Ca6F818,0x79199bba2593bf4D3C8c1b39E32a666AF9C22Def
6073,15627872,181440,7673715521,179900,1540,394,4544,0x1Fa8559e873f698292766790AeCf8080A66433F6,0x4233C93649444871FdB2a5bB63ab548F41E9a71f
6074,15627872,181458,7673715521,179906,1552,394,3,0x1Fa8559e873f698292766790AeCf8080A66433F6,0x64d692BD809a758015f30075247126176dac86A8
6075,15627872,21000,7673715521,21000,0,2,37,0x5D7876BDF88c0dbF241C5d62DB344C1332288513,0x6eAa07E433a6911328c85b34C89F2a9E8d22F08a
6076,15627872,181476,7673715521,179912,1564,394,5,0x1Fa8559e873f698292766790AeCf8080A66433F6,0x5CCFe5Cf56Efb67BF960ec0A73296476906E1E14
6077,15627872,181458,7673715521,179906,1552,394,141,0x1Fa8559e873f698292766790AeCf8080A66433F6,0x3a87d39577dd1c9D39e570FCc27F78Bdfd00130d
6078,15627872,21000,7673715521,21000,0,2,22,0x4afd5Bf70bb7487c9F3ff9FB2e72fF306dDA73Fc,0x0d2cAD56e15aEd87a2bBc56ef17Db89793a75A85
6079,15627872,178398,7673715521,178194,204,74,2356,0x645E9324f4be25be581BB62163cfa86c40b01D07,0xc5009AFEd2D6DA219538aD165998F63B553185B1
6080,15627872,191221,7673715521,190225,996,266,213,0xd588b586D61C826A0e87919b3D1a239206d58bf2,0xde499CC69295e266DcA857ab4DF0Bc6A22a99142
6081,15627872,181476,7673715521,179912,1564,394,122,0x1Fa8559e873f698292766790AeCf8080A66433F6,0xE2afECD496F1423D6276F166F613C979A6e7afa6
6082,15627872,400000,7673715521,398000,2000,522,707,0x7a250d5630B4cF539739dF2C5dAcb4c659F2488D,0x006C343A305570239b62d2865A5e48144055eCfe
6083,15627872,55978,7639657701,55034,944,138,353,0x32F19B8c25333bF68FaCe58041858f185c17CF74,0xaFFB9c721f4d266525CE655a87009f7015FbA7F5
6084,15627872,400000,7555513055,398848,1152,266,1689,0x77e28Df59411d635f2bE0B9e89499A136295e67c,0xc7a894EB2f1C34CB5f1Ae88af795FdE1CE3dD187
6085,15627872,248929,7408345878,246145,2784,842,108,0x68b3465833fb72A70ecDF485E0e4C7bD8665Fc45,0x957e185cC1a2451E84109D5AAB815ffEdE9F5903
6086,15627872,54024,7389434832,53536,488,138,381,0x7f8C5954e8E231e211578703024732616F9527EA,0x12F413972cca9075Bd6c9A7bB138BD2AF1770703
6087,15627872,21000,7389434832,21000,0,2,44,0xFDA97E87e7A89fe864Bb0017BCeEB66Ef9432A4a,0xF41D156A9bbc1FA6172a50002060cBc757035385
6088,15627872,373963,7389434832,370299,3664,970,950,0x68b3465833fb72A70ecDF485E0e4C7bD8665Fc45,0x2af76ca7b4dbC1Afb3b4367bf217b75Cbd19230d
6089,15627872,21000,7313715521,21000,0,2,26,0x069674D9392230aa29A5B61F02E5E214a2105Cc3,0x133d9002713C3cC29Cafd812a4D39e5938Ed30b2
6090,15627872,223618,7267430714,220846,2772,842,35,0x68b3465833fb72A70ecDF485E0e4C7bD8665Fc45,0xcEA2B5aaE34Dbd6932fD266FdF490b2aC70fd96C
6091,15627872,80000,7267430714,79056,944,138,0,0x95aD61b0a150d79219dCF64E1E6Cc01f0B64C4cE,0xf5Fd5A4d764EB9e9746fd9283525eC54Eb7eC5C5
6092,15627872,80000,7267430714,79056,944,138,0,0xdAC17F958D2ee523a2206206994597C13D831ec7,0x4EC193bC8b7aEb0f3267Efd5D42c1e41277877Bb
6093,15627872,45228,7267430714,44204,1024,202,890834,0x0763fdCCF1aE541A5961815C0872A8c5Bc6DE4d7,0x340d693ED55d7bA167D184ea76Ea2Fd092a35BDc
6094,15627872,70000,7267430714,69056,944,138,9,0xdAC17F958D2ee523a2206206994597C13D831ec7,0xBc2eF17D0243b9ddeeaB5C5C5E06E71c40f36313
6095,15627872,21000,7267430714,21000,0,2,191,0x974CaA59e49682CdA0AD2bbe82983419A2ECC400,0x983e384F4579582D1fA58B423dd238626CdE7cA1
6096,15627872,90000,7267430714,89568,432,74,4,0xaBEA9132b05A70803a4E85094fD0e1800777fBEF,0xf3e0986733Db9a0F4c1552c50a2762b45010D508
6097,15627872,69826,7179119043,68882,944,138,26,0x95aD61b0a150d79219dCF64E1E6Cc01f0B64C4cE,0x32Aa23c483904e03751d317B37adA87B0E2036d0
6098,15627872,70915,7179119043,69971,944,138,25,0xCE3f08e664693ca792caCE4af1364D5e220827B2,0xdAC4F2FAE6e4828322696DD7bfBb6E4148C9569E
6099,15627872,150756,7179119043,150692,64,10,3,0x65c2e54a4c75ff6da7b6B32369c1677250075fb2,0xB4c5AFf8B16Df3fA0fb5357C48e6011683Efe492
6100,15627872,57262,7061836668,56286,976,202,890835,0xA0b86991c6218b36c1d19D4a2e9Eb0cE3606eB48,0x340d693ED55d7bA167D184ea76Ea2Fd092a35BDc
6101,15627872,105000,7061836668,105000,0,2,138569,0xF610E4B9DDb52a1d12052861A8B8ceA733f20496,0x974CaA59e49682CdA0AD2bbe82983419A2ECC400
6102,15627872,105000,7326619434,105000,0,2,138570,0x401982cbe24F6eeEab77C463D5BE0FC4c986bE1b,0x974CaA59e49682CdA0AD2bbe82983419A2ECC400
6103,15627872,57849,7061836668,56825,1024,202,890836,0x4Fabb145d64652a948d72533023f6E7A623C7C53,0x340d693ED55d7bA167D184ea76Ea2Fd092a35BDc
6104,15627872,21000,7061836668,21000,0,2,71,0x974CaA59e49682CdA0AD2bbe82983419A2ECC400,0x38caC02fa366bA22de30A375696b1f35850A3EfC
6105,15627872,70000,7061836668,69056,944,138,10,0xdAC17F958D2ee523a2206206994597C13D831ec7,0xBc2eF17D0243b9ddeeaB5C5C5E06E71c40f36313
6106,15627872,191077,7061836668,190177,900,266,87,0xd588b586D61C826A0e87919b3D1a239206d58bf2,0x710E29C9c3bD8904Eb3d993b05E1bE418Bc715aa
6107,15627872,21000,7061836668,21000,0,2,0,0x3B794929566e3Ba0f25e4263e1987828b5c87161,0x05752F3c28Fd91C027a216F57b05B774E32957B4
6108,15627872,258274,6912998732,256674,1600,286,1862,0x0000000000304a767881fDcCB30FCEB51f6221e2,0x5174DEdC36695F1593C527F7C1B6486b6d6a8120
6109,15627872,3451109,6873926985,3449105,2004,650,2196,0xADb5401CB913a78d0bA161C1Af66Ac35243b6d1c,0xD7924a51Ad327Fd8B3F680F5CC74BD66Ba784a88
6110,15627872,65000,6866903957,64404,596,138,157060,0xdAC17F958D2ee523a2206206994597C13D831ec7,0x8C8D7C46219D9205f056f28fee5950aD564d7465
6111,15627872,357735,6866903957,163311,194424,24470,183248,0x5E4e65926BA27467555EB562121fac00D24E9dD2,0x6887246668a3b87F54DeB3b94Ba47a6f63F32985
6112,15627872,342070,6673715521,339082,2988,650,22033,0x91000060399502550000007bbfBA0052F47B008A,0x0000e0C70000ca6bc5006838e7cc3e7C8fD23D00
6113,15627872,21000,6758567029,21000,0,2,0,0x910b136BA3BFD201F2D7CbF6Fe7573E1bC46C317,0x09E8D26358895760aDE1B673BA332589170fca13
6114,15627872,21000,6758567029,21000,0,2,1,0x1DDFf575310a762939b15BD73264C61cDadD5694,0x09E8D26358895760aDE1B673BA332589170fca13
6115,15627872,21000,6758567029,21000,0,2,2,0xc8CB2c691CAe725214547D0378890E57c24340ac,0x09E8D26358895760aDE1B673BA332589170fca13
6116,15627872,26000,6673715521,26000,0,2,12027,0xADaE1798F761Fa7fce29B6673D453d1a48A2931A,0xDAFEA492D9c6733ae3d56b7Ed1ADB60692c98Bc5
6117,15627873,21000,31766034202,21000,0,2,0,0x96Db3ab394c0af77c857ec8b4012a73aBb38f7Bc,0x728e8c5Cca0f12257D552BA3D5D00214aF174a88
6118,15627873,800000,20178692772,798836,1164,266,53278,0x96D4F9d8F23eadee78fc6824fc60b8c1CE578443,0x7b9d4D8772b8705dDc7456Daf821c3022DDa0504
6119,15627873,1000000,19178692772,998152,1848,458,7539,0xd9e1cE17f2641f24aE83637ab66a2cca9C378B9F,0x759Ec1b3326de6Fd4Ba316F65A6F689c4e4C3092
6120,15627873,524233,19178692772,521945,2288,390,26584,0xC8046263d5B5544F6413a98B4693488499195A46,0xEf5a3745F822f8F83693564c54904d7FF156CFb2
6121,15627873,523657,19178692772,516041,7616,1524,105723,0x0000000000007F150Bd6f54c40A34d7C3d5e9f56,0x60530f5Ca4CB9907e0FBE67cA3AFCbFE56D19A5c
6122,15627873,10000020,19178692772,9992180,7840,2506,4002,0xc2A54F74EbbBba5ed92d6a0B5dcB0B0FFB96F36e,0x443dff63C2634Ac5EF5aA5bFbd194A503c734de4
6123,15627873,2500000,19178692772,2492160,7840,2506,330,0x9ac549fe3f83D4d599A61619135383ffC7B657ae,0x941c9088db081ddfd00672157B800e57dd06E497
6124,15627873,313629,19178692772,308677,4952,1674,39471,0x7Ed7382D0EcfeE9Bf1085671CCe4b0A5774a6E89,0x79b7a69d90c82E014Bf0315e164208119B510FA0
6125,15627873,77832,17000000000,77164,668,138,2188235,0x295B42684F90c77DA7ea46336001010F2791Ec8c,0x75e89d5979E4f6Fba9F97c104c2F0AFB3F1dcB88
6126,15627873,77484,17000000000,76804,680,138,2188236,0x1E4EDE388cbc9F4b5c79681B7f94d36a11ABEBC9,0x75e89d5979E4f6Fba9F97c104c2F0AFB3F1dcB88
6127,15627873,77356,17000000000,76736,620,138,2188237,0x467719aD09025FcC6cF6F8311755809d45a5E5f3,0x75e89d5979E4f6Fba9F97c104c2F0AFB3F1dcB88
6128,15627873,77356,17000000000,76748,608,138,2188238,0x467719aD09025FcC6cF6F8311755809d45a5E5f3,0x75e89d5979E4f6Fba9F97c104c2F0AFB3F1dcB88
6129,15627873,74969,13100000000,74361,608,138,0,0xdAC17F958D2ee523a2206206994597C13D831ec7,0x99F69FC3e23DE8246639a20aBa48F709Cb2835F5
6130,15627873,257774,12517225977,255458,2316,650,116841,0xA69babEF1cA67A37Ffaf7a485DfFF3382056e78C,0x6046945C5B5eF5933b8E73a98A6AD7bF3e031df7
6131,15627873,222222,12000000000,220658,1564,394,154,0x1Fa8559e873f698292766790AeCf8080A66433F6,0xA8490De8E5F43EC8B1bDDAA82421dd24799C5ad4
6132,15627873,193760,11582692773,192164,1596,230,2273,0x9507c04B10486547584C37bCBd931B2a4FeE9A41,0x5D809525a9A1C4BEF5FeF0cEfa8269048e7d8DDE
6133,15627873,21000,10826691320,21000,0,2,1569063,0x8F2B3A434B746c55c5dba065d58C69c4dE35b161,0xAe45a8240147E6179ec7c9f92c5A18F9a97B3fCA
6134,15627873,21000,10826691320,21000,0,2,1569064,0x4A4d0975fC1064C0eB8C67E4819863A0386724A4,0xAe45a8240147E6179ec7c9f92c5A18F9a97B3fCA
6135,15627873,21000,10826691320,21000,0,2,1569065,0x6918796Da11589dA97e68adF441c6EDe40F494ea,0xAe45a8240147E6179ec7c9f92c5A18F9a97B3fCA
6136,15627873,60000,10826691320,59392,608,138,1,0xdAC17F958D2ee523a2206206994597C13D831ec7,0x9D4A2F18FeAfd33A1253b2Ea576BDcd7E64CF38C
6137,15627873,35000,10826691320,35000,0,2,1,0x7758E507850dA48cd47df1fB5F875c23E3340c50,0xA9bFf6AfA8A50bD9121796e84B6303bFc6806694
6138,15627873,60000,10826691320,59392,608,138,11,0xA0b86991c6218b36c1d19D4a2e9Eb0cE3606eB48,0x1845f2Ed09A6703BB012bCEb1Cac594D37E6C412
6139,15627873,60000,10826691320,59404,596,138,7,0xA0b86991c6218b36c1d19D4a2e9Eb0cE3606eB48,0x7Fc63D968908d1DAE98B22C86Ec39774e470be4e
6140,15627873,60000,10826691320,59392,608,138,0,0xdAC17F958D2ee523a2206206994597C13D831ec7,0x1c00b0Eeb45a385fF0e317041d015b1963b000E5
6141,15627873,60000,10826691320,59392,608,138,2,0xdAC17F958D2ee523a2206206994597C13D831ec7,0xEa4406222b8AaF64FD9cFB885b6404a46E175119
6142,15627873,21000,10103833351,21000,0,2,57,0x2E635F2d63a22F4bC8456bb0d5C2de8E0196d7f0,0x137375FeB18ba2BA491406c691Ccf5D5fBea2602
6143,15627873,305899,9678692772,298923,6976,970,1560,0x9b3B6974531d8AA15A87908FFd821A64863Ede5B,0xc3dA3c9F9f9da324748f61833AbA979533d16D50
6144,15627873,169218,9628692772,167370,1848,458,258,0x7a250d5630B4cF539739dF2C5dAcb4c659F2488D,0xe6D3D38195499D1932d05a3121F5b1Be96AB1eBE
6145,15627873,55904,9628692772,54960,944,138,259,0x011b0beAe3eC5953B4805b064cC78f6F892A99cC,0xe6D3D38195499D1932d05a3121F5b1Be96AB1eBE
6146,15627873,50000,9524605264,50000,0,2,1210289,0xFFCEB83767b7BFffA53c65198f1aafF27165ee09,0x912fD21d7a69678227fE6d08C64222Db41477bA0
6147,15627873,50000,9179692772,50000,0,2,57396,0x19ea1233cf4626d90f0ed75D64711ff63bc9eCE6,0x60F9e80D0D40b2958ac39006635dE782096866C3
6148,15627873,85000,9178692772,84512,488,138,127,0xD27dcbcC8778a8AB33AAc529Df36a634567Be325,0xC49B45185d123A19980F48C9De728436d711f1e4
6149,15627873,201992,9178692772,196212,5780,1170,2260,0xDef1C0ded9bec7F1a1670819833240f027b25EfF,0x22c45Fb52C9EF7bfaff34a0DAf4ec9C361bBbE17
6150,15627873,92151,9178692772,92087,64,10,1625,0x4Dbd4fc535Ac27206064B68FfCf827b0A60BAB3f,0x55684b89adF372CC3091975633bD7128da3a46Bc
6151,15627873,227644,9178692772,224896,2748,842,186,0x68b3465833fb72A70ecDF485E0e4C7bD8665Fc45,0xb1e294784c75477333EA54C04D7DAb611fF76Dc9
6152,15627873,181458,9178692772,179906,1552,394,441,0x1Fa8559e873f698292766790AeCf8080A66433F6,0x7870A3B083752D8F9a79AA78E35D4105120C4174
6153,15627873,191077,9178692772,190177,900,266,591,0xd588b586D61C826A0e87919b3D1a239206d58bf2,0x66298837Aa0079C0D1a4ff7549F2Aac8A79c383e
6154,15627873,2000000,9178692772,1993800,6200,1482,171046,0xA9D1e08C7793af67e9d92fe308d5697FB81d3E43,0x7830c87C02e56AFf27FA8Ab1241711331FA86F43
6155,15627873,2000000,9178692772,1994860,5140,1162,171047,0xA9D1e08C7793af67e9d92fe308d5697FB81d3E43,0x7830c87C02e56AFf27FA8Ab1241711331FA86F43
6156,15627873,207128,9178692772,207128,0,2,1312154,0x3f82cf523083b1d82e6407F88764fA4BE95b84C1,0xf60c2Ea62EDBfE808163751DD0d8693DCb30019c
6157,15627873,21000,9178692772,21000,0,2,2759944,0x8C23F72143D2a32C59edF2b02925D279d2e6642F,0x267be1C1D684F78cb4F6a176C4911b741E4Ffdc0
6158,15627873,21000,9178692772,21000,0,2,8265755,0xAB2D3C7ed45933caBac50b27c3281FEED4b4e969,0xb5d85CBf7cB3EE0D56b3bB207D5Fc4B82f43F511
6159,15627873,21000,9178692772,21000,0,2,6578035,0x47E386410EA0e969229878F91EF76e11CAFfC77E,0xeB2629a2734e272Bcc07BDA959863f316F4bD4Cf
6160,15627873,21000,9178692772,21000,0,2,1228778,0xB2d686F4957C22d659D2c3480F8263C37B00E8f7,0x71660c4005BA85c37ccec55d0C4493E66Fe775d3
6161,15627873,21000,9178692772,21000,0,2,7100802,0x5eFE8F41011CC82a9BADea329052A56B1bD97282,0xddfAbCdc4D8FfC6d5beaf154f18B778f892A0740
6162,15627873,21000,9178692772,21000,0,2,1783207,0x3C06d8A7Ea5659a122C54faa41aEA1De2AE9df50,0x503828976D22510aad0201ac7EC88293211D23Da
6163,15627873,21000,9178692772,21000,0,2,34,0xF7be43c8a3d2d7e098594fA9920A7D4D0b4Ca526,0x5D058e07Cb15004a1140Eb380046cd3aB93008BD
6164,15627873,144511,9178692772,137911,6600,1802,5,0x00000000006c3852cbEf3e08E8dF289169EdE581,0x5c37D7eDdB52c1572e6511739529865e14D16300
6165,15627873,500000,9178692772,498248,1752,458,1151,0xa24787320ede4CC19D800bf87B41Ab9539c4dA9D,0xe2d6Ae60244376c311cD4F54a8455eD18977134a
6166,15627873,134908,9178692772,128888,6020,1674,381,0x00000000006c3852cbEf3e08E8dF289169EdE581,0x2fa02eD904A94Ef1241D19EEd1D42474824A90Ce
6167,15627873,269846,9178692772,266594,3252,1034,1,0x68b3465833fb72A70ecDF485E0e4C7bD8665Fc45,0x7422C5cd16eb2EeDc0cf2FEd0ef2f55e8f0f394f
6168,15627873,42000,9178692772,42000,0,2,329536,0x7AfC83598826be4124C53397D0b9B23bD4d98309,0x9430801EBAf509Ad49202aaBC5F5Bc6fd8A3dAf8
6169,15627873,1550000,9178692772,1547892,2108,522,643,0x7a250d5630B4cF539739dF2C5dAcb4c659F2488D,0xf46D6E90723CF72b2A6C534531e700aDA0bF4CE9
6170,15627873,75799,9178692772,67055,8744,1290,73,0xa2c14852974afE7755eA824260Ca5dF03B816458,0x5012e2f6b9d81e96622BFA2F2764fcB406d8e6C1
6171,15627873,103605,8978692772,100409,3196,970,69319,0x4D9079Bb4165aeb4084c526a32695dCfd2F77381,0x428AB2BA90Eba0a4Be7aF34C9Ac451ab061AC010
6172,15627873,178851,8960188597,177327,1524,230,5410,0x9507c04B10486547584C37bCBd931B2a4FeE9A41,0x800AD322aa10ce8de372B2b5e1F05f6180c70b04
6173,15627873,54281,8926975144,53637,644,138,12451,0xf203Ca1769ca8e9e8FE1DA9D147DB68B6c919817,0x9093dd96c4bb6b44A9E0A522e2DE49641F146223
6174,15627873,156252,8913435876,154264,1988,522,37,0x53e0e51b5Ed9202110D7Ecd637A4581db8b9879F,0x2F454945fFBAbF4303B7CC1F13a77f61ca702fE8
6175,15627873,800000,8848692772,798324,1676,402,46629,0x1111111254fb6c44bAC0beD2854e76F90643097d,0x839d4641F97153b0ff26aB837860c479E2Bd0242
6176,15627873,300000,8778692772,297632,2368,586,719,0xd9e1cE17f2641f24aE83637ab66a2cca9C378B9F,0x06d5c81EeD0A8e15467475b90143D0B98f586fac
6177,15627873,300000,8778692772,297632,2368,586,277,0xd9e1cE17f2641f24aE83637ab66a2cca9C378B9F,0x49b2d9EF9658007d2d5A4Bf0d9E78F1ae0457AA7
6178,15627873,21000,8743088982,21000,0,2,7,0x46e7187502715442EA7d8Dcb11B27D7889369148,0x46e7187502715442EA7d8Dcb11B27D7889369148
6179,15627873,49175,8678692772,48687,488,138,245,0x1192c7F41FFaE6aF6851994A9382C6f4c95B51F7,0x6E36Efec92219538444A964F136fB57cF5ae3b3E
6180,15627873,56667,8678692772,55723,944,138,202,0xc667a0e7711de7C5916038B6FB709C93DBb7B67f,0xC5AEF555182FaD33C4f156E4033FfCD12eff9d8e
6181,15627873,143289,8678692772,136689,6600,1802,73,0x00000000006c3852cbEf3e08E8dF289169EdE581,0x546367D801a949107A95Cd1D591C741078598fF3
6182,15627873,142959,8678692772,136407,6552,1802,110,0x00000000006c3852cbEf3e08E8dF289169EdE581,0xCc1dD65746D5910362bE6201D598BE868C83dF32
6183,15627873,163805,8678692772,157217,6588,1802,50,0x00000000006c3852cbEf3e08E8dF289169EdE581,0xa45dC8d972c4b6A6ff5b3018A7ac43290927F662
6184,15627873,56659,8678692772,55715,944,138,258,0x9431DE2DFE10BDB30995bd3791dE03a6c9570054,0x97bAFecB09d44Afa1886e7d0E378e5AA3007E69C
6185,15627873,152511,8678692772,145911,6600,1802,114,0x00000000006c3852cbEf3e08E8dF289169EdE581,0x0DA7601122174Eb7743cC22e9e1f67363E91b2c2
6186,15627873,54520,8678692772,53892,628,202,583,0x084b1c3C81545d370f3634392De611CaaBFf8148,0x62764715edAC8396C76E8704Ae86509b23b523A2
6187,15627873,205741,8678692772,203005,2736,842,227,0x68b3465833fb72A70ecDF485E0e4C7bD8665Fc45,0x3EB4BD4e17f51b09Bfa3E842b90d5293404376b6
6188,15627873,52541,8678692772,51685,856,202,104,0x000000000000509081d6FCD3ee63e791aD1db763,0xD4142730f3e5640C129DB5E206Fd990B53aBFC30
6189,15627873,287691,8678692772,285367,2324,522,180,0x283Af0B28c62C092C9727F1Ee09c02CA627EB7F5,0x483B9B145C728f34157a73596530f53429DAE189
6190,15627873,71697,8678692772,69513,2184,458,441,0x74312363e45DCaBA76c59ec49a7Aa8A65a67EeD3,0x923b14ad2c5eCde9A549Ce11e3EeD4790B3766EA
6191,15627873,186644,8678692772,178300,8344,2194,64,0x00000000006c3852cbEf3e08E8dF289169EdE581,0x3A73A38e7b01CaA1251c9779113026A0e448F98b
6192,15627873,99244,8678692772,98636,608,138,20,0xA0b86991c6218b36c1d19D4a2e9Eb0cE3606eB48,0x334d673730D4fE96b91d044B01423Ac3d9960C26
6193,15627873,196090,8678692772,189526,6564,1802,47,0x00000000006c3852cbEf3e08E8dF289169EdE581,0x9aCE182C0d1f30E6A8b90650659DE6f29DF6Af23
6194,15627873,51547,8678692772,50951,596,138,4,0x467719aD09025FcC6cF6F8311755809d45a5E5f3,0xed42833b6cb2079153a40DF31B2F68b19D3cbb4C
6195,15627873,278821,8678692772,278617,204,74,470,0x55f1C36Bb7aE0d7D6caE97902E30A2306686Ec73,0x36151eF8bF252eB963235fd76245B98580D595F0
6196,15627873,53786,8678692772,52842,944,138,3,0xdAC17F958D2ee523a2206206994597C13D831ec7,0x57592d6066a82625cf91ee4881F55D27Ddc0Fe9A
6197,15627873,46267,8678692772,45691,576,74,205,0x283Af0B28c62C092C9727F1Ee09c02CA627EB7F5,0xF29a9321e238A1df5E076b2C9992266b4BB46878
6198,15627873,58516,8678692772,57572,944,138,0,0x7D1AfA7B718fb893dB30A3aBc0Cfc608AaCfeBB0,0xbE56C177E41a2B8a37216b7816231b1C19B20594
6199,15627873,55904,8678692772,54960,944,138,280,0x011b0beAe3eC5953B4805b064cC78f6F892A99cC,0x8013F0aEB145e4527d31032A3370f3B581C92152
6200,15627873,46127,8678692772,45639,488,138,1375,0x9016067919813eDfDDAEdcDFCF62172411e3d6c8,0xA2B0E6cF670740e0c0DF7bfcAf6B79684988a6F3
6201,15627873,542644,8678692772,542036,608,138,169,0xC549d87E9CEA28961927436a2B7D6944f7CA86eb,0xc5b4e6572287160669DA93098Cf9ce4d8dEA0830
6202,15627873,143353,8678692772,136689,6664,1810,74,0x00000000006c3852cbEf3e08E8dF289169EdE581,0x546367D801a949107A95Cd1D591C741078598fF3
6203,15627873,32413,8678692772,30969,1444,202,16,0x00000000000C2E074eC69A0dFb2997BA6C7d2e1e,0x975F6b37456b9b03996F494B430bde71e75429A4
6204,15627873,38846,8660000000,38214,632,138,1,0x7D1AfA7B718fb893dB30A3aBc0Cfc608AaCfeBB0,0x7dd504AD5f1b37cf70c1B025eC3fFcc8D1F8D70f
6205,15627873,21000,8590000000,21000,0,2,705880,0x22D1D975E06F4cfA837253954151D3e2d7031f45,0x6dfc34609a05bC22319fA4Cce1d1E2929548c0D7
6206,15627873,213368,8467576608,211980,1388,402,548,0x1111111254fb6c44bAC0beD2854e76F90643097d,0xf9Ac5B6c837b290dbce32467f188e568a04972d8
6207,15627873,69400,8178692772,68824,576,74,107,0x283Af0B28c62C092C9727F1Ee09c02CA627EB7F5,0xc40456ee3Ce933b81D9be4D68d964Eeb1F684298
6208,15627873,53443,8178692772,52499,944,138,0,0x55296f69f40Ea6d20E478533C15A6B08B654E758,0x16D6746d7158432B1206227f3425D7936EDA95d2
6209,15627873,47503,8178692772,46491,1012,202,263782,0x3506424F91fD33084466F402d5D97f05F8e3b4AF,0x7Bd8EFab672250de65ba4bA3BC6C3aA08120A1c3
6210,15627873,181476,8178692772,179912,1564,394,137,0x1Fa8559e873f698292766790AeCf8080A66433F6,0x673a041A8631DCF4A308E9669E09Ef8526de8f89
6211,15627873,181476,8178692772,179912,1564,394,3034,0x1Fa8559e873f698292766790AeCf8080A66433F6,0xf2E9db3c5D06015833Df31eD3C37172a2B34EE7F
6212,15627873,181476,8178692772,179912,1564,394,5644,0x1Fa8559e873f698292766790AeCf8080A66433F6,0xb5F31EB9e70f88c5997a243DfB59b7097bcd84bE
6213,15627873,181476,8178692772,179912,1564,394,65,0x1Fa8559e873f698292766790AeCf8080A66433F6,0xc6572C84e614Ed4e0daEFB8b496494B30964Bb73
6214,15627873,60715,8000000000,53271,7444,2506,150,0x00000000006c3852cbEf3e08E8dF289169EdE581,0x8C7cCE1F0ed5cF36D24cB8aBa73749a0e0eCb995
6215,15627873,21000,7894412083,21000,0,2,67,0xac14B5B29448f474C1a8dF3F712b82c3efed7e42,0xA1ed9c875F1De001FAc7963e1716Bc31F522fc78
6216,15627873,34235,7554816325,33627,608,138,13,0x083D41d6DD21EE938f0c055CA4fb12268DF0EfaC,0x90C058ccEF37b833A5B271A30192357Ded296DF4
6217,15627873,2374152,7326619434,2373852,300,74,456,0x317b50327E48a54c56b0212a7aAbe8A5A2573AB0,0x9a679F16A53a7b353c4879E40Cf50082d6ebc5ab
6218,15627873,21000,7326619434,21000,0,2,26,0xd5FBDa4C79F38920159fE5f22DF9655FDe292d47,0x26032288b2090843CF3940747Aba28a7aF699B7D
6219,15627873,174143,7326619434,172131,2012,522,266,0xEfF92A263d31888d860bD50809A8D171709b7b1c,0x24D0Da18B2E4F2681ad1183Bee248E7B9e8e6b58
6220,15627873,18976607,7180692772,18734363,242244,35402,214,0xc0E53C70dD53b5e1A8275Aa65ec07F20038F8317,0xa5Db65D218d9A017c39c0657c0663Fee0085a5c2
6221,15627874,21000,31766034202,21000,0,2,1,0x8790B7dE5D4B555C28428df2D928905b36B1522D,0x728e8c5Cca0f12257D552BA3D5D00214aF174a88
6222,15627874,150000,30000000000,150000,0,2,11173684,0xAe64A66FaDC306395C001234fABfD09cE27bBdC0,0xFBb1b73C4f0BDa4f67dcA266ce6Ef42f520fBB98
6223,15627874,21000,20000000000,21000,0,2,48,0xFD4492E70DF97A6155C6D244f5ec5B5a39b6F096,0x426DaeF611bB209Acc8ceFFeAa6aC151e7122A7C
6224,15627874,175110,15004362923,173546,1564,394,1989,0x1Fa8559e873f698292766790AeCf8080A66433F6,0x0B4AE84E396aEe628C562449Bc6d49968c1E1AEf
6225,15627874,181476,12000000000,179912,1564,394,4564,0x1Fa8559e873f698292766790AeCf8080A66433F6,0xE88B1bc93F5711b628E81a50D5143C15B1473Bd9
6226,15627874,55331,11020000000,54723,608,138,26,0xdAC17F958D2ee523a2206206994597C13D831ec7,0xD0628161D7B9189F6477adA520d3bB71Bb7127bE
6227,15627874,273981,10504362923,241781,32200,5770,5088,0xA0c68C638235ee32657e8f720a23ceC1bFc77C77,0x433c8A73Bec1273561E4E2201649de12f20B7D58
6228,15627874,207128,10004362923,206520,608,138,4232339,0xdAC17F958D2ee523a2206206994597C13D831ec7,0xDFd5293D8e347dFe59E90eFd55b2956a1343963d
6229,15627874,207128,10004362923,207128,0,2,3492280,0x529Aa7F1701DB84292A496aB45eF14eEF055300d,0x56Eddb7aa87536c09CCc2793473599fD21A8b17F
6230,15627874,207128,10004362923,206508,620,138,3492281,0xdAC17F958D2ee523a2206206994597C13D831ec7,0x56Eddb7aa87536c09CCc2793473599fD21A8b17F
6231,15627874,179431,10004362923,178871,560,138,0,0x182E77c1ac6575ad30f3EbE2Edc4eBB1e7ff81f4,0x8b14A1A527104512A446453d31dD6bE3b8cB3451
6232,15627874,500000,10004362923,498248,1752,458,1262741,0xa24787320ede4CC19D800bf87B41Ab9539c4dA9D,0x89e51fA8CA5D66cd220bAed62ED01e8951aa7c40
6233,15627874,331952,10000000000,327088,4864,1546,482,0x68b3465833fb72A70ecDF485E0e4C7bD8665Fc45,0x8764885033215F2fdfE7A2CF3a6430E14FA5BdB2
6234,15627874,143265,10000000000,136689,6576,1802,590,0x00000000006c3852cbEf3e08E8dF289169EdE581,0xCB405895fe35Ca438BF87Bf59fa490ad16c45500
6235,15627874,410066,10000000000,406450,3616,1162,309,0x68b3465833fb72A70ecDF485E0e4C7bD8665Fc45,0xeC11Cae419177e6ecE61c6C35DBD0F8e08B89982
6236,15627874,70000,9620027188,69392,608,138,532,0xdAC17F958D2ee523a2206206994597C13D831ec7,0xf5491f793D47A6Ea22f5e0B9AD3990CF66c4b40B
6237,15627874,169064,9504362923,158400,10664,3402,415,0x00000000006c3852cbEf3e08E8dF289169EdE581,0x3F3eD9E0846Ab48339B70603E617Ae253932f819
6238,15627874,471670,9504362923,468006,3664,1162,690,0x68b3465833fb72A70ecDF485E0e4C7bD8665Fc45,0x51115F73F927fCf13ef6f27f6bAA170156d44489
6239,15627874,118268,9504362923,116012,2256,650,201,0xC45f3c76FeeEa53aAE5AFA9b51F166E025145400,0xe306E8C4fCFE21800A93d6C08440aAB73183f384
6240,15627874,21000,9504362923,21000,0,2,2393,0xdc7DC88971E6f9e46421FCb60Cd7515ab5c1ba7D,0xe1e2E153e785118Fa7b50e93e6b8cf887F025Bc7
6241,15627874,249801,9504362923,247381,2420,522,7,0x283Af0B28c62C092C9727F1Ee09c02CA627EB7F5,0x73005c43c6A82540dabf4115513F5e3A74D5d526
6242,15627874,400000,9504362923,399392,608,138,173,0xc3d688B66703497DAA19211EEdff47f25384cdc3,0x94aEc6a2Fd64b63cd501960E920A4D5562d35d40
6243,15627874,60412,9504362923,59816,596,138,135,0xA0b86991c6218b36c1d19D4a2e9Eb0cE3606eB48,0xE00973e3954135cCB87fc18C045dcf19585C48d4
6244,15627874,175971,9504362923,173199,2772,842,670,0x68b3465833fb72A70ecDF485E0e4C7bD8665Fc45,0x0144D10B6b9d90fEF7d139e9693eac9F55e344Ed
6245,15627874,76230,9504362923,75278,952,202,1002,0x28B708Ee88e608f3307A7d41b930312fC9C9e632,0x4Cc8C9a45B953a1922D8700e7cf4c0489D0b4154
6246,15627874,227799,9504362923,225027,2772,842,162,0x68b3465833fb72A70ecDF485E0e4C7bD8665Fc45,0x4492CA2CCCE314831Bdb1cD7924b5fA33b4C9Af8
6247,15627874,94813,9504362923,94205,608,138,340,0xdAC17F958D2ee523a2206206994597C13D831ec7,0xe9e28b7FA3c972c5Ca4D28e3955386c9217c1eC2
6248,15627874,46267,9504362923,45691,576,74,1564,0x283Af0B28c62C092C9727F1Ee09c02CA627EB7F5,0xD59d1EF7Dfd0D9C41DA1B12209722b5a0712Dd32
6249,15627874,46596,9504362923,46108,488,138,57,0xC26ef2E721CC3C494b0F91Be9be38b6111a1A83c,0x777C29cD351111F4bdB394Bf1530a7510fA2F46a
6250,15627874,21000,9504362923,21000,0,2,739,0x11286A8D9AB6C307Ce0681Ad66C1b588Ad85a03a,0xB23a91638BF4E9Ba88AcB1BeA4F81a569a1fcd4c
6251,15627874,194497,9504362923,193285,1212,458,33,0x612E2DadDc89d91409e40f946f9f7CfE422e777E,0xB96Ab28F90b838435152148032392ea0da3AC7DA
6252,15627874,21000,9504362923,21000,0,2,1,0xd50d8df8f5aD747899B8b23fa0dC1c166c82dE12,0xe0c4cd0b4b71b6d413D743847E1ED013CEe2A721
6253,15627874,259617,9504362923,256349,3268,1354,19,0x03c545163bd114D756c65DDA1D97D37b89dA2236,0xa0DEfb94C58E0e03cdd8E580F35fB64097fe9F9d
6254,15627874,55923,9504362923,54979,944,138,34,0xD309A8d0498Cc73f53481e46094DC0d3aaB0d9dd,0xB1C438BE81560a91317498AC82763Bf94e506464
6255,15627874,329032,9504362923,329032,0,2,165,0xE5FdBdb64E422aC6CB048B8f0917244968253F39,0xE5FdBdb64E422aC6CB048B8f0917244968253F39
6256,15627874,1000000,9504362923,999308,692,138,4121137,0x95aD61b0a150d79219dCF64E1E6Cc01f0B64C4cE,0x0D0707963952f2fBA59dD06f2b425ace40b492Fe
6257,15627874,72535,9504362923,71595,940,202,33,0x6de7aC835EC6841Af9b94fd1273dB83B8d69e3f7,0x4f0B4c8f8e11CD9967f3d81773ECB14047612aa0
6258,15627874,181476,9004362923,179912,1564,394,172,0x1Fa8559e873f698292766790AeCf8080A66433F6,0x872C3cf514B537837764cc28b564BC62cAa54245
6259,15627874,181476,9004362923,179912,1564,394,66,0x1Fa8559e873f698292766790AeCf8080A66433F6,0xbb6916F4Ad547F369C74C058c1A2dC693a79cb02
6260,15627874,524310,8738993280,522202,2108,522,635,0x7a250d5630B4cF539739dF2C5dAcb4c659F2488D,0xbB16B9DD8d06231A4Fd7403cA2BD38EaB20C062B
6261,15627874,203559,8738993280,201883,1676,402,27,0x1111111254fb6c44bAC0beD2854e76F90643097d,0x32Aa23c483904e03751d317B37adA87B0E2036d0
6262,15627874,21000,8240284748,21000,0,2,1,0x3a9C66c182e195697D867b9fC39D1bB29ba1cD7D,0x4f990a56EB615F6785117448456dae9b4ECd327E
6263,15627874,21000,8240284748,21000,0,2,1,0x3a9C66c182e195697D867b9fC39D1bB29ba1cD7D,0xb49927eA027b82551D4751600F61D839830338AA
6264,15627875,21000,61798438170,21000,0,2,0,0x64dc04Ea09E3A784D207F96B13F62A3ae49Cc3E5,0xd07e437ADA413472D1C468a34a783FD881B25aFc
6265,15627875,21000,61798438170,21000,0,2,1,0x22551748ad434dFeBdDd4dccd95C237808877B58,0xd07e437ADA413472D1C468a34a783FD881B25aFc
6266,15627875,71000,51723492160,71000,0,2,2326,0xD6f859ba5076e7690b2056f697e5097f9FE836Ed,0xD6f859ba5076e7690b2056f697e5097f9FE836Ed
6267,15627875,324583,41968846809,323435,1148,180,5396,0x9507c04B10486547584C37bCBd931B2a4FeE9A41,0xd78ceBa1f9291dadE3539bD558eB5D9B969ec66F
6268,15627875,21000,38213426502,21000,0,2,30467,0x0e451436025B652dbD396873F25e7756d16f933e,0x4d7F1790644Af787933c9fF0e2cff9a9B4299Abb
6269,15627875,294930,7307675848,292746,2184,650,106629,0xA69babEF1cA67A37Ffaf7a485DfFF3382056e78C,0x9AAb3F81604c683a1a0D14019FBfe15bef7aA1ee
6270,15627875,21000,33577424487,21000,0,2,0,0x28ABB96176Ce3F6Fc7B40d9bf4a0761997e5156c,0x7b4c0EDaf53D25ceA0E3CbC61E8D8dcEd0c36942
6271,15627875,21000,33577424487,21000,0,2,1,0x29cfeB478d5A10FbAa247c09aced7c840dE59C18,0x7b4c0EDaf53D25ceA0E3CbC61E8D8dcEd0c36942
6272,15627875,21000,32880883829,21000,0,2,0,0x22d7047b08381B38074Db83759fb5079E310E903,0x28ABB96176Ce3F6Fc7B40d9bf4a0761997e5156c
6273,15627875,21000,32880883829,21000,0,2,1,0x6AdA4Ce7537E022367c8c392D196E4ae4F04cEe7,0x28ABB96176Ce3F6Fc7B40d9bf4a0761997e5156c
6274,15627875,71000,32281965000,71000,0,2,2370,0x9380Fbf3c062D638989fcD6D15b1f5B2cB3372D8,0x9380Fbf3c062D638989fcD6D15b1f5B2cB3372D8
6275,15627875,210000,30000000000,210000,0,2,843594,0x88767cbF39d32b75c56bCCEBab9f8C71F81e689F,0xA7EFAe728D2936e78BDA97dc267687568dD593f3
6276,15627875,142963,22307675848,134963,8000,2442,177,0x00000000006c3852cbEf3e08E8dF289169EdE581,0xB988E56aAC0a693eC5e307c084d4E0C33426A4e4
6277,15627875,250000,7307675848,249476,524,78,1081,0x9b873B45b23965CC69b81b5596e4Bf4DFE31b6bA,0x1c3F3ab470B3712424DBf22D39C343F0aa042F76
6278,15627875,201946,8807675848,199542,2404,586,4,0x03f7724180AA6b939894B5Ca4314783B0b36b329,0x57592d6066a82625cf91ee4881F55D27Ddc0Fe9A
6279,15627875,250000,55332770704,249144,856,118,1082,0x9b873B45b23965CC69b81b5596e4Bf4DFE31b6bA,0x1c3F3ab470B3712424DBf22D39C343F0aa042F76
6280,15627875,5049496,17000000000,5042372,7124,1098,289,0x0a39DA505DfB5E0BBc6bd84428281A8ba1bC7753,0x495E889d1A6cEB447a57dcc1C68410299392380c
6281,15627875,155380,15099184696,154292,1088,150,1006,0x38A868000000a600a300867c596D400D79970500,0x255ED4ae17EFf35923cfDe87ED6ce81c4ebf8888
6282,15627875,21000,14000000000,21000,0,2,1,0x500A746c9a44f68Fe6AA86a92e7B3AF4F322Ae66,0x0fD915f498BdD94c0200a726f3b9dDcEb9D647cD
6283,15627875,85184,13100000000,84564,620,138,5,0xdAC17F958D2ee523a2206206994597C13D831ec7,0xE1b5b70F7EbCB173aA2EB5f416dd7B440dD30c63
6284,15627875,21000,12600000000,21000,0,2,1,0x500A746c9a44f68Fe6AA86a92e7B3AF4F322Ae66,0xebe01bE34202A32915D4a8605731eEF8cCA199F9
6285,15627875,209259,12371881208,209055,204,74,514,0xDad08B9401358D3398aC796ae130653550d74bc5,0x92e8E8760aBa91467A321230EF3ba081aD3998Fb
6286,15627875,300000,12307675848,298436,1564,394,6,0x1Fa8559e873f698292766790AeCf8080A66433F6,0x8c6E43dEDaB5A769E11BdC34aB78c87A2b5E5765
6287,15627875,300000,12307675848,298436,1564,394,6,0x1Fa8559e873f698292766790AeCf8080A66433F6,0xD36F21243834F62aa8981721Ab0d4B358E69f0a5
6288,15627875,226910,12307675848,225086,1824,458,224,0x7a250d5630B4cF539739dF2C5dAcb4c659F2488D,0x2cF962479895De592aE1f1d338caED65949c99E1
6289,15627875,300000,12307675848,298436,1564,394,6,0x1Fa8559e873f698292766790AeCf8080A66433F6,0x6CB1a22d2b64d3431491e029c598e20CDA54D4Bf
6290,15627875,300000,12307675848,298436,1564,394,6,0x1Fa8559e873f698292766790AeCf8080A66433F6,0x3380728Cac7b5b4eb1BC8630E04603655F70aD01
6291,15627875,300000,12307675848,298436,1564,394,6,0x1Fa8559e873f698292766790AeCf8080A66433F6,0xB525bde9Af7518fb240ABE591919235e043349a8
6292,15627875,300000,12307675848,298436,1564,394,6,0x1Fa8559e873f698292766790AeCf8080A66433F6,0x73dc4290b67A3cd7B3E1D116b04317b6BA5Cd941
6293,15627875,300000,12307675848,298436,1564,394,6,0x1Fa8559e873f698292766790AeCf8080A66433F6,0x8a3718E7eac2552765F1aC747A7fd5cB3C4cA19C
6294,15627875,300000,12307675848,298448,1552,394,6,0x1Fa8559e873f698292766790AeCf8080A66433F6,0x7E879F99b09342f9aD26c858Fc7f5518EF0D1361
6295,15627875,300000,12307675848,298436,1564,394,6,0x1Fa8559e873f698292766790AeCf8080A66433F6,0x68ca907be31A2296d17481e3E079B56d59b9fEf7
6296,15627875,300000,12307675848,298436,1564,394,6,0x1Fa8559e873f698292766790AeCf8080A66433F6,0x7Faf71C0558D45cB7c944CDFcA177e3fE8c6102d
6297,15627875,300000,12307675848,298436,1564,394,6,0x1Fa8559e873f698292766790AeCf8080A66433F6,0xceA9f8C6b6A41e29f374528a2817188c9b4CE3e7
6298,15627875,300000,12307675848,298448,1552,394,6,0x1Fa8559e873f698292766790AeCf8080A66433F6,0xC0958535524f1D3883ce12858d32A8d6e4e412BB
6299,15627875,300000,12307675848,298436,1564,394,6,0x1Fa8559e873f698292766790AeCf8080A66433F6,0x9F552C1166c50abD0aDF4D514B1fb978A9eDA901
6300,15627875,300000,12307675848,298448,1552,394,6,0x1Fa8559e873f698292766790AeCf8080A66433F6,0x7404dDc7aFF5923429AbF632A7f99EF71C6fa613
6301,15627875,300000,12307675848,298436,1564,394,6,0x1Fa8559e873f698292766790AeCf8080A66433F6,0x79e8046fa0EB11538DD954611f5de90F77FB83fc
6302,15627875,300000,12307675848,298436,1564,394,6,0x1Fa8559e873f698292766790AeCf8080A66433F6,0x890c153fd5201CC90F1Dc555c891ac7dBD80AdA7
6303,15627875,300000,12307675848,298436,1564,394,6,0x1Fa8559e873f698292766790AeCf8080A66433F6,0x37a015B907c39AD92e1c522105755397F8C5c815
6304,15627875,300000,12307675848,298436,1564,394,6,0x1Fa8559e873f698292766790AeCf8080A66433F6,0x43b2976bcE68573afBea7F0418cDd207a9a003eE
6305,15627875,300000,12307675848,298436,1564,394,6,0x1Fa8559e873f698292766790AeCf8080A66433F6,0x5C5756e5a9f8A18c82109B4df7D7b6fbBA4921DB
6306,15627875,300000,12307675848,298448,1552,394,6,0x1Fa8559e873f698292766790AeCf8080A66433F6,0x769bC353fa04b8B98F647Af8A575b6A16A79eA84
6307,15627875,300000,12307675848,298436,1564,394,6,0x1Fa8559e873f698292766790AeCf8080A66433F6,0x30Cf17723d0cb253856aBB5738c86C268fE47FC5
6308,15627875,300000,12307675848,298436,1564,394,6,0x1Fa8559e873f698292766790AeCf8080A66433F6,0x402BD064Efeee5c8cD2c2D78cA3Db4CE22CB5730
6309,15627875,300000,12307675848,298436,1564,394,6,0x1Fa8559e873f698292766790AeCf8080A66433F6,0x74bde8483142E1e8406A0CeD63628C241D9152aF
6310,15627875,300000,12307675848,298448,1552,394,6,0x1Fa8559e873f698292766790AeCf8080A66433F6,0xCc8E92824ab726090FC5f935a64F5d86bf752B4c
6311,15627875,300000,12307675848,298436,1564,394,6,0x1Fa8559e873f698292766790AeCf8080A66433F6,0xEA7Df239Ec8b07f85433eFa8763Cea7B5c3a7bE3
6312,15627875,300000,12307675848,298436,1564,394,6,0x1Fa8559e873f698292766790AeCf8080A66433F6,0x40Ff1087eE1B85285A8D8A3638e80dAfd7A628De
6313,15627875,300000,12307675848,298436,1564,394,6,0x1Fa8559e873f698292766790AeCf8080A66433F6,0x10Ca5Ed0eB978268E9CA84C7429B45435514FE69
6314,15627875,300000,12307675848,298436,1564,394,6,0x1Fa8559e873f698292766790AeCf8080A66433F6,0x55C550CB3EE7F7dfC1DE7603758B3301703d419A
6315,15627875,300000,12307675848,298436,1564,394,6,0x1Fa8559e873f698292766790AeCf8080A66433F6,0xe1Da94f0087398b90a33124d1B116EAAa560AAbC
6316,15627875,300000,12307675848,298436,1564,394,6,0x1Fa8559e873f698292766790AeCf8080A66433F6,0x929748860A2c383604e9EFD8672B642305e20F13
6317,15627875,300000,12307675848,298448,1552,394,6,0x1Fa8559e873f698292766790AeCf8080A66433F6,0xBC8824821C9335A30eb73a3700C1d8890E5cbEfB
6318,15627875,300000,12307675848,298436,1564,394,6,0x1Fa8559e873f698292766790AeCf8080A66433F6,0xc544064fcc802a0Cfa9a5e5F7E9F369356aD30D4
6319,15627875,300000,12307675848,298436,1564,394,6,0x1Fa8559e873f698292766790AeCf8080A66433F6,0x587Ae434cfe131bc736a3Da35B2cEaF365fAb452
6320,15627875,300000,12307675848,298448,1552,394,6,0x1Fa8559e873f698292766790AeCf8080A66433F6,0xfCECacce3a9C8CeC24157eBD93D0A659f6C53948
6321,15627875,300000,12307675848,298436,1564,394,6,0x1Fa8559e873f698292766790AeCf8080A66433F6,0xAA9d6a8a039Ed966Cd89fb300594cd6a4597072a
6322,15627875,300000,12307675848,298436,1564,394,6,0x1Fa8559e873f698292766790AeCf8080A66433F6,0x6E3F2b4c87f18bA249fe99a5D1F2b7884Fdc9b48
6323,15627875,300000,12307675848,298436,1564,394,6,0x1Fa8559e873f698292766790AeCf8080A66433F6,0x3a7a4C0591435A78650FE2481eC57599B7d3ad5D
6324,15627875,300000,12307675848,298436,1564,394,6,0x1Fa8559e873f698292766790AeCf8080A66433F6,0x8521725f3bc9D4Fc518eC431C2d7964a9B4dBD20
6325,15627875,300000,12307675848,298436,1564,394,6,0x1Fa8559e873f698292766790AeCf8080A66433F6,0xc90A4E96B034298ca77E77E87Bae416Ae24a88b9
6326,15627875,300000,12307675848,298436,1564,394,6,0x1Fa8559e873f698292766790AeCf8080A66433F6,0xCA0b665BA1d169A850e93a58F96856D3e8474496
6327,15627875,300000,12307675848,298436,1564,394,6,0x1Fa8559e873f698292766790AeCf8080A66433F6,0xb4F6060f1338faBC924bc33461DF47E156D775Bb
6328,15627875,300000,12307675848,298436,1564,394,6,0x1Fa8559e873f698292766790AeCf8080A66433F6,0x9B950CC83be64E97592d98ACDaA818B6866d053F
6329,15627875,300000,12307675848,298436,1564,394,6,0x1Fa8559e873f698292766790AeCf8080A66433F6,0xb22fcad95fe15024c3b05BDDDACc1b8b6c49C76F
6330,15627875,300000,12307675848,298436,1564,394,6,0x1Fa8559e873f698292766790AeCf8080A66433F6,0x33DC75A71f17D85AE789f8562CE5Eaa261929C52
6331,15627875,300000,12307675848,298436,1564,394,6,0x1Fa8559e873f698292766790AeCf8080A66433F6,0x0E0637Ee49bD32eebdB040f75be6e30dac21b5E7
6332,15627875,300000,12307675848,298436,1564,394,6,0x1Fa8559e873f698292766790AeCf8080A66433F6,0xc90a85292DA5De6F7Aa18A81B1307101a40dDdA4
6333,15627875,300000,12307675848,298436,1564,394,6,0x1Fa8559e873f698292766790AeCf8080A66433F6,0xb3665a5c5639dB0cf3BCfe6DE9273CEDC7917d89
6334,15627875,300000,12307675848,298448,1552,394,6,0x1Fa8559e873f698292766790AeCf8080A66433F6,0x5744B9849172709b8318074F00105Aa605aEA99A
6335,15627875,300000,12307675848,298436,1564,394,6,0x1Fa8559e873f698292766790AeCf8080A66433F6,0x652191b52E9e1AD7dfcEC10315eb20df5dfA2b58
6336,15627875,21000,11500000000,21000,0,2,7,0x835cfb6200399c8Ac5339787f59099EeE4eA2f29,0x84e5CDC34BeC8a1137f9197143C2537008cB7bd5
6337,15627875,63000,11051376003,63000,0,2,2710054,0x7160016ecd34C669f37953f01F2731B2413Fe368,0xC098B2a3Aa256D2140208C3de6543aAEf5cd3A94
6338,15627875,70000,11000000000,69404,596,138,54,0xdAC17F958D2ee523a2206206994597C13D831ec7,0x1710227fBe443060B968Ace7b8B71911149D7416
6339,15627875,350000,10982277074,350000,0,2,6925055,0x6EC9A24013aC5bB4B097e2659ee63467718ef770,0x46340b20830761efd32832A74d7169B29FEB9758
6340,15627875,342000,10800000000,331324,10676,3402,27783,0x00000000006c3852cbEf3e08E8dF289169EdE581,0x8279648470Eb92CBcd00CeB8Ca30C2aDfAc20740
6341,15627875,52966,10690817572,52534,432,74,155627,0x566D57dB370A4bDAdf18945A02a8999c7259bF5D,0xcDd37Ada79F589c15bD4f8fD2083dc88E34A2af2
6342,15627875,270147,8576582999,267983,2164,382,1863,0x0000000000304a767881fDcCB30FCEB51f6221e2,0x5174DEdC36695F1593C527F7C1B6486b6d6a8120
6343,15627875,21000,32500000000,21000,0,2,48,0x326d8516115F35fFc60B3f2F07D683EB1E9e1482,0xD567c4057B60fFf93679Fe952d9d1d890281F3DA
6344,15627875,211250,10307675848,209498,1752,458,38,0x7a250d5630B4cF539739dF2C5dAcb4c659F2488D,0x51cCB5494CC7Babf31a8D5d8dF956778733B8fca
6345,15627875,500000,10307675848,498052,1948,394,60927,0x585C3d4Da9b533C7e3dF8AC7356C882859298cEe,0xd5cf0Cb9a8DF9B46f077f561d8b76c34A69bD82F
6346,15627875,1770310,10307675848,1657150,113160,14552,0,,0x9A4140FFB57D5272ea009c37a18D2A88B54e6063
6347,15627875,21000,10270000000,21000,0,2,0,0x6dfc34609a05bC22319fA4Cce1d1E2929548c0D7,0xfFBd263Ca04CE5649241d39d6E35996b82e235eC
6348,15627875,21000,10270000000,21000,0,2,0,0x6dfc34609a05bC22319fA4Cce1d1E2929548c0D7,0x8f1B8e9E307911e11385Ff05d09b13a8c65be2F0
6349,15627875,21000,10270000000,21000,0,2,113,0x6dfc34609a05bC22319fA4Cce1d1E2929548c0D7,0x90571F7CBc82eae8886f610fc017C918d6085a20
6350,15627875,21000,10055533395,21000,0,2,42,0xCBD6832Ebc203e49E2B771897067fce3c58575ac,0xa4716C43472f0229b9f78A6d35fA17872fD50Bc9
6351,15627875,191041,10000000000,190165,876,266,1394,0xd588b586D61C826A0e87919b3D1a239206d58bf2,0xC22d03e13B888Dabb33A1575e4F6542f0e996622
6352,15627875,21000,9809675848,21000,0,2,251470,0x4126466e95591b0612C6C7F66E59969120328eE4,0x151B381058f91cF871E7eA1eE83c45326F61e96D
6353,15627875,120000,9809675848,119380,620,138,0,0xdAC17F958D2ee523a2206206994597C13D831ec7,0xFAF8C777C3CA109e827b7978dF20143A1D4a76F4
6354,15627875,76908,9807675848,75668,1240,202,2,0xF5C9F957705bea56a7e806943f98F7777B995826,0x32C8a80dB4801f95Ad8Ca2301D4Ecb7AEC1eCaea
6355,15627875,335892,9807675848,331548,4344,1034,25,0x197492CCB4B1acaAAcd43432657A17832E36AB49,0xd4f5c694b1d232AFB8642cC96386514a41741c58
6356,15627875,53421,9807675848,51625,1796,714,8,0x6FBBC829C17211015581754D5DBb694DA96dC6f8,0xf1A4C08FB891BE86DB2E5892b23FfdcEa6eA360e
6357,15627875,69000,9707675848,68512,488,138,405,0xD27dcbcC8778a8AB33AAc529Df36a634567Be325,0xeA770cb95f55163FC249bD5B42FEb23F37Aaf524
6358,15627875,69000,9707675848,68512,488,138,328,0xD27dcbcC8778a8AB33AAc529Df36a634567Be325,0xD7Ee6Bb87352676865F7F9E94a13401Bb7308Fa3
6359,15627875,69000,9707675848,68512,488,138,483,0xD27dcbcC8778a8AB33AAc529Df36a634567Be325,0x9558A94782C49d82a67EdEa148937BB522BA5C8c
6360,15627875,21000,9637675848,21000,0,2,1,0x27315f5F282c31fBADE4aE952d2631C05cD3a26F,0x0e8c83C39D46935Cf795A79973182439E9C21180
6361,15627875,100000,9633960327,99404,596,138,368501,0xdAC17F958D2ee523a2206206994597C13D831ec7,0xeC30d02f10353f8EFC9601371f56e808751f396F
6362,15627875,90000,9633960327,90000,0,2,784413,0x6b09CA1ec26824D744445FcDD0112bBe5E7CafA9,0xcaD621da75a66c7A8f4FF86D30A2bF981Bfc8FdD
6363,15627875,21000,9620027188,21000,0,2,7,0xB30d6D0A73947803e0Cb66493019D56D489E4476,0x9C34aA07a1f8F4A8Ee9F2AE5f345CD12c53AA069
6364,15627875,21000,9620027188,21000,0,2,0,0x6bCdA11EE8E33dc06FCbCD77D30538259d1739f9,0x7EA69Cb731182a9ef750D2Aa94eC478f7fc1728d
6365,15627875,50000,9583445570,50000,0,2,503552,0x9891f1eD22De10FD7072bD7A22F1e5DFBeBf3EeB,0x000F422887eA7d370FF31173FD3B46c8F66A5B1c
6366,15627875,21000,9349061683,21000,0,2,16,0xc52CdB4821427B719b176765447578293e4CF9cb,0x1C40167fA59D2E88B615E49878638989F74e9354
6367,15627875,262342,9308548432,259962,2380,586,16,0x53e0e51b5Ed9202110D7Ecd637A4581db8b9879F,0x2E2a52DD81a71b6f251F8C558840Ed439aC9D7D7
6368,15627875,67557,9307675848,67493,64,10,360,0xC02aaA39b223FE8D0A0e5C4F27eAD9083C756Cc2,0x6B6AAfc7c3fFEda16F8526c2321403c73c551CDA
6369,15627875,285312,9307675848,282528,2784,842,506,0x68b3465833fb72A70ecDF485E0e4C7bD8665Fc45,0x91CA602f60d8A7B2fC5610A5f0330078e10eda63
6370,15627875,42000,9307675848,42000,0,2,329537,0xe408764785f8305F1Da0a9ca9AbC1408BfC0ecd2,0x9430801EBAf509Ad49202aaBC5F5Bc6fd8A3dAf8
6371,15627875,179157,9307675848,176349,2808,842,162,0x68b3465833fb72A70ecDF485E0e4C7bD8665Fc45,0x9269aD883E747B7b68CAB5B8c25235FC18e9c1Ee
6372,15627875,46551,9307675848,45607,944,138,0,0x95aD61b0a150d79219dCF64E1E6Cc01f0B64C4cE,0x6bcc43d50963363767C112Fc6365714ddc6631B6
6373,15627875,100000,9307675848,99024,976,202,88938,0xdAC17F958D2ee523a2206206994597C13D831ec7,0x3018018c44338B9728d02be12d632C6691E020d1
6374,15627875,458087,9307675848,451807,6280,1612,661,0x881D40237659C251811CEC9c364ef91dC08D300C,0x37B009b21260e07fe73AD2E5BEe98acb1C6B8B2a
6375,15627875,264201,9307675848,258529,5672,1548,1,0x881D40237659C251811CEC9c364ef91dC08D300C,0x6bcc43d50963363767C112Fc6365714ddc6631B6
6376,15627875,21000,9307675848,21000,0,2,28,0xa7b68442E86cF3d7069fc9B3BA9bb9D8163bd1f0,0xB7765d88E1f9e86f49412482CB6D620267B3f3cb
6377,15627875,220472,9307675848,217640,2832,842,502,0x68b3465833fb72A70ecDF485E0e4C7bD8665Fc45,0xf083b5e401619a64a91aDC5470DB816606872d48
6378,15627875,85000,9307675848,84512,488,138,98,0xD27dcbcC8778a8AB33AAc529Df36a634567Be325,0x848E3b880EaC1F530bAe1Aa84D6ea4aECA7572A7
6379,15627875,85000,9307675848,84512,488,138,85,0xD27dcbcC8778a8AB33AAc529Df36a634567Be325,0xd285b457D8f74Ceb72d57BBC1ce30C9523860a16
6380,15627875,85000,9307675848,84512,488,138,71,0xD27dcbcC8778a8AB33AAc529Df36a634567Be325,0x9Fd2f5b668ea847F2a7E79f846CECA0a06Df2AaC
6381,15627875,248900,9307675848,246140,2760,842,58,0x68b3465833fb72A70ecDF485E0e4C7bD8665Fc45,0x566Bf2896a62A5F60864A8bB9F50242db86Ad549
6382,15627875,262519,9307675848,260483,2036,522,489,0x7a250d5630B4cF539739dF2C5dAcb4c659F2488D,0x21d835061Ff2f718025c85EdFA0106B13b579bEf
6383,15627875,21000,9307675848,21000,0,2,6030,0xa3A08E72f155E8d2A44AE7829ed56a3a33EEDEb5,0x65768f7e9448595181271a0Af9A2351D383ace1a
6384,15627875,21000,9307675848,21000,0,2,1,0xA090e606E30bD747d4E6245a1517EbE430F0057e,0xf77f8e6dceE2B45642D757462aECAE95C18b1516
6385,15627875,75000,9307675848,74320,680,138,7163,0x320623b8E4fF03373931769A31Fc52A4E78B5d70,0xe3792A9c235D434B702023b33F03C48C41631090
6386,15627875,508779,9307675848,505971,2808,842,5,0x68b3465833fb72A70ecDF485E0e4C7bD8665Fc45,0x6C2f6C546ab0e965521337f3725c793756F5F057
6387,15627875,316226,9307675848,306698,9528,2636,105,0x881D40237659C251811CEC9c364ef91dC08D300C,0x8C0DBA157f2bf26655176BcBD9637CF7e6FBf7b1
6388,15627875,223107,9307675848,220359,2748,842,2621,0x68b3465833fb72A70ecDF485E0e4C7bD8665Fc45,0x5B8f487765cF8F88Db19C19e2409B51A59Df084C
6389,15627875,184183,9307675848,177543,6640,1810,571,0x00000000006c3852cbEf3e08E8dF289169EdE581,0xCb60a7E36BC53410c54b2aF8d2992b0D416a33fA
6390,15627875,21000,9307675848,21000,0,2,72344,0x134E5788ABa7DE10BA531500794D4703D9B4386A,0xab97925eB84fe0260779F58B7cb08d77dcB1ee2B
6391,15627875,230805,9307675848,227565,3240,1034,347,0x68b3465833fb72A70ecDF485E0e4C7bD8665Fc45,0xd45ebE9C038F63A1689B9334ECe9550972029B43
6392,15627875,91401,9307675848,81633,9768,1418,74,0x67E0eb8557437aB7393243c88A11F3c7E424cA3D,0x5012e2f6b9d81e96622BFA2F2764fcB406d8e6C1
6393,15627875,75000,9307675848,74356,644,138,43,0x320623b8E4fF03373931769A31Fc52A4E78B5d70,0xADB6faf8b2c9e78A9A1780e7fe26Ce3E74cDe674
6394,15627875,75000,9307675848,74332,668,138,92,0x320623b8E4fF03373931769A31Fc52A4E78B5d70,0x8C91f8496d9a8ce2FF452D5FC286b9FA44CF8Dae
6395,15627875,21000,9220000000,21000,0,2,0,0x6dfc34609a05bC22319fA4Cce1d1E2929548c0D7,0xcC0226654A57845b9e2da42275973fe72240e495
6396,15627875,21000,9220000000,21000,0,2,9,0x6dfc34609a05bC22319fA4Cce1d1E2929548c0D7,0xaEF7124Da3d23d3f0E41fF22fA89fc8B58657fe3
6397,15627875,21000,9220000000,21000,0,2,0,0x6dfc34609a05bC22319fA4Cce1d1E2929548c0D7,0xE1cDDe843446f0BdE8787F85aE01aE3d28d6b65B
6398,15627875,44313,9130675848,43657,656,138,113051,0x7D1AfA7B718fb893dB30A3aBc0Cfc608AaCfeBB0,0x6081258689a75d253d87cE902A8de3887239Fe80
6399,15627875,84000,9130675848,83392,608,138,113052,0xA0b86991c6218b36c1d19D4a2e9Eb0cE3606eB48,0x6081258689a75d253d87cE902A8de3887239Fe80
6400,15627875,21000,9130675848,21000,0,2,8346,0x4938df248CFd0F259c561Fa5c1d95Af32275DD8e,0x770E66bf008C0204a8231F4ea5C3Af12e5f580e4
6401,15627875,180000,9000000000,179392,608,138,444361,0xdAC17F958D2ee523a2206206994597C13D831ec7,0x48c04ed5691981C42154C6167398f95e8f38a7fF
6402,15627875,50000,8926975144,50000,0,2,1210290,0xC03c5c5102de33Ad380Cd7Bb85092cC739b338Cb,0x912fD21d7a69678227fE6d08C64222Db41477bA0
6403,15627875,27938,8918193168,27874,64,10,65,0xC02aaA39b223FE8D0A0e5C4F27eAD9083C756Cc2,0xbca5F958f63831618EB4B489404af3D8Ed9eA8B4
6404,15627875,21000,8850000000,21000,0,2,7,0x292f04a44506c2fd49Bac032E1ca148C35A478c8,0xE1bEf5cD780885589A6DB9C35Af564Ec9ed51A4c
6405,15627875,21000,8850000000,21000,0,2,17,0x292f04a44506c2fd49Bac032E1ca148C35A478c8,0x8b567906f138Aae46ceF8b5CAD92D15E536Cf6B3
6406,15627875,1125650,8817675848,1115762,9888,1802,416,0x23E79722Bb8B55a0d04f3AFbCFC34eb771526Adb,0xD0471582c70d35B2A1928552F4D0f82fE4C6cFBa
6407,15627875,1000000,8807675848,999392,608,138,4121138,0xdAC17F958D2ee523a2206206994597C13D831ec7,0x0D0707963952f2fBA59dD06f2b425ace40b492Fe
6408,15627875,71717,8807675848,69533,2184,458,442,0x74312363e45DCaBA76c59ec49a7Aa8A65a67EeD3,0x923b14ad2c5eCde9A549Ce11e3EeD4790B3766EA
6409,15627875,49175,8807675848,48687,488,138,38,0xD27dcbcC8778a8AB33AAc529Df36a634567Be325,0x3a588efdC1627F489456cE0f768A30D9D9B0845B
6410,15627875,21000,8807675848,21000,0,2,4,0x0DB27f2454f20383E0A35F20bE45d05e42245Af5,0xc91aF7f1452c115C785eA6Abc907Be4cF99F57a2
6411,15627875,46957,8807675848,46289,668,138,333,0x33DaD834eca1290A330C4C4634bC3b64a0197120,0x0bA744604dbBD3FE3f99912b9aCd6F39528Bcd88
6412,15627875,46130,8807675848,45642,488,138,198,0xF8C18Df7509c03b45e6247b2b9E73fcaDEF24dd6,0x0b9e99e938AaB21618AA2bf543C60C167967BBC4
6413,15627875,21000,8807675848,21000,0,2,105,0x4a771933F09c667F851CF24CDd4AEBa000f99790,0xc648C3D1aDC58C9F318aAF8F5A197cd599b1F193
6414,15627875,46286,8807675848,45642,644,138,543,0x1EA48B9965bb5086F3b468E50ED93888a661fc17,0x1B69c4A788aD8f940e624341AB45c731D01190De
6415,15627875,289393,8807675848,286865,2528,522,486,0x283Af0B28c62C092C9727F1Ee09c02CA627EB7F5,0x36966A187BDEb677078B2c1543F71e911E5d47a2
6416,15627875,21000,8807675848,21000,0,2,34,0x54C5eEC2d5c00FDd322d437e8B82236E527EDFB5,0xb819c80304078e653787B5775591971376ABA8eB
6417,15627875,64375,8807675848,63423,952,202,2,0xea20dDf1782b059fae738d87aC15E1C5dE17ca26,0xB47a8ED63b4AEa9EAA6D4B508f40626027d79EAd
6418,15627875,46267,8807675848,45691,576,74,371,0x283Af0B28c62C092C9727F1Ee09c02CA627EB7F5,0x9AB5657982689c38eDC358004e8cAB744aA710b0
6419,15627875,27938,8807675848,27874,64,10,747,0xC02aaA39b223FE8D0A0e5C4F27eAD9083C756Cc2,0x1B56EB67F280ADd7cFE89727aCa1134274443a39
6420,15627875,203206,8807675848,201042,2164,586,162,0xFbdDaDD80fe7bda00B901FbAf73803F2238Ae655,0xB78F8440a21a3128439BE04ac257703EE549a41E
6421,15627875,99226,8807675848,98630,596,138,55,0xA0b86991c6218b36c1d19D4a2e9Eb0cE3606eB48,0x24dfa3F06e7833F10847f6c8cB1952C0A77e0c1a
6422,15627875,37999,8807675848,37307,692,138,3,0xa71d0588EAf47f12B13cF8eC750430d21DF04974,0x98ECf0FC8394042a45e0F02587C65c01d89dbA8c
6423,15627875,49175,8807675848,48687,488,138,633,0x7f738Ad7072187909384B2ffBaEEdC3C1DA1b686,0x6CFbA31B89974acD050d5cAf48Ae92A12Ed160B9
6424,15627875,123784,8807675848,122816,968,330,221,0x4e32004D8b81847A670b4a1778ACe4dCF2bBA01E,0x27A73ADC21324Af52E2Ab15b3Bd076b5d65d860b
6425,15627875,216525,8807675848,213765,2760,650,1893234,0xD1669Ac6044269b59Fa12c5822439F609Ca54F41,0xD2C82F2e5FA236E114A81173e375a73664610998
6426,15627875,202043,8807675848,199295,2748,650,1893235,0xD1669Ac6044269b59Fa12c5822439F609Ca54F41,0xD2C82F2e5FA236E114A81173e375a73664610998
6427,15627875,195815,8807675848,189163,6652,1810,2204,0x00000000006c3852cbEf3e08E8dF289169EdE581,0xF6926D15fC0Ee0113aC4840E7d881D92Cf193a7d
6428,15627875,289463,8807675848,287103,2360,522,211,0x283Af0B28c62C092C9727F1Ee09c02CA627EB7F5,0xb4a53b85a873A5fFa6fBe995E39107C9C1bCd935
6429,15627875,232130,8807675848,228502,3628,1162,569,0x68b3465833fb72A70ecDF485E0e4C7bD8665Fc45,0x20563eA21269A67f298346932c8EDf8a2c8f16A3
6430,15627875,162707,8807675848,152187,10520,3402,1719,0x00000000006c3852cbEf3e08E8dF289169EdE581,0x6742DC28e16Fe31189EB111B1Ab6Bb953561b6B0
6431,15627875,216881,8807675848,210405,6476,1746,195,0x00000000006c3852cbEf3e08E8dF289169EdE581,0xda4c111B94cC6ffF12bAaCA83D615AC5489b314A
6432,15627875,175602,8807675848,168470,7132,1930,245,0x00000000006c3852cbEf3e08E8dF289169EdE581,0xd4b4FDa41B6c3B45e5c60DB35FE3ACC9e49CDB73
6433,15627875,143217,8807675848,136689,6528,1802,75,0x00000000006c3852cbEf3e08E8dF289169EdE581,0x546367D801a949107A95Cd1D591C741078598fF3
6434,15627875,21000,8807675848,21000,0,2,1,0xE4a958027Ffdd183cD3134C3b94ADF82FFc03f4a,0x96637b68b8dD242961D77116B935D4A9f5038db8
6435,15627875,72866,8807675848,71006,1860,458,107,0xFbdDaDD80fe7bda00B901FbAf73803F2238Ae655,0x17c852867106C351516D4ccC2bd5810D49B224B2
6436,15627875,55904,8807675848,54960,944,138,114,0x011b0beAe3eC5953B4805b064cC78f6F892A99cC,0x3864e0699a3d50b734A2C801cf92CE2A8906Dc3a
6437,15627875,21000,8807675848,21000,0,2,28,0x0CAFCCC656f7E3F0Ec6a961dbF1Cd723C7e95A9B,0x4286262EC04cBE19d85944441a09Ca44C567B27a
6438,15627875,203413,8807675848,199833,3580,1162,104,0x68b3465833fb72A70ecDF485E0e4C7bD8665Fc45,0x29AFa8C4ceaE4E91695bdE9F0C280f729c5030FB
6439,15627875,361830,8807675848,357002,4828,1546,1102,0x68b3465833fb72A70ecDF485E0e4C7bD8665Fc45,0xc8caaf4374d7833594d3e63c5c2364Bc654F9CB3
6440,15627875,21000,8807675848,21000,0,2,9,0xA5256793A152226A10fEBD38Fc2B267e5feca5fA,0x702E9f185d6cDfD6b076d9Db3D10fBC27F75883c
6441,15627875,101221,8807675848,99629,1592,330,4,0x4976fb03C32e5B8cfe2b6cCB31c09Ba78EBaBa41,0xbA7A9701A17577438bA4C6A678B533404cEF3Be0
6442,15627875,329058,8807675848,324714,4344,1034,1,0x197492CCB4B1acaAAcd43432657A17832E36AB49,0xaA072f4427c07E1F222e39984deb05bE98DE4328
6443,15627875,46663,8807675848,46175,488,138,376,0x236672Ed575E1e479b8E101AEeb920F32361f6F9,0x5Db71204C7D9a9a23359676aE159eD28D2fF4523
6444,15627875,21000,8807675848,21000,0,2,18,0xC723e161809D5F4382d31EA20ac817488c1D7131,0xf48E977751858e37912Ff443c6F4F3cd5057A3A6
6445,15627875,405246,8807675848,401642,3604,1162,9,0x68b3465833fb72A70ecDF485E0e4C7bD8665Fc45,0xf51f8d02F3361EFC60D11Ac5d91360D81168B217
6446,15627875,74392,8807675848,72440,1952,330,1,0x00000000000C2E074eC69A0dFb2997BA6C7d2e1e,0x5B072e124297e7C5e39575174c609220b230CEd8
6447,15627875,29573,8807675848,29097,476,138,41,0x3A472c4D0dfbbb91ed050d3bb6B3623037c6263c,0x84De5F6794C9438A5aAaCeFE1248194064428CD3
6448,15627875,113118,8807675848,112786,332,138,1780,0xEC568fffba86c094cf06b22134B23074DFE2252c,0x49D2db5F6C17a5A2894f52125048aAA988850009
6449,15627875,175971,8807675848,173199,2772,842,280,0x68b3465833fb72A70ecDF485E0e4C7bD8665Fc45,0x906eA1f28992B948f6FEbBfD44E6541B13a3d0dF
6450,15627875,184002,8807675848,177578,6424,1738,781,0x00000000006c3852cbEf3e08E8dF289169EdE581,0xB8B31cBCeE619583045c0b80f76f9610D7D67F6B
6451,15627875,306418,8807675848,304046,2372,522,26,0x283Af0B28c62C092C9727F1Ee09c02CA627EB7F5,0x07d175E9a075aB47fB36b149207EEB650E5FDdA8
6452,15627875,782888,8807675848,778008,4880,1290,398,0x000000000000509081d6FCD3ee63e791aD1db763,0x4C16c40AeBb9c7d3d755AF80b15E843b5A058E00
6453,15627875,181476,8807675848,179912,1564,394,41,0x1Fa8559e873f698292766790AeCf8080A66433F6,0xd6f5a1eEA1991e216B37aC19bf34595d70710F04
6454,15627875,58676,8807675848,57732,944,138,0,0xdAC17F958D2ee523a2206206994597C13D831ec7,0x3c7F1E7D67f67a50A5D29899A7A5f486A30522b1
6455,15627875,46157,8807675848,45669,488,138,2920,0x55f1C36Bb7aE0d7D6caE97902E30A2306686Ec73,0x0338CE5020c447f7e668DC2ef778025CE398266B
6456,15627875,99262,8807675848,98642,620,138,9,0xA0b86991c6218b36c1d19D4a2e9Eb0cE3606eB48,0x3583d5bF1b06EB6c950B680F94503827B85E15d9
6457,15627875,21000,8807675848,21000,0,2,3035,0x4248E7C9B1f45FC8C479eA9bE8db719c95B0dCA8,0xf2E9db3c5D06015833Df31eD3C37172a2B34EE7F
6458,15627875,21000,8807675848,21000,0,2,5,0x6233d3554CA70DC071F56450f496bf2300C9D972,0x6eF314FE7C08Cb78D58Df1995dE6CdF2060435F9
6459,15627875,377080,8807675848,373476,3604,1162,203,0x68b3465833fb72A70ecDF485E0e4C7bD8665Fc45,0xC5AEF555182FaD33C4f156E4033FfCD12eff9d8e
6460,15627875,264451,8807675848,253067,11384,3210,103,0x4976fb03C32e5B8cfe2b6cCB31c09Ba78EBaBa41,0x66Bdf4461070Eb2997fDd66922376Ed83dDED95E
6461,15627875,444025,8807675848,420681,23344,8146,162,0x00000000006c3852cbEf3e08E8dF289169EdE581,0x2BaF623bdff8b5a80b39Ebada5B3a05EC7DD747c
6462,15627875,27938,8807675848,27874,64,10,186,0xC02aaA39b223FE8D0A0e5C4F27eAD9083C756Cc2,0x8E5Fc124a234B4AD7691fbb4De28Dd3029Eb2561
6463,15627875,49175,8807675848,48687,488,138,472,0xD27dcbcC8778a8AB33AAc529Df36a634567Be325,0x970DeC26bA135ac56e498d44A3eE1431A01A5A46
6464,15627875,97246,8807675848,82690,14556,4874,234,0x00000000006c3852cbEf3e08E8dF289169EdE581,0x2fAE61c7b7e0c073a69Fe687CE977Ac33565F9AD
6465,15627875,46631,8807675848,46059,572,138,695,0xaE351b8Ae55B69A5007618E598dDe89d0a092c37,0xCBA9B01C02B38b058052f5F90C62CAdd9176f274
6466,15627875,179614,8807675848,167666,11948,3786,282,0x00000000006c3852cbEf3e08E8dF289169EdE581,0x4B5aF9A639eB60Edaa3164235371BcEAB1a0F791
6467,15627875,145570,8807675848,142810,2760,842,189,0x68b3465833fb72A70ecDF485E0e4C7bD8665Fc45,0x6BfE59e8fEaDDfBdBb97F7Da8c6B4550a8bD4ffd
6468,15627875,288817,8807675848,286469,2348,522,258,0x283Af0B28c62C092C9727F1Ee09c02CA627EB7F5,0x34A19a7fd3383e89C943B3E44073c4d21837695C
6469,15627875,143229,8807675848,136689,6540,1802,76,0x00000000006c3852cbEf3e08E8dF289169EdE581,0x546367D801a949107A95Cd1D591C741078598fF3
6470,15627875,146672,8807675848,140108,6564,1802,381,0x00000000006c3852cbEf3e08E8dF289169EdE581,0x9F96c987f70aa929118e6B333e36a06742785806
6471,15627875,127718,8807675848,124654,3064,586,0,0x72a06bf2a1CE5e39cBA06c0CAb824960B587d64c,0xa516B3825ab8626711Cb1d6F631a0Ed67189EECA
6472,15627875,215918,8807675848,212266,3652,1162,13,0x68b3465833fb72A70ecDF485E0e4C7bD8665Fc45,0x4bC32c75f4DE5AFD4098cd0AA394AD4cD4996dfc
6473,15627875,53999,8807675848,53427,572,138,121,0x6de7aC835EC6841Af9b94fd1273dB83B8d69e3f7,0x1297956c62Fb438deaC7eE81AeFC1076b4f24B04
6474,15627875,157481,8807675848,155609,1872,842,526,0x7239F01C663f3c9fD7A44cB2BC8d19B67bdD1336,0xa8771fD60920f165Fb4E4CFCA2Cb1ab055f9ED53
6475,15627875,342486,8807675848,337646,4840,1546,162,0x68b3465833fb72A70ecDF485E0e4C7bD8665Fc45,0x32824719A58b4A11628E2826de26f10411799299
6476,15627875,150156,8807675848,143528,6628,1810,88,0x00000000006c3852cbEf3e08E8dF289169EdE581,0x1095d6C40aBFf548BFF36342E923E5AdC04D1E88
6477,15627875,302952,8807675848,270564,32388,5642,30158,0xA0c68C638235ee32657e8f720a23ceC1bFc77C77,0x65A8F07Bd9A8598E1b5B6C0a88F4779DBC077675
6478,15627875,21000,8807675848,21000,0,2,1,0x0Ac650F878Cc45a23727fA13B67d019B37B379BA,0xC679F875351eFfdd3d35E6d18A52c1F45663841c
6479,15627875,99226,8807675848,98630,596,138,73,0xA0b86991c6218b36c1d19D4a2e9Eb0cE3606eB48,0xc4b4782A4909928D08ABD7F89e911531996BC91E
6480,15627875,181476,8800000000,179912,1564,394,303,0x1Fa8559e873f698292766790AeCf8080A66433F6,0x126bDBcB92F139C0Db62FC9aeec56A661E903C05
6481,15627875,100504,8425612349,100440,64,10,2,0x65c2e54a4c75ff6da7b6B32369c1677250075fb2,0x44f47B09Bcb4532a3492D1bB3000ff582A7b21C3
6482,15627875,250000,8307675848,250000,0,2,45337105,0xC31F76278Fd10ad4471852Dc95BAD5E881D23692,0xEA674fdDe714fd979de3EdF0F56AA9716B898ec8
6483,15627875,250000,8307675848,250000,0,2,45337106,0x2a8E4A8633ADd1c115ef2d2516fA76F976872D93,0xEA674fdDe714fd979de3EdF0F56AA9716B898ec8
6484,15627875,250000,8307675848,250000,0,2,45337107,0x3e51461f9f0bB48a957E8b3b089A909c260A2cd6,0xEA674fdDe714fd979de3EdF0F56AA9716B898ec8
6485,15627875,250000,8307675848,250000,0,2,45337108,0xd6E7bd4A3F081Ae33C962523B6f9266Af8B424aC,0xEA674fdDe714fd979de3EdF0F56AA9716B898ec8
6486,15627875,250000,8307675848,250000,0,2,45337109,0x8a257746b1c287Cd6f4f92Da3D6e99146814eaE5,0xEA674fdDe714fd979de3EdF0F56AA9716B898ec8
6487,15627875,250000,8307675848,250000,0,2,45337110,0x039949d8650ADF89dF809f79051E3A47d573C9d8,0xEA674fdDe714fd979de3EdF0F56AA9716B898ec8
6488,15627875,250000,8307675848,250000,0,2,45337111,0x246aCAf67960Ab23713a38454000Ed0a3dF489fB,0xEA674fdDe714fd979de3EdF0F56AA9716B898ec8
6489,15627875,250000,8307675848,250000,0,2,45337112,0x28D255B52D9faAf8d3Fd7ecaF7E4e718b74937Ad,0xEA674fdDe714fd979de3EdF0F56AA9716B898ec8
6490,15627875,250000,8307675848,250000,0,2,45337113,0x8f1Fd29EAaD66bcdeaBd6446407C5bfBe384D192,0xEA674fdDe714fd979de3EdF0F56AA9716B898ec8
6491,15627875,250000,8307675848,250000,0,2,45337114,0x876cCe459864828B7D65FE470082f58703485E37,0xEA674fdDe714fd979de3EdF0F56AA9716B898ec8
6492,15627875,317925,8307675848,314661,3264,1034,45,0x68b3465833fb72A70ecDF485E0e4C7bD8665Fc45,0xd50621a46607532Ea7ed6Aa944b05672a1044549
6493,15627875,181476,8307675848,179912,1564,394,2003,0x1Fa8559e873f698292766790AeCf8080A66433F6,0x786cAbb5E602D47Dc8365eF014412d6e4ee63427
6494,15627875,181476,8307675848,179912,1564,394,3038,0x1Fa8559e873f698292766790AeCf8080A66433F6,0xb585b60De71E48032e8C19B90896984afc6a660d
6495,15627875,181476,8307675848,179912,1564,394,1334,0x1Fa8559e873f698292766790AeCf8080A66433F6,0x8589F2Ef6353A2d4B771Ee3c9f8743A7D47Ddc47
6496,15627875,181476,8307675848,179912,1564,394,798,0x1Fa8559e873f698292766790AeCf8080A66433F6,0xA1CeBE38B72a91D37659D9E10968e17d5d1A52Bc
6497,15627875,181476,8307675848,179912,1564,394,410,0x1Fa8559e873f698292766790AeCf8080A66433F6,0xA66EA67a418693636e4E071c3Db5B5Fe8B71Dd7B
6498,15627875,181476,8307675848,179912,1564,394,6938,0x1Fa8559e873f698292766790AeCf8080A66433F6,0x0653e299Ee741808F12427277FC8a062d9C718E1
6499,15627875,181476,8307675848,179912,1564,394,3317,0x1Fa8559e873f698292766790AeCf8080A66433F6,0x5d70a49E217DBdC1a5049542d70C0fAfba5E6bF2
6500,15627875,181476,8307675848,179912,1564,394,61,0x1Fa8559e873f698292766790AeCf8080A66433F6,0x37A4Fe4C5FbFb03504E22E1C94135A09ddC6531a
6501,15627875,181476,8307675848,179912,1564,394,302,0x1Fa8559e873f698292766790AeCf8080A66433F6,0x6aee11de0a0Ca9DFf7a8543FC5e55268df30c831
6502,15627875,181476,8307675848,179912,1564,394,780,0x1Fa8559e873f698292766790AeCf8080A66433F6,0xB09A3Dbf9d37b5b8472f55b4a5B95DDd9D376D9D
6503,15627875,181476,8307675848,179912,1564,394,411,0x1Fa8559e873f698292766790AeCf8080A66433F6,0xA66EA67a418693636e4E071c3Db5B5Fe8B71Dd7B
6504,15627875,181476,8307675848,179912,1564,394,549,0x1Fa8559e873f698292766790AeCf8080A66433F6,0xD98Dc21ae71606f11E5FB4Bd6BD8315BB1078D5d
6505,15627875,181476,8307675848,179912,1564,394,30,0x1Fa8559e873f698292766790AeCf8080A66433F6,0x3292d5C235f891A7Dfa8ea3df68eC515a3E8fc2d
6506,15627875,181476,8307675848,179912,1564,394,3318,0x1Fa8559e873f698292766790AeCf8080A66433F6,0x5d70a49E217DBdC1a5049542d70C0fAfba5E6bF2
6507,15627875,181476,8307675848,179912,1564,394,1761,0x1Fa8559e873f698292766790AeCf8080A66433F6,0x5bc05b93aE5c7cB44A8C78f13eFdb9e9EA209356
6508,15627875,255180,8307675848,255116,64,10,1263,0x3504d394b396E0a0Fe2A028C27bA84cca17Bf583,0x2Bb70959883302601AcB3C8Fdc83c031D80Be32b
6509,15627875,181476,8307675848,179912,1564,394,216,0x1Fa8559e873f698292766790AeCf8080A66433F6,0x3fe3a8fE534ae4Fcd8Fe355832deAe0BC344fD02
6510,15627875,21001,8222100000,21001,0,2,53,0x3819f64f282bf135d62168C1e513280dAF905e06,0x7C98A9d061d280481de819D31f49d8A494C7F4c3
6511,15627875,61633,8144634952,60689,944,138,2,0x6ADb2E268de2aA1aBF6578E4a8119b960E02928F,0xE5f204DA4d90034cEA9a5D3AC46291633E93e3D2
6512,15627875,2000000,8109069329,1997940,2060,522,403,0x7a250d5630B4cF539739dF2C5dAcb4c659F2488D,0xC1604496e206B7ff546c602Fdd5Ab69cF15f3DA7
6513,15627875,21000,8042306205,21000,0,2,32,0xca9a727cb44007206cB419955CCa7729199fB256,0xe77574207a1321a01721346B2bFe975FA6214Eef
6514,15627875,150000,7815548705,149392,608,138,638778,0xA0b86991c6218b36c1d19D4a2e9Eb0cE3606eB48,0x55FE002aefF02F77364de339a1292923A15844B8
6515,15627875,70000,7673715521,70000,0,2,323,0x27315f5F282c31fBADE4aE952d2631C05cD3a26F,0xc4f20b2cBDd108Fd8BE8db04EC854098322a6843
6516,15627875,123351,7553594352,122703,648,266,354,0x8D8A3e7EAdA138523c2dcB78FDbbF51A63A3faAD,0x811B23e4Ab2B4BeAE94Db8a7Ff143c417Af3CD9c
6517,15627875,88517,7507887312,87617,900,266,150,0xd588b586D61C826A0e87919b3D1a239206d58bf2,0xdF2B5ae21772d879068eC6df25eFBa8Cfb2089b4
6518,15627875,80000,7371881208,79056,944,138,0,0x0D8775F648430679A709E98d2b0Cb6250d2887EF,0x5658a08355887F0F43F357627cf4D96774D4617a
6519,15627875,21000,7326619434,21000,0,2,13,0x000F422887eA7d370FF31173FD3B46c8F66A5B1c,0xaD8De3Ea80e2f876c29f731d775497a454ce0842
6520,15627875,26000,7307675848,26000,0,2,12028,0xd4E96eF8eee8678dBFf4d535E033Ed1a4F7605b7,0xDAFEA492D9c6733ae3d56b7Ed1ADB60692c98Bc5
6521,15627876,176568,15585524031,175280,1288,190,5248,0x9507c04B10486547584C37bCBd931B2a4FeE9A41,0x99F03d6367f3f5240Fcf9712cdA1086E0F0D9F0a
6522,15627876,284827,12814660278,283455,1372,226,2960,0xc7EE7c66636f407586afa431C19A916e04928942,0x1dA543fa5bCBaA38B179a88861e9D47E7deb26CF
6523,15627876,63589,9542690429,63325,264,74,372,0xC02aaA39b223FE8D0A0e5C4F27eAD9083C756Cc2,0xeCAc677eA36b6cF68940702b268aa4D9ceDd3117
6524,15627876,302123,9850155768,296183,5940,1676,467,0x881D40237659C251811CEC9c364ef91dC08D300C,0x8318777F8b8A1e81243Abb5e58B3483D2138F257
6525,15627876,655012,26481815550,634488,20524,6226,30883,0x1111111254fb6c44bAC0beD2854e76F90643097d,0x6CBD3A415A440eE6514F0bC1e0bf22871343441f
6526,15627876,487349,18078585105,485313,2036,522,607,0x7a250d5630B4cF539739dF2C5dAcb4c659F2488D,0x3565104e6058D993FdC6aCb1828cD3d9e97Fc6bb
6527,15627876,21000,13600000000,21000,0,2,275,0xC098B2a3Aa256D2140208C3de6543aAEf5cd3A94,0x4D19b23bF96E1516F111786e8bA7c70ee638bd22
6528,15627876,300000,13078585105,298436,1564,394,6,0x1Fa8559e873f698292766790AeCf8080A66433F6,0x963b2ae4Ed59955bd950e1B0378515Ed6B5D9f62
6529,15627876,21000,12600000000,21000,0,2,5,0x500A746c9a44f68Fe6AA86a92e7B3AF4F322Ae66,0xa1e2f97A5F04520132b588D32D91d042b2B5D394
6530,15627876,181476,12078585105,179912,1564,394,1123,0x1Fa8559e873f698292766790AeCf8080A66433F6,0x612C45551195f15Bf05D722b9f137C914b077FC7
6531,15627876,84290,11878585105,83302,988,202,355153,0xA0b86991c6218b36c1d19D4a2e9Eb0cE3606eB48,0x7abE0cE388281d2aCF297Cb089caef3819b13448
6532,15627876,30065,11500000000,30065,0,2,57,0x43E493Ad584430EEEBeFeFcc153C284E9b7E7db7,0x303202E9097755AD69CC2Fde03bc5ba303Ee4Cd5
6533,15627876,100000,11275109140,99392,608,138,181437,0x473037de59cf9484632f4A27B509CFE8d4a31404,0x6238872A0Bd9F0E19073695532a7Ed77ce93C69E
6534,15627876,69881,11078585105,68937,944,138,39,0x011b0beAe3eC5953B4805b064cC78f6F892A99cC,0x51cCB5494CC7Babf31a8D5d8dF956778733B8fca
6535,15627876,21000,10605235507,21000,0,2,8,0xE3373Be8A26f89bFFD11057CBc543F731975c859,0x019C75e7335B443d2d0fE04Cc29CEBE6b86093F6
6536,15627876,21000,10605235507,21000,0,2,3,0x69991dac574A028f1f3267951616bd0fb9567C2B,0xae4B4332fB78162C3512Eb53CAe038D1BAC135De
6537,15627876,172350,10578585105,171922,428,138,218,0x28c6ea3F9cF9bC1a07A828fce1e7783261691B49,0x158DF9e0dF873286B1233CbA5F4965044cb779C8
6538,15627876,349525,10578585105,348877,648,266,40,0x98727FB35AdDf1eE92d62B36CeabFF1b5d3E2503,0x04bC337f14ad1F7ED42A03f89C5e44eF1cE792f9
6539,15627876,150756,10578585105,150692,64,10,1,0x65c2e54a4c75ff6da7b6B32369c1677250075fb2,0xf4b1B6Abfdc820e7507A2ba7730FeB181CF81c29
6540,15627876,21580,10578585105,21000,580,76,13470,0xaf65E45F4C0BD388F91EeB23cFCd52F4fCdd6Ee2,0xaf65E45F4C0BD388F91EeB23cFCd52F4fCdd6Ee2
6541,15627876,302498,10080535057,302498,0,2,117899,0x26bce6eCb5b10138e4bf14aC0ffcc8727FEF3B2e,0x26bce6eCb5b10138e4bf14aC0ffcc8727FEF3B2e
6542,15627876,207128,10078585105,207128,0,2,1679530,0xc7cba090E88d2DD8B6F00eF075c339ed12797bED,0x4976A4A02f38326660D17bf34b431dC6e2eb2327
6543,15627876,181476,10078585105,179912,1564,394,3,0x1Fa8559e873f698292766790AeCf8080A66433F6,0x27B7d84604168a77f4DEe6b9AA850C1Eb62C9984
6544,15627876,207128,10078585105,206520,608,138,3492282,0xdAC17F958D2ee523a2206206994597C13D831ec7,0x56Eddb7aa87536c09CCc2793473599fD21A8b17F
6545,15627876,207128,10078585105,207128,0,2,4708706,0xf958A34b11a361B075ac5eC398ba16C5A229C2FE,0x28C6c06298d514Db089934071355E5743bf21d60
6546,15627876,207128,10078585105,207128,0,2,4232340,0x69f369235421974Fab60f1B516f54C224dc5c46c,0xDFd5293D8e347dFe59E90eFd55b2956a1343963d
6547,15627876,39630,10078585105,39354,276,74,170,0xC02aaA39b223FE8D0A0e5C4F27eAD9083C756Cc2,0xcE64da4caf4c7D5A65c74Fbacb16E170d300285d
6548,15627876,207128,10078585105,206520,608,138,4708707,0xdAC17F958D2ee523a2206206994597C13D831ec7,0x28C6c06298d514Db089934071355E5743bf21d60
6549,15627876,207128,10078585105,206508,620,138,4232341,0xdAC17F958D2ee523a2206206994597C13D831ec7,0xDFd5293D8e347dFe59E90eFd55b2956a1343963d
6550,15627876,355402,10078585105,323686,31716,10826,13797,0x1eE3151cFf01321059e3865214379B85c79cA984,0xdAb1a1854214684acE522439684a145E62505233
6551,15627876,187983,10078585105,185163,2820,842,28,0x68b3465833fb72A70ecDF485E0e4C7bD8665Fc45,0x7b002aF38A1B385aba61996C6173952CefD65cF2
6552,15627876,220348,10078585105,213852,6496,1810,1444,0x00000000006c3852cbEf3e08E8dF289169EdE581,0xCA705afF2c65e9525174bd4654Ca5Dc855Fd8a20
6553,15627876,181476,10078585105,179912,1564,394,187,0x1Fa8559e873f698292766790AeCf8080A66433F6,0x3b3d5dB5Eaa36bf26a3b6909D35D2D449B70b714
6554,15627876,30732,10078585105,30668,64,10,600,0xC02aaA39b223FE8D0A0e5C4F27eAD9083C756Cc2,0x46C8D1C63dDf0E057431C78998a1F31Def926431
6555,15627876,42000,10078585105,42000,0,2,329538,0xf85c56F8305F2e84Ccc241dFAD379031472A239C,0x9430801EBAf509Ad49202aaBC5F5Bc6fd8A3dAf8
6556,15627876,85000,10078585105,84428,572,138,99,0xD27dcbcC8778a8AB33AAc529Df36a634567Be325,0x848E3b880EaC1F530bAe1Aa84D6ea4aECA7572A7
6557,15627876,85000,10078585105,84428,572,138,86,0xD27dcbcC8778a8AB33AAc529Df36a634567Be325,0xd285b457D8f74Ceb72d57BBC1ce30C9523860a16
6558,15627876,85000,10078585105,84428,572,138,72,0xD27dcbcC8778a8AB33AAc529Df36a634567Be325,0x9Fd2f5b668ea847F2a7E79f846CECA0a06Df2AaC
6559,15627876,70000,10000000000,69380,620,138,55,0xdAC17F958D2ee523a2206206994597C13D831ec7,0xc931763151f86FffAAebD963965313a006A51286
6560,15627876,75808,10000000000,75188,620,138,334,0xdAC17F958D2ee523a2206206994597C13D831ec7,0xb36eF8156Ba46448427cE98Ac1d29Be91Da554ae
6561,15627876,62089,10000000000,61433,656,138,46,0xd2877702675e6cEb975b4A1dFf9fb7BAF4C91ea9,0xAdF7269b19A8dC940e715Bb93bA602474562bDEb
6562,15627876,21000,10000000000,21000,0,2,5,0x70C48F3Ec8Be53867D9584DCD087FBe2aAB3122A,0x9C3F4CE9FAE3bd42c070122fAaC548d03Ad975A6
6563,15627876,21000,10000000000,21000,0,2,508310,0xD06B90f29F11eC11902F269fBD1F9D24f79d7f39,0x39F6a6C85d39d5ABAd8A398310c52E7c374F2bA3
6564,15627876,563222,9688585105,551390,11832,3914,296,0xDEF171Fe48CF0115B1d80b88dc8eAB59176FEe57,0x17D065070486Ca0fC8b4B382b946BE79Fb4fF10D
6565,15627876,70000,9620027188,69392,608,138,533,0xdAC17F958D2ee523a2206206994597C13D831ec7,0xf5491f793D47A6Ea22f5e0B9AD3990CF66c4b40B
6566,15627876,21000,9620027188,21000,0,2,4,0x8e84CAA8FDc1e1f5a22F44079e4E6De2893BdDeB,0x0c552eFd295Bb2FE4FCa8464163d73f429104490
6567,15627876,21000,9578585105,21000,0,2,105,0xF89AC992C4F59664DEe4f9BF9d4a976d412A43ff,0x30608D51cB263EbDf62051Ac8a4BD66f84a4bac4
6568,15627876,200000,9578585105,199356,644,138,0,0xe28b3B32B6c345A34Ff64674606124Dd5Aceca30,0xAa24F837A2d39aE5Ebe24043407cDcDc4Bd40B97
6569,15627876,21000,9578585105,21000,0,2,980,0xafd4a3232a0345f5D15159e6E8f3A5960CDeC89E,0xd011878cBEE251d148857A58EB737ADc3A4a9e98
6570,15627876,46280,9578585105,45420,860,138,154,0xC02aaA39b223FE8D0A0e5C4F27eAD9083C756Cc2,0x26c8a2C7175F53fc85438D343B5d5C2cC5F46751
6571,15627876,77391,9578585105,76759,632,138,821,0xC02aaA39b223FE8D0A0e5C4F27eAD9083C756Cc2,0x8Ad52C3AB4233341f7a5B25DD0eBC4dcc26C53Ee
6572,15627876,94795,9578585105,94199,596,138,4,0xdAC17F958D2ee523a2206206994597C13D831ec7,0x76E3Ad086D33824AB6a39232aa37CeEd7bFBF6A4
6573,15627876,99226,9578585105,98630,596,138,69,0xA0b86991c6218b36c1d19D4a2e9Eb0cE3606eB48,0xBcd82a987C890274B4cB0274dFfe63201FA82460
6574,15627876,194333,9578585105,187825,6508,1738,418,0x00000000006c3852cbEf3e08E8dF289169EdE581,0x99B5F5adAb46Ecd6b942A45097397408E8A05ae5
6575,15627876,46267,9578585105,45691,576,74,295,0x283Af0B28c62C092C9727F1Ee09c02CA627EB7F5,0xBd3aE808d527a8d17531274A4a604eEd708f73Dd
6576,15627876,238584,9578585105,234252,4332,1034,122,0xcCbCa4F9651Ef122D58d7EC5acCa27D806840209,0x1a083628b6Acfec6f80d623cc71f48E7045c2a2D
6577,15627876,21644,9578585105,21000,644,138,11,0x7ceB23fD6bC0adD59E62ac25578270cFf1b9f619,0x682Cad157D79d73Eb1D93d036B438d6F05084736
6578,15627876,495288,9578585105,494932,356,138,3,0x2b591e99afE9f32eAA6214f7B7629768c40Eeb39,0xe8f772032992aaf48Ebe6acD7101762A473a17f9
6579,15627876,21000,9578585105,21000,0,2,384,0xCa20557ab716842773b8B0C51462a32502774954,0xBb6F57d9736e845A133F8164CD46A833699E65aA
6580,15627876,46859,9578585105,46371,488,138,667,0x197492CCB4B1acaAAcd43432657A17832E36AB49,0x4306584e0B233AE9c1E6C154A9Ff230FC2E06AA3
6581,15627876,94813,9578585105,94205,608,138,71,0xdAC17F958D2ee523a2206206994597C13D831ec7,0xb231E5B824119E2a7AE637eb6a68bBfAfa059af6
6582,15627876,200000,9578585105,199344,656,138,0,0xBB0E17EF65F82Ab018d8EDd776e8DD940327B28b,0xf755285e0940b909e306eA17BeEA1415b1c9A605
6583,15627876,379570,9578585105,377366,2204,906,982,0xDd49A93FDcae579AE50B4b9923325e9e335ec82B,0x0FED94bA4F477AE9cDDF413a4b16f6e63405d043
6584,15627876,278821,9578585105,278617,204,74,471,0x55f1C36Bb7aE0d7D6caE97902E30A2306686Ec73,0x36151eF8bF252eB963235fd76245B98580D595F0
6585,15627876,249716,9578585105,244776,4940,1482,490,0x68b3465833fb72A70ecDF485E0e4C7bD8665Fc45,0x04Aa48f7e1e5011FAAe6A19723ce79e5421f645c
6586,15627876,200000,9578585105,199356,644,138,0,0x3845badAde8e6dFF049820680d1F14bD3903a5d0,0xeA1E5Ad97A124E15F209959a39f7c77BEFB1cD79
6587,15627876,49515,9578585105,49027,488,138,42,0x2839Db13B229eb059ebB457b5Cb168D0604Da1db,0x3106804Fc9E3A769aDD46c28712a1f1EA960D441
6588,15627876,21000,9578585105,21000,0,2,483,0xdeB35278D298d781faBd43Db9e22F56f81C21AF6,0x7f6735484aAAbb863955Fb029B602ABCf9626F3B
6589,15627876,46103,9578585105,45615,488,138,5863,0x346378C67d0F71343F80299ed8C0407aC2Df05eB,0x3FB65FEEAB83bf60B0D1FfBC4217d2D97a35C8D4
6590,15627876,156383,9578585105,149731,6652,1810,724,0x00000000006c3852cbEf3e08E8dF289169EdE581,0x6393Ea33B25528D50Df724460C4465187EAd1403
6591,15627876,45696,9578585105,45064,632,138,2,0x12b6893cE26Ea6341919FE289212ef77e51688c8,0x8d8C97a015937e2A54b497130D00c22935594e32
6592,15627876,55951,9578585105,55007,944,138,198,0x04B9788559Db3869eB48C76acaC7Af17c0165B00,0x3dE360223Ee281E7baEA41CB9BaAc4DdE16eD157
6593,15627876,71709,9578585105,69513,2196,458,117,0x74312363e45DCaBA76c59ec49a7Aa8A65a67EeD3,0x78fEd80ac6Dee33C1eE92fe4D91DaBB775CC1048
6594,15627876,204476,9578585105,186536,17940,4490,418,0x00000000006c3852cbEf3e08E8dF289169EdE581,0xB8ef7f2082a0783aef1a8F85ecf89f06CD94F812
6595,15627876,21560,9578585105,21000,560,138,12,0x5E40037d3C0b2aFA1495582431f27a83d199a6D8,0x682Cad157D79d73Eb1D93d036B438d6F05084736
6596,15627876,69145,9578585105,68549,596,138,410,0xdAC17F958D2ee523a2206206994597C13D831ec7,0x9360cb09D73a7908F6692165868374DE5d955886
6597,15627876,143229,9578585105,136689,6540,1802,77,0x00000000006c3852cbEf3e08E8dF289169EdE581,0x546367D801a949107A95Cd1D591C741078598fF3
6598,15627876,21000,9578585105,21000,0,2,19,0xFeE2ECefE093bB8CBfe40a66E36cbdC5e1212933,0xf48E977751858e37912Ff443c6F4F3cd5057A3A6
6599,15627876,46267,9578585105,45691,576,74,3813,0x283Af0B28c62C092C9727F1Ee09c02CA627EB7F5,0xe519e5EB81F92bF19EcFc7e5d9c6418CD8c2E0B9
6600,15627876,21000,9578585105,21000,0,2,324,0x524506DE26B5D706FeaaF97A34552CDac6645C34,0x23d8646672cDca0b3261adc46aA2d5A44B0A56EB
6601,15627876,99226,9578585105,98630,596,138,50,0xA0b86991c6218b36c1d19D4a2e9Eb0cE3606eB48,0x9E8371624a617066Be39070C21cF019C0953E8D7
6602,15627876,21000,9578585105,21000,0,2,1715,0xBa98130C362431039e34638508c9EB57623D433E,0x2dB2053E75Bcd9e448E171086935A263E0f8D32E
6603,15627876,46185,9578585105,45697,488,138,377,0x4CEAe3C1c32471bfAeE9420C922B32590790734C,0x5Db71204C7D9a9a23359676aE159eD28D2fF4523
6604,15627876,308107,9578585105,304063,4044,1226,108,0x68b3465833fb72A70ecDF485E0e4C7bD8665Fc45,0x6aC20BF955649752F7a7797A4BC98FBAA1e9af8D
6605,15627876,21000,9578585105,21000,0,2,2,0x3548F5bF82FaCF61D3BdC08000b23652AC63098C,0x896220C8954C15546781078b6C77A6d858BC4D6d
6606,15627876,115530,9578585105,115326,204,74,4,0x184f3FAd8618a6F458C16bae63F70C426fE784B3,0xAab1Ba4198054D5078aE1c955E2224a6B61103dB
6607,15627876,139478,9578585105,138654,824,330,239,0xA544fF15ce113fC927374858a0F0F5554249294b,0xd8fd0ae6076B3D643543B7C7D386d5425bb48284
6608,15627876,21000,9353936099,21000,0,2,16900,0x610d9F80dCC1a834E830E3729d4D31243A0DF2DD,0xDf8DD5e0b4168f20a3488Ad088dDB198fE602Cb3
6609,15627876,55930,9078585105,54986,944,138,4,0x67B6D479c7bB412C54e03dCA8E1Bc6740ce6b99C,0xF2673cb3b22212005f1cCE6515c942B7cD4Aa31c
6610,15627876,200000,9078585105,199392,608,138,0,0xA0b86991c6218b36c1d19D4a2e9Eb0cE3606eB48,0x78418eAdDFbbfa9c60ced65445647848396D6Aae
6611,15627876,186855,9078585105,183239,3616,1162,1,0x68b3465833fb72A70ecDF485E0e4C7bD8665Fc45,0x16D6746d7158432B1206227f3425D7936EDA95d2
6612,15627876,21000,9078585105,21000,0,2,24,0x1be06A045EA2e4949366e303ABcf41dEc9052976,0x123dFbaE0C505598980077F0C4a8E895d464F5DE
6613,15627876,181476,9078585105,179912,1564,394,217,0x1Fa8559e873f698292766790AeCf8080A66433F6,0x3fe3a8fE534ae4Fcd8Fe355832deAe0BC344fD02
6614,15627876,46076,9078585105,45588,488,138,84,0x57f1887a8BF19b14fC0dF6Fd9B2acc9Af147eA85,0x9Bf9762dC965c724bea17294Ab8FFbdaE8719e97
6615,15627876,181476,9078585105,179912,1564,394,3702,0x1Fa8559e873f698292766790AeCf8080A66433F6,0x1A05A7E4CC57897fCad9acf24F8418699Afb6469
6616,15627876,181458,9078585105,179906,1552,394,1013,0x1Fa8559e873f698292766790AeCf8080A66433F6,0xDe8E3bc6F225fa30911C7e36e13c13F7E51B98c1
6617,15627876,181476,9078585105,179912,1564,394,116,0x1Fa8559e873f698292766790AeCf8080A66433F6,0x203c622A19e328A792f1Ca451a079bA7451F6D6c
6618,15627876,150756,9078585105,150692,64,10,2,0x65c2e54a4c75ff6da7b6B32369c1677250075fb2,0xC519ABAf09fACFD2aB94067fa37730Cb5565b226
6619,15627876,181476,9078585105,179912,1564,394,2482,0x1Fa8559e873f698292766790AeCf8080A66433F6,0xeb6Bc3940C9fe8D7A90BAeB168F64F2FeCD9A5cE
6620,15627876,204792,9004362923,203572,1220,330,522,0x26FC1f11E612366d3367fc0cbFfF9e819da91C8d,0xcf5e233BcB1f1B3536E0879Be2D3294049d7bfC7
6621,15627876,753024,9000000000,748608,4416,1226,62,0xC36442b4a4522E871399CD717aBDD847Ab11FE88,0x680CfEA894cD0Bd8491c348795fa791F7386d235
6622,15627876,600000,8813215462,597956,2044,466,26,0x1111111254fb6c44bAC0beD2854e76F90643097d,0xdAC4F2FAE6e4828322696DD7bfBb6E4148C9569E
6623,15627876,55953,8813215462,55009,944,138,13,0xD371cE2BeB6b24195E790C561e4d86DD745E3c49,0x61D63e0C0e10Db3C43A705A3D54069fB033E67AC
6624,15627876,55374,8813215462,54730,644,138,4,0x7D1AfA7B718fb893dB30A3aBc0Cfc608AaCfeBB0,0xD7E56Fc27F5CB9a16Ec772FE52b639C6f1c93D07
6625,15627876,292363,8671627314,288847,3516,686,53738,0x0000000000007F150Bd6f54c40A34d7C3d5e9f56,0x048Fde2d3d47F54d3E7bE0Be7A40e1cb5AfF5d72
6626,15627876,600000,8644250341,598728,1272,458,59277,0xE544cF993C7d477C7ef8E91D28aCA250D135aa03,0x69f36eA1ebf4Ec9E53e3aaBF11CAF62b034ff3eE
6627,15627876,323978,8287648684,160358,163620,20678,183249,0x5E4e65926BA27467555EB562121fac00D24E9dD2,0x6887246668a3b87F54DeB3b94Ba47a6f63F32985
6628,15627876,21000,8287648684,21000,0,2,1,0xf76C5B19E86c256482f4aaD1dae620A0c3ac0Cd6,0x47DBF2DDF117c1357185828c60005b461577Ffbc
6629,15627876,21000,8213426502,21000,0,2,269,0x974CaA59e49682CdA0AD2bbe82983419A2ECC400,0xAc77e1fE8Be71A467C3CBD61381011B9e0DE23f7
6630,15627876,21000,8213426502,21000,0,2,34,0x974CaA59e49682CdA0AD2bbe82983419A2ECC400,0x9B90c3230465CeD747765AC02784b278244063E1
6631,15627876,21000,8213426502,21000,0,2,22,0x974CaA59e49682CdA0AD2bbe82983419A2ECC400,0xd86E840E377aD58c994a89A5C54324610DB38262
6632,15627876,51988,8213426502,51044,944,138,1651,0x72B169AD8aF6c4FB53056b6a2A85602Ad6863864,0x3d26b43dD2181471b46cF484dd8c06C47c050d4C
6633,15627876,297511,8213426502,295639,1872,458,87,0x7a250d5630B4cF539739dF2C5dAcb4c659F2488D,0xDda7690F497C81812AcAf6CCd5FCE6e573CD45F3
6634,15627876,30000,8078585105,30000,0,2,3671,0x388C818CA8B9251b393131C08a736A67ccB19297,0xF2f5C73fa04406b1995e397B55c24aB1f3eA726C
6635,15627877,250000,53000000000,250000,0,2,18572,0x2d574B46446F895c1AeAA746C1fFeC451Dafaf03,0x41b309236C87b1bc6FA8Eb865833E44158Fa991a
6636,15627877,21000,9757429774,21000,0,2,154,0x108a34B3BbDb4B3A87d8171A5BBa111e5dfC8ec9,0xf430392e40A3a7D68DeA5e7DAb22Be27Dc8f8895
6637,15627877,174214,9257429774,172262,1952,522,5,0xeF3739eE528B8D74D0C2a906Aa469C67233c6B44,0x2811d32Aec2030Cc66b6Eb46aE2Fe48Dd7Da7Aa3
6638,15627877,51406,9257429774,50918,488,138,29,0xC29F534013a5d9566C206ec0060c192e57741a7d,0xB2362053e77ceb3bFE79a0EF12959E847AB7415a
6639,15627877,21000,9257429774,21000,0,2,155,0xbb94657DEC1EC61F1967313d8aDB97E6D3b2aE04,0xD417d5cC5DFD013fB1773a9B6Cd4913C2AA754bD
6640,15627877,46103,9257429774,45615,488,138,40,0x346378C67d0F71343F80299ed8C0407aC2Df05eB,0xb6f2fbd8C9DFbC0D9042a48fD3d993F71fCc6252
6641,15627877,21000,9257429774,21000,0,2,453,0x8f1645828F36C9A2C7dFdA5875F6B78DaC138fB0,0xa7AA892Ae4D5c7645439073EFd784e0E9B6B73c2
6642,15627877,21000,8000000000,21000,0,2,1,0x868DBDc3845c40aA16c3E3b7E46675777B68c4E0,0xED01c1a2B93749dD3d204D019986daBC2a36aFA7
6643,15627878,499999,50000000000,498211,1788,458,142,0x7a250d5630B4cF539739dF2C5dAcb4c659F2488D,0x50dc990680ff369dB44e6a0B078BF31c8B5631dD
6644,15627878,499999,50000000000,498211,1788,458,0,0x7a250d5630B4cF539739dF2C5dAcb4c659F2488D,0x94F68aa774b6f71C67bA0A699809E0dBBcbc997E
6645,15627878,21000,50000000000,21000,0,2,206383,0x93E3f877a4d30D9CE00B62287A06aE9482FF7ef5,0xc35fB86F962ea955751a793a007B5CDd44F798D7
6646,15627878,21000,45000000000,21000,0,2,28,0xe68bF79618d1a1385fFD2656ab5E3fcDF4b737F3,0x9F3c6eE18275bD115A525500c16c2053866f9dC3
6647,15627878,21000,45000000000,21000,0,2,0,0xD86e3A116Bc98A354253dea47ffd36E86b1A1BC2,0xB2d686F4957C22d659D2c3480F8263C37B00E8f7
6648,15627878,200000,31130000000,199392,608,138,1205081,0xdAC17F958D2ee523a2206206994597C13D831ec7,0xFfec0067F5a79CFf07527f63D83dD5462cCf8BA4
6649,15627878,21000,20000000000,21000,0,2,32,0x494053eD39DA37C2aad5490a34e457F7E4163acF,0x15F1df685730adcb9E826548452C52Eee15f6299
6650,15627878,5049368,17000000000,5042268,7100,1098,290,0x0a39DA505DfB5E0BBc6bd84428281A8ba1bC7753,0x495E889d1A6cEB447a57dcc1C68410299392380c
6651,15627878,50000,15257429774,50000,0,2,2188239,0xffa2Ff9e5A2B9813Af15feBD880F396384b003B4,0x75e89d5979E4f6Fba9F97c104c2F0AFB3F1dcB88
6652,15627878,77356,15257429774,76748,608,138,2188240,0x467719aD09025FcC6cF6F8311755809d45a5E5f3,0x75e89d5979E4f6Fba9F97c104c2F0AFB3F1dcB88
6653,15627878,77356,15257429774,76736,620,138,2188241,0x467719aD09025FcC6cF6F8311755809d45a5E5f3,0x75e89d5979E4f6Fba9F97c104c2F0AFB3F1dcB88
6654,15627878,224794,14324977916,222970,1824,458,12,0xEfF92A263d31888d860bD50809A8D171709b7b1c,0xD16c628Fe3114BB816110bf09F3f7697B8A23B8a
6655,15627878,21000,14000000000,21000,0,2,3,0x500A746c9a44f68Fe6AA86a92e7B3AF4F322Ae66,0x58F350118e7fb44d77b154e4AeBCaE172caced78
6656,15627878,94690,13000000000,93638,1052,138,5683,0x5650CA3f0289C762F83DdE1894faA9b6d0d89798,0xe2A61FEcD0C671437dc486D6ceD280C1a13873C5
6657,15627878,350000,12405234083,350000,0,2,6925056,0x2687Ef59900D46CcbC4DA0A426CA3e3B1e69Ed80,0x46340b20830761efd32832A74d7169B29FEB9758
6658,15627878,100000,11990027398,99356,644,138,88,0x011b0beAe3eC5953B4805b064cC78f6F892A99cC,0xDda7690F497C81812AcAf6CCd5FCE6e573CD45F3
6659,15627878,334926,11808238489,333030,1896,458,213,0x7a250d5630B4cF539739dF2C5dAcb4c659F2488D,0x11cE31192602A36f4203b264da3132D2a5A9BF17
6660,15627878,46506,11000000000,45562,944,138,86,0x8B39B70E39Aa811b69365398e0aACe9bee238AEb,0x4669e6F2001a3035b8a0F94548976697BE539aE7
6661,15627878,291856,11000000000,287136,4720,1162,87,0xe66B31678d6C16E9ebf358268a790B763C133750,0x4669e6F2001a3035b8a0F94548976697BE539aE7
6662,15627878,170000,11000000000,169404,596,138,0,0xdAC17F958D2ee523a2206206994597C13D831ec7,0xD06B90f29F11eC11902F269fBD1F9D24f79d7f39
6663,15627878,50000,11000000000,50000,0,2,719000,0x24D96531B4de609De19d2e2DF3C29cfa0Ef9bc4f,0xA4e5961B58DBE487639929643dCB1Dc3848dAF5E
6664,15627878,400000,10773943289,399332,668,138,30884,0x321C2fE4446C7c963dc41Dd58879AF648838f98D,0x6CBD3A415A440eE6514F0bC1e0bf22871343441f
6665,15627878,97395,10551938644,96787,608,138,4709930,0xA0b86991c6218b36c1d19D4a2e9Eb0cE3606eB48,0x2FAF487A4414Fe77e2327F0bf4AE2a264a776AD2
6666,15627878,93850,10551938644,93242,608,138,355154,0xdAC17F958D2ee523a2206206994597C13D831ec7,0x7abE0cE388281d2aCF297Cb089caef3819b13448
6667,15627878,250000,10500000000,249344,656,138,6642,0x09a3EcAFa817268f77BE1283176B946C4ff2E608,0xD782E53A49D564F5fce4bA99555DD25d16d02a75
6668,15627878,1000000,10110931395,999568,432,74,34711,0x278dC748edA1d8eFEf1aDFB518542612b49Fcd34,0xBB437059584e30598b3AF0154472E47E6e2a45B9
6669,15627878,191041,10000000000,190165,876,266,1395,0xd588b586D61C826A0e87919b3D1a239206d58bf2,0xC22d03e13B888Dabb33A1575e4F6542f0e996622
6670,15627878,21000,10000000000,21000,0,2,168677,0x4F027bb401166D3CC6Ff2ea53b33fD03579Ef9d4,0x4E5B2e1dc63F6b91cb6Cd759936495434C7e972F
6671,15627878,21000,9996666080,21000,0,2,262,0xCBD6832Ebc203e49E2B771897067fce3c58575ac,0xf37509A330e22F2871ab949317e55B1EaD3FaFc2
6672,15627878,100000,9400000000,99024,976,202,705881,0xdAC17F958D2ee523a2206206994597C13D831ec7,0x6dfc34609a05bC22319fA4Cce1d1E2929548c0D7
6673,15627878,21000,10000000000,21000,0,2,705882,0x954da37b9322349898efa17d175618Ffc5AF9B8C,0x6dfc34609a05bC22319fA4Cce1d1E2929548c0D7
6674,15627878,21000,10000000000,21000,0,2,705883,0x2bECa0942AD36fC10a767a91411B2C35249BBb54,0x6dfc34609a05bC22319fA4Cce1d1E2929548c0D7
6675,15627878,69000,9208238489,68512,488,138,173,0xF3a1befc9643F94551c24A766Afb87383ef64dD4,0xF8c4917294bEEd728B0e6a078CA54503d268d982
6676,15627878,69000,9208238489,68512,488,138,193,0xF3a1befc9643F94551c24A766Afb87383ef64dD4,0x6B3fFABd36dDb8857b70119d0C200926c93D306F
6677,15627878,69000,9208238489,68512,488,138,187,0xF3a1befc9643F94551c24A766Afb87383ef64dD4,0x4e9B92f35d406Bfcc5DC25293496cDcb2d4AE1A4
6678,15627878,69000,9208238489,68512,488,138,154,0xF3a1befc9643F94551c24A766Afb87383ef64dD4,0x10bC3519C091CCf8cA154502706dAa7bF1Cd1488
6679,15627878,69000,9208238489,68512,488,138,157,0xF3a1befc9643F94551c24A766Afb87383ef64dD4,0x722f9469Fe0f11DB3A475d316Be6A2d522E7BDDD
6680,15627878,69000,9208238489,68512,488,138,149,0xF3a1befc9643F94551c24A766Afb87383ef64dD4,0x595f15e6e015eaB22F64dB690eAbC3a82223754C
6681,15627878,69000,9208238489,68512,488,138,175,0xF3a1befc9643F94551c24A766Afb87383ef64dD4,0xb24685fab9E4d790F548e6b5E2f68d9b03ECc98c
6682,15627878,69000,9208238489,68512,488,138,170,0xF3a1befc9643F94551c24A766Afb87383ef64dD4,0xB36461824ddF4b681A901BD988aF5ec84B16a787
6683,15627878,69000,9208238489,68512,488,138,157,0xF3a1befc9643F94551c24A766Afb87383ef64dD4,0x62451EB6B395bd8540920fE960486de8AB342bCa
6684,15627878,69000,9208238489,68512,488,138,166,0xF3a1befc9643F94551c24A766Afb87383ef64dD4,0xd3513bbe5c3470e9E9f5Eb38C7d749d8A27f886e
6685,15627878,69000,9208238489,68512,488,138,154,0xF3a1befc9643F94551c24A766Afb87383ef64dD4,0xc00C2c003Bf135DdE4AD5903Addab4AD6342514A
6686,15627878,69000,9208238489,68512,488,138,156,0xF3a1befc9643F94551c24A766Afb87383ef64dD4,0x832E2B01c565fC279A643c27EcC6e8201f3Bf687
6687,15627878,69000,9208238489,68512,488,138,152,0xF3a1befc9643F94551c24A766Afb87383ef64dD4,0x3753a1f853008f3d115e92938e8dA9817749eb03
6688,15627878,69000,9208238489,68512,488,138,154,0xF3a1befc9643F94551c24A766Afb87383ef64dD4,0xfFBC2B4FDd344B5CD42a8cA3eaA246Cc6AE0fBeE
6689,15627878,69000,9208238489,68512,488,138,161,0xF3a1befc9643F94551c24A766Afb87383ef64dD4,0xE0b077E55288aa333EE40fB6C2Ff96D868250dDa
6690,15627878,69000,9208238489,68512,488,138,160,0xF3a1befc9643F94551c24A766Afb87383ef64dD4,0xd6aad4530B90Af742BDdDCF13b476489EEC0fA9F
6691,15627878,69000,9208238489,68512,488,138,170,0xF3a1befc9643F94551c24A766Afb87383ef64dD4,0xF19E6cdB179E13d716a4029FE237EECB64ebB7CD
6692,15627878,58565,9120000000,57945,620,138,121,0xA0b86991c6218b36c1d19D4a2e9Eb0cE3606eB48,0x4C6599eC8659D8E9AeeD4C0156953b58C87ba353
6693,15627878,2000000,9116413552,1997940,2060,522,219,0x7a250d5630B4cF539739dF2C5dAcb4c659F2488D,0x3537c0a9D538c9dDA35CC8864e28075efbA5D698
6694,15627878,60907,9000000000,53271,7636,2506,1132,0x00000000006c3852cbEf3e08E8dF289169EdE581,0xecDA2c559aDE78ff0A3B1e5cF0ECd0d23143827b
6695,15627878,49280,8915585536,48684,596,138,0,0xA0b86991c6218b36c1d19D4a2e9Eb0cE3606eB48,0xBEAe018f3A87C8bFF9F99543565C3F1Bc0413C80
6696,15627878,21000,8855238489,21000,0,2,251063,0x88a924BC7FEdBc1008307298E0e20d780f580B42,0x8216874887415e2650D12D53Ff53516F04a74FD7
6697,15627878,21000,8855238489,21000,0,2,251064,0x5ca22dbA4a6661562E97Cc9C42b63D20147672a5,0x8216874887415e2650D12D53Ff53516F04a74FD7
6698,15627878,54184,8808238489,53612,572,138,530,0xD27dcbcC8778a8AB33AAc529Df36a634567Be325,0x2FC870C83cb84095715f3B479165CF5e5BfA7350
6699,15627878,54184,8808238489,53612,572,138,422,0xD27dcbcC8778a8AB33AAc529Df36a634567Be325,0x80CDb268e0eA2A22984024FF97C5c536EB8929F3
6700,15627878,54184,8808238489,53612,572,138,77,0xD27dcbcC8778a8AB33AAc529Df36a634567Be325,0x80A52aae0364715f36e31Fa592D07Aaa02cf410b
6701,15627878,54184,8808238489,53612,572,138,453,0xD27dcbcC8778a8AB33AAc529Df36a634567Be325,0x812F332def216F4C4E1Fa56d5Bf3607f1EaEc033
6702,15627878,54184,8808238489,53612,572,138,435,0xD27dcbcC8778a8AB33AAc529Df36a634567Be325,0x7BeB23a1B2Ab2103F2344429b543233586833fE6
6703,15627878,54184,8808238489,53612,572,138,517,0xD27dcbcC8778a8AB33AAc529Df36a634567Be325,0xC79F419598EcAdf64320dc6B5701Bf4fe476057a
6704,15627878,54184,8808238489,53612,572,138,79,0xD27dcbcC8778a8AB33AAc529Df36a634567Be325,0x091550e34477Ae4F55DE5482a5081745635b4777
6705,15627878,54184,8808238489,53612,572,138,446,0xD27dcbcC8778a8AB33AAc529Df36a634567Be325,0x306FDD1d17455E3685646BBC16C6A739Ad99C93C
6706,15627878,54184,8808238489,53612,572,138,82,0xD27dcbcC8778a8AB33AAc529Df36a634567Be325,0x95B89929D9D66FB8c158ab858F05CC6Fa36DA50A
6707,15627878,54184,8808238489,53612,572,138,84,0xD27dcbcC8778a8AB33AAc529Df36a634567Be325,0x9917118D1a7dd25C764cF3F7376249F38dc74c62
6708,15627878,54184,8808238489,53612,572,138,79,0xD27dcbcC8778a8AB33AAc529Df36a634567Be325,0x047cbbD15Fcc63218100e0893239f8518c62CE4D
6709,15627878,54184,8808238489,53612,572,138,437,0xD27dcbcC8778a8AB33AAc529Df36a634567Be325,0x4CF72c476d4ff1f69A5A1120f1FF3839e1215d53
6710,15627878,21000,8808238489,21000,0,2,0,0xb8bA36E591FAceE901FfD3d5D82dF491551AD7eF,0x736714e9C2a015E97DFb20cBc0588D1258B457ae
6711,15627878,54184,8808238489,53612,572,138,78,0xD27dcbcC8778a8AB33AAc529Df36a634567Be325,0xd314Fbcea2cf01237f4b1C31bd6c9F92D59f5AA0
6712,15627878,181476,8808238489,179912,1564,394,129,0x1Fa8559e873f698292766790AeCf8080A66433F6,0xd714F225a094077C4cb69a5e2341197EEe7AFABd
6713,15627878,54184,8808238489,53612,572,138,84,0xD27dcbcC8778a8AB33AAc529Df36a634567Be325,0xB67E3D9A90D523Db45516e7A1fc8eCA657EC9253
6714,15627878,54184,8808238489,53612,572,138,85,0xD27dcbcC8778a8AB33AAc529Df36a634567Be325,0xC09aED984376ACF1dbfB9AE5eb4a83AE9C59c7CA
6715,15627878,54184,8808238489,53612,572,138,439,0xD27dcbcC8778a8AB33AAc529Df36a634567Be325,0xE669aF9802D21c30e434c00e0f5Cb2832B850475
6716,15627878,54184,8808238489,53612,572,138,78,0xD27dcbcC8778a8AB33AAc529Df36a634567Be325,0x9d758481E7D38Bd367B02d720D94244CbF834150
6717,15627878,207128,8808238489,207128,0,2,1312155,0xAc8FBc015c758DEd57fEF530E8384881477974E1,0xf60c2Ea62EDBfE808163751DD0d8693DCb30019c
6718,15627878,54184,8808238489,53612,572,138,82,0xD27dcbcC8778a8AB33AAc529Df36a634567Be325,0xFfaaFe4d78Cc87bC38569330b33A59E07D2Adbf2
6719,15627878,42000,8808238489,42000,0,2,329539,0x43285D11c78520B6b6883805631f96204BAF8FdB,0x9430801EBAf509Ad49202aaBC5F5Bc6fd8A3dAf8
6720,15627878,207128,8808238489,206472,656,138,4708708,0x320623b8E4fF03373931769A31Fc52A4E78B5d70,0x28C6c06298d514Db089934071355E5743bf21d60
6721,15627878,207128,8808238489,206520,608,138,4708709,0xdAC17F958D2ee523a2206206994597C13D831ec7,0x28C6c06298d514Db089934071355E5743bf21d60
6722,15627878,75000,8808238489,74332,668,138,286,0x320623b8E4fF03373931769A31Fc52A4E78B5d70,0x93d0d1A8c0B16AbdF02b85D4a3cE7ada53C28238
6723,15627878,21000,8808238489,21000,0,2,6,0x8bf6DA3aeA14CB31a141F76D6Fc143613a900143,0x8BD737e1Ed1eF278e11BDB7933226629310af41F
6724,15627878,181476,8808238489,179912,1564,394,726,0x1Fa8559e873f698292766790AeCf8080A66433F6,0x2Aa21C914C5d43CB917e68eF263909F166B8Ba79
6725,15627878,75808,8808238489,67076,8732,1290,75,0x9495A029Ce34983C0bF0c45EE8214021E95dA26A,0x5012e2f6b9d81e96622BFA2F2764fcB406d8e6C1
6726,15627878,155546,8808238489,153966,1580,330,17,0x84c2b16FA6877a8fF4F3271db7ea837233DFd6f0,0xc9f69ff262e45C289d8488C59F46900915d9f352
6727,15627878,21000,8808238489,21000,0,2,8265756,0xA850B2ADe716017814d5cD8B9345EB4b33FeCE31,0xb5d85CBf7cB3EE0D56b3bB207D5Fc4B82f43F511
6728,15627878,249291,8808238489,244811,4480,1420,48,0x881D40237659C251811CEC9c364ef91dC08D300C,0x4239e68e2eF8E5F46EB85c480788a0aEB54605ff
6729,15627878,21000,8808238489,21000,0,2,185,0x240ff4Ca23442827309E950f685067217dCB71A9,0x72EA9c09588C8EA75487246D4b4AcABECAA5442c
6730,15627878,2000000,8808238489,1994912,5088,1226,171048,0xA9D1e08C7793af67e9d92fe308d5697FB81d3E43,0x7830c87C02e56AFf27FA8Ab1241711331FA86F43
6731,15627878,740000,8808238489,729028,10972,2506,23541,0x5E3c7bdf06C35f88c6c0De739ed1c04767e330F9,0x265b3Aaeb858F32Fe18CFc28EEA21977Fc379F3C
6732,15627878,21000,8808238489,21000,0,2,469167,0xb34c9dEC8E2F0d3320407664653Cf4c92935A978,0xb739D0895772DBB71A89A3754A160269068f0D45
6733,15627878,2000000,8808238489,1989460,10540,2314,171049,0xA9D1e08C7793af67e9d92fe308d5697FB81d3E43,0x7830c87C02e56AFf27FA8Ab1241711331FA86F43
6734,15627878,21000,8808238489,21000,0,2,6578036,0x43e6d6213FB0ee37E83564d384157EA5868A929c,0xeB2629a2734e272Bcc07BDA959863f316F4bD4Cf
6735,15627878,290761,8808238489,288365,2396,522,89,0x283Af0B28c62C092C9727F1Ee09c02CA627EB7F5,0x41Ad5F539133Dc08b22D55098a855a0b95de85cF
6736,15627878,21000,8808238489,21000,0,2,1211349,0x9f8FA959fCa0b76D0B70CAC667c29f88e90381c8,0x95A9bd206aE52C4BA8EecFc93d18EACDd41C88CC
6737,15627878,140059,8808238489,138519,1540,394,0,0x1Fa8559e873f698292766790AeCf8080A66433F6,0x96bB185aa3B115d4FD016A6640916Ec651Cc8F05
6738,15627878,140088,8808238489,138524,1564,394,0,0x1Fa8559e873f698292766790AeCf8080A66433F6,0x44b7f9A947FaaBeA50b148967D57d1a3Da042f22
6739,15627878,140088,8808238489,138524,1564,394,0,0x1Fa8559e873f698292766790AeCf8080A66433F6,0x818e63fB7Df6FfB523A07F93ED8cA28D0A39Dd54
6740,15627878,140088,8808238489,138524,1564,394,0,0x1Fa8559e873f698292766790AeCf8080A66433F6,0x4cFcfC5a236F99b849e5573CE6970aB6c0822912
6741,15627878,140088,8808238489,138524,1564,394,0,0x1Fa8559e873f698292766790AeCf8080A66433F6,0x8482aDB09BfDb95E82EcE7FF2a0216909b42Fb36
6742,15627878,140088,8808238489,138524,1564,394,0,0x1Fa8559e873f698292766790AeCf8080A66433F6,0x98c0404C8047B3bE5a4f428A594A95ba3eCB7A11
6743,15627878,140088,8808238489,138524,1564,394,0,0x1Fa8559e873f698292766790AeCf8080A66433F6,0xACc01D7Acd955b5DA425e338A0Ce4063e6752B53
6744,15627878,140088,8808238489,138524,1564,394,0,0x1Fa8559e873f698292766790AeCf8080A66433F6,0x0630cC517173E493D1C593F64a73e5C01A663C25
6745,15627878,140088,8808238489,138524,1564,394,0,0x1Fa8559e873f698292766790AeCf8080A66433F6,0x3A62896C27879e3b8557B862e0841734e532a177
6746,15627878,140088,8808238489,138524,1564,394,0,0x1Fa8559e873f698292766790AeCf8080A66433F6,0x91F5E297Dd9C72B1272DC68216a99DCC9B2f378e
6747,15627878,140073,8808238489,138521,1552,394,0,0x1Fa8559e873f698292766790AeCf8080A66433F6,0x0F3EDa6587B468AA556A82deAd2ef2f1e09c4E24
6748,15627878,140088,8808238489,138524,1564,394,0,0x1Fa8559e873f698292766790AeCf8080A66433F6,0x4bE143F5EBE0ff036Ad0A63CABA53135ab7B4c34
6749,15627878,140088,8808238489,138524,1564,394,0,0x1Fa8559e873f698292766790AeCf8080A66433F6,0x8118f30AD971AFB328DF6bc07ad5A185C1bDbF1D
6750,15627878,140073,8808238489,138521,1552,394,0,0x1Fa8559e873f698292766790AeCf8080A66433F6,0x75DEF8a617882E94D172690ad052afE590FbF318
6751,15627878,140088,8808238489,138524,1564,394,0,0x1Fa8559e873f698292766790AeCf8080A66433F6,0x1d0E79a272Ab88bE7D9Ac80543899BB363A36414
6752,15627878,140088,8808238489,138524,1564,394,0,0x1Fa8559e873f698292766790AeCf8080A66433F6,0xfa80cBc76516B9bA69F8dB8BD36E816e14D385d7
6753,15627878,140088,8808238489,138524,1564,394,0,0x1Fa8559e873f698292766790AeCf8080A66433F6,0x5d4d1b76865a2ab7EF3aF2590B2d814571D46476
6754,15627878,140073,8808238489,138521,1552,394,0,0x1Fa8559e873f698292766790AeCf8080A66433F6,0x434304E0800C65deD0C9B0eC0C2961C602F537be
6755,15627878,140088,8808238489,138524,1564,394,0,0x1Fa8559e873f698292766790AeCf8080A66433F6,0xe7272348eA4Dcc5e7835Ee3dAF72594eeA912bdc
6756,15627878,140088,8808238489,138524,1564,394,0,0x1Fa8559e873f698292766790AeCf8080A66433F6,0x6bF9bfc814089C878B5c97B515dBb0A3Ec8c683f
6757,15627878,140088,8808238489,138524,1564,394,0,0x1Fa8559e873f698292766790AeCf8080A66433F6,0xEf548aC3f4f2b2418E5BbB6A6255D7581420C254
6758,15627878,140073,8808238489,138521,1552,394,0,0x1Fa8559e873f698292766790AeCf8080A66433F6,0x3500eDb0F5Fed55b0360E3A286bdE979906fAdCD
6759,15627878,140073,8808238489,138521,1552,394,0,0x1Fa8559e873f698292766790AeCf8080A66433F6,0x5Cea5Ce361422b003c1BfF95e3F1627d55B8E462
6760,15627878,140088,8808238489,138524,1564,394,0,0x1Fa8559e873f698292766790AeCf8080A66433F6,0x2142dDbcFd90A40AD2AA29c634C32Ab1b078e44c
6761,15627878,140088,8808238489,138524,1564,394,0,0x1Fa8559e873f698292766790AeCf8080A66433F6,0x375d7544472179282C8531acD7ec671AF3D9F84d
6762,15627878,70000,8808238489,69392,608,138,534,0xdAC17F958D2ee523a2206206994597C13D831ec7,0xf5491f793D47A6Ea22f5e0B9AD3990CF66c4b40B
6763,15627878,140073,8808238489,138521,1552,394,0,0x1Fa8559e873f698292766790AeCf8080A66433F6,0xD99F469a08461B3c55E2A25E2d8D7eB7bb083c03
6764,15627878,78133,8808238489,77489,644,138,0,0x514910771AF9Ca656af840dff83E8264EcF986CA,0x5466594f146c2A516D2892dEaef3e38c24Db3a86
6765,15627878,63184,8760000000,63184,0,2,20,0x6dc07B1d5d7F107B20056A55E389D85C5aD47c77,0x08D5a1466D43b47038b919A073e67120a2459225
6766,15627878,21000,8623238489,21000,0,2,20,0x2108Ced73A30674A9dB5A8B22bE3BC8f5c79D8E3,0x76b36A038cd2086406120b2807258cD7b857308F
6767,15627878,236985,8474676732,228113,8872,2578,46630,0x1111111254fb6c44bAC0beD2854e76F90643097d,0x839d4641F97153b0ff26aB837860c479E2Bd0242
6768,15627878,21000,8308238489,21000,0,2,319,0x24CAd7ED3cf32E26a9577A87CEb5130f20BF6582,0x41009b7eaCD96B01687EC633962256ED1C433229
6769,15627878,46547,8308238489,46059,488,138,309,0xaE351b8Ae55B69A5007618E598dDe89d0a092c37,0xF904A3932979cBf4EEaAB3b588396883ebC360bA
6770,15627878,166745,8308238489,160145,6600,1802,137,0x00000000006c3852cbEf3e08E8dF289169EdE581,0x6aCb75E3bcAf3FEA600c7EB13Ce3278C47A342c8
6771,15627878,21560,8308238489,21000,560,138,13,0x5E40037d3C0b2aFA1495582431f27a83d199a6D8,0x682Cad157D79d73Eb1D93d036B438d6F05084736
6772,15627878,99244,8308238489,98636,608,138,7,0xA0b86991c6218b36c1d19D4a2e9Eb0cE3606eB48,0xe538e0a86d31b683F5fBaa42BC40Cd64F0AC6f18
6773,15627878,79572,8308238489,79168,404,138,473,0x2b591e99afE9f32eAA6214f7B7629768c40Eeb39,0xCF162B0bEBc44B49238D9C08398695868c6B30B5
6774,15627878,69163,8308238489,68555,608,138,98,0xdAC17F958D2ee523a2206206994597C13D831ec7,0x1c632152D528D0aa32624E0b2a410B4d97F7D0a2
6775,15627878,21000,8308238489,21000,0,2,96,0x5f719B085dfB7518556913cB5614188C066a2b55,0xEB15E979fb663AD9f2d2054b6AC432fB97744fDD
6776,15627878,142995,8308238489,136407,6588,1802,111,0x00000000006c3852cbEf3e08E8dF289169EdE581,0xCc1dD65746D5910362bE6201D598BE868C83dF32
6777,15627878,46957,8308238489,46289,668,138,237,0x06D5cA7C9accd15a87d4993A421B7e702BDBaB20,0x794DceEDd37e140553C161Fe230Ea80c76cdB622
6778,15627878,21000,8308238489,21000,0,2,274,0x7B2C05FDdd0d3d9179226Ca3dEd46A130338444F,0xbF14FdAdE69D44Ff8257cD80D79cd53A31c9F8db
6779,15627878,46682,8308238489,46194,488,138,2246,0x67df41EDf21e1c581A77E939f60db7bAa5E96993,0x81269781E647eb0843Dc3a8fEbC55a38cE69B4eB
6780,15627878,72878,8308238489,71006,1872,458,108,0xFbdDaDD80fe7bda00B901FbAf73803F2238Ae655,0x17c852867106C351516D4ccC2bd5810D49B224B2
6781,15627878,289303,8308238489,286943,2360,522,259,0x283Af0B28c62C092C9727F1Ee09c02CA627EB7F5,0x34A19a7fd3383e89C943B3E44073c4d21837695C
6782,15627878,55808,8308238489,54864,944,138,190,0x5B7533812759B45C2B44C19e320ba2cD2681b542,0xD12EC12A77D3f30844a58c2E992273B8152A2eD5
6783,15627878,21000,8308238489,21000,0,2,259,0x61E8e35BcD34DC81cf62C228daC20531baE4FEAb,0xAE147912e7d4d3863d11c7e3b2A9d9d692fBEDD5
6784,15627878,150756,8308238489,150692,64,10,3,0x65c2e54a4c75ff6da7b6B32369c1677250075fb2,0xB0DEF22328Aa13d1309058e6f94143A16BeAA82e
6785,15627878,21000,8308238489,21000,0,2,385,0x10c699e993857eB0430d5c63AF0d9E74Bc5637bb,0xBb6F57d9736e845A133F8164CD46A833699E65aA
6786,15627878,46127,8308238489,45639,488,138,378,0x9CE696322A7495b83f279DB6080314CF4d9f8C1f,0x5Db71204C7D9a9a23359676aE159eD28D2fF4523
6787,15627878,21000,8308238489,21000,0,2,8,0x1af98F8597Cd7de03Eea95e4b29E6d8AF120Cfc6,0x92B5c8D00502f235b221eDDDf8721e6f16B5a6A2
6788,15627878,127854,8308238489,127262,592,202,2,0x084b1c3C81545d370f3634392De611CaaBFf8148,0x2BA5D2DcA7fba8BCF712B979b8dc049076CA0EA3
6789,15627878,127854,8308238489,127262,592,202,3,0x084b1c3C81545d370f3634392De611CaaBFf8148,0x2BA5D2DcA7fba8BCF712B979b8dc049076CA0EA3
6790,15627878,52180,8308238489,51536,644,138,218,0xC0B376f1887b00b66De12cD0741618FCaAA6D47d,0xA57f1e4d7f08E5F4880E293A51d8bF3BdaFb44e2
6791,15627878,21000,8308238489,21000,0,2,36,0x00751EFAf82587F9C8E8314a8a7074Dc7f7AbB4a,0x03abBb58DfE52B58CaFd50239AB0606D8C2E1cAe
6792,15627878,21000,8308238489,21000,0,2,1716,0xD13d8625FAeE6695d88c63e181c3c9BEd5883D36,0x2dB2053E75Bcd9e448E171086935A263E0f8D32E
6793,15627878,271786,8308238489,268458,3328,970,1,0x68b3465833fb72A70ecDF485E0e4C7bD8665Fc45,0xbE56C177E41a2B8a37216b7816231b1C19B20594
6794,15627878,118019,8308238489,116211,1808,426,136,0x3ee18B2214AFF97000D974cf647E7C347E8fa585,0xE00973e3954135cCB87fc18C045dcf19585C48d4
6795,15627878,219592,8308238489,215548,4044,650,1,0x0E5598308BF8A2Dced4546C249BD267870F6A646,0x500A23B6DbC9125D6d2158899D6A2d7D23a6C496
6796,15627878,73188,8308238489,72580,608,138,42,0xA0b86991c6218b36c1d19D4a2e9Eb0cE3606eB48,0xb2b4dfB67f3AEBA9789659867188dD3c61c39B64
6797,15627878,46085,8308238489,45597,488,138,36,0x0A16305612706B4eabce43247D61Fe7fBED708E4,0xdb95a85DBBb2BfaeCBeFB72dA8A7f7d4bC334F66
6798,15627878,46076,8308238489,45588,488,138,19,0x57f1887a8BF19b14fC0dF6Fd9B2acc9Af147eA85,0xD61adcA4F4525187929B160f7743d45D4d32d4d5
6799,15627878,563795,8308238489,533267,30528,10634,1860,0x83C8F28c26bF6aaca652Df1DbBE0e1b56F8baBa2,0x97bDd734FcA8456dE0c98a7820f0F3907EF1BD83
6800,15627878,151223,8308238489,151159,64,10,2,0xb5588C411ba0bb7D38865fdC51D082d004e519F7,0xC679F875351eFfdd3d35E6d18A52c1F45663841c
6801,15627878,178697,8308238489,171465,7232,1938,103,0x00000000006c3852cbEf3e08E8dF289169EdE581,0x1B145997895bDc2079e6C77bca9E071B63DBe36D
6802,15627878,261103,8308238489,257451,3652,1162,143,0x68b3465833fb72A70ecDF485E0e4C7bD8665Fc45,0x818e05F1e9Bc6bDEC285D20374e60A05F9E5301b
6803,15627878,166745,8308238489,160145,6600,1802,126,0x00000000006c3852cbEf3e08E8dF289169EdE581,0xb03cB3d3df64c627096A497362792Ea01A38E1F2
6804,15627878,60707,8308238489,53271,7436,2514,8,0x00000000006c3852cbEf3e08E8dF289169EdE581,0xEEb72aBBA44B1eB80F20C50eC370d3073DccF88E
6805,15627878,46631,8308238489,46059,572,138,9,0xaE351b8Ae55B69A5007618E598dDe89d0a092c37,0xf1A4C08FB891BE86DB2E5892b23FfdcEa6eA360e
6806,15627878,73188,8308238489,72580,608,138,173,0xA0b86991c6218b36c1d19D4a2e9Eb0cE3606eB48,0xCc378bdDC3201c6B3189DC13F52F290D9C9F1Df6
6807,15627878,142178,8308238489,141902,276,74,544,0x8Bc3702c35D33E5DF7cb0F06cb72a0c34Ae0C56F,0x1B69c4A788aD8f940e624341AB45c731D01190De
6808,15627878,121753,8308238489,121689,64,10,88,0xD332A125ba3e5471980b7320e21884479143AF92,0x69A5C9B5c70e6464a050828615D520A24BD9C860
6809,15627878,61487,8308238489,53271,8216,2514,80,0x00000000006c3852cbEf3e08E8dF289169EdE581,0x14Edea867c14Eab93080f63375212b415144A585
6810,15627878,2083038,8308238489,2082562,476,138,43,0x30f8C50089d7b0f8db6bC95a71B01353FfE50968,0x64974Bcdb6e3ccA6035804D80550Bc7DFbDc6CfE
6811,15627878,73170,8308238489,72574,596,138,182,0xA0b86991c6218b36c1d19D4a2e9Eb0cE3606eB48,0xC2606254E1c3bD456B19650c9488F031823a8c77
6812,15627878,60081,8308238489,59461,620,138,44,0x5650CA3f0289C762F83DdE1894faA9b6d0d89798,0x4493BfD02f87Bf6F01440A91788E7cC280e6da1c
6813,15627878,163793,8308238489,157217,6576,1802,110,0x00000000006c3852cbEf3e08E8dF289169EdE581,0x3f98282FFBEA563d5ECef32E99dd46F127F7a0b7
6814,15627878,159466,8308238489,152902,6564,1802,726,0x00000000006c3852cbEf3e08E8dF289169EdE581,0x48FDDcfb47b32da5fA724d5c028DC3c15EdC6525
6815,15627878,163161,8308238489,162921,240,74,2777,0xf11ED77fD65840b64602526DDC38311E9923c81B,0x60acF8D95fd365122e56F414b2C13D9dc7742Ad7
6816,15627878,240558,8308238489,237798,2760,842,6,0x68b3465833fb72A70ecDF485E0e4C7bD8665Fc45,0x3232Ce1029A5f760b4aAC0dA5855633539568ad3
6817,15627878,267831,8308238489,248319,19512,4682,270,0x00000000006c3852cbEf3e08E8dF289169EdE581,0x77bC47264A515cEe4BA3652ff23cC83D365D1E0a
6818,15627878,46255,8308238489,45691,564,74,40,0x283Af0B28c62C092C9727F1Ee09c02CA627EB7F5,0x17E674A8cEb2D36edd5ff54D368F0c28a0a210B5
6819,15627878,51436,8308238489,50948,488,138,400,0x2912919719414a093deAC78031e90Ba493b8Da34,0x7cFBfE6a6C5a1089a542534C0c7F69e749f6b80f
6820,15627878,46122,8308238489,45634,488,138,524,0xf54cC94f1F2f5De012B6Aa51F1E7eBdc43Ef5afC,0x03A4518Ff4872850d82Dc41450E153AB0c37e6bb
6821,15627878,55904,8308238489,54960,944,138,281,0x011b0beAe3eC5953B4805b064cC78f6F892A99cC,0x906eA1f28992B948f6FEbBfD44E6541B13a3d0dF
6822,15627878,137084,8308238489,136132,952,394,87,0x17D084106C2f1C716ce39fa015AB022757d30C9A,0xC5b6A4A7F89A6056A36EFe3d9f07830cc07c8afF
6823,15627878,639963,8308238489,623939,16024,4618,5,0x617Dee16B86534a5d792A4d7A62FB491B544111E,0x4d6DCBEA6bDE4C7D80392a68E093a1EF949764d6
6824,15627878,46267,8308238489,45691,576,74,29,0x283Af0B28c62C092C9727F1Ee09c02CA627EB7F5,0xe67163F37Af775f05B929F9a1647a5601E60af18
6825,15627878,92151,8308238489,92087,64,10,64,0x4Dbd4fc535Ac27206064B68FfCf827b0A60BAB3f,0x72a1B660F394b50C0affe1de15ed7F8a5863A25E
6826,15627878,84961,8308238489,84757,204,74,205,0x55f1C36Bb7aE0d7D6caE97902E30A2306686Ec73,0x5bAB06Aab8aEcD0E60c8287391233F2285ad7071
6827,15627878,143229,8308238489,136689,6540,1802,78,0x00000000006c3852cbEf3e08E8dF289169EdE581,0x546367D801a949107A95Cd1D591C741078598fF3
6828,15627878,129244,8308238489,123376,5868,1418,541,0x4a848F44146Ca6D1D6AA34bcdF3C41093deF1761,0x26104955B8280C28CA392f42422fdBdbF93C7003
6829,15627878,224863,8308238489,205779,19084,4618,155,0x00000000006c3852cbEf3e08E8dF289169EdE581,0x26c8a2C7175F53fc85438D343B5d5C2cC5F46751
6830,15627878,46267,8308238489,45691,576,74,978,0x283Af0B28c62C092C9727F1Ee09c02CA627EB7F5,0xA5b71Bac1a71C5c2A226B61E778C2a738Ff6b297
6831,15627878,46267,8308238489,45691,576,74,15,0x283Af0B28c62C092C9727F1Ee09c02CA627EB7F5,0x49E6f9753F3eDdc19310195f46482c29FC354693
6832,15627878,217201,8308238489,214025,3176,906,382,0x68b3465833fb72A70ecDF485E0e4C7bD8665Fc45,0x01cb74cfd225aA8A1A5EC723C1DbCE4A497baC30
6833,15627878,217395,8308238489,214599,2796,842,58,0x68b3465833fb72A70ecDF485E0e4C7bD8665Fc45,0xaB4823265505173c42549de036aD26f1C1418101
6834,15627878,105000,8287648684,105000,0,2,138571,0x7BFA21068ba50f2D25c1bf44c35A59A603D59029,0x974CaA59e49682CdA0AD2bbe82983419A2ECC400
6835,15627878,225863,8287648684,223791,2072,522,45,0xEfF92A263d31888d860bD50809A8D171709b7b1c,0xc18C24d43ee5cE1064941A563E096B7e882c0a7f
6836,15627878,90000,8000000000,90000,0,2,449979,0x858448850D316537EAD10512d0802D36966f609f,0x077D360f11D220E4d5D831430c81C26c9be7C4A4
6837,15627878,303721,8000000000,300305,3416,522,685,0x9b3B6974531d8AA15A87908FFd821A64863Ede5B,0x8c97B171738aA8fdbD0bb73a440Be2424F840635
6838,15627878,21000,7993351599,21000,0,2,150325,0x12C6Fa5891E00601dB3b9Ab76F32f68720992459,0x1C727a55eA3c11B0ab7D3a361Fe0F3C47cE6de5d
6839,15627878,53591,7853556384,52647,944,138,78,0x467719aD09025FcC6cF6F8311755809d45a5E5f3,0xc50e05B4802c643Cd0873f5dE9B793f2F988A12e
6840,15627878,230501,7808238489,229729,772,202,15,0xcDA72070E455bb31C7690a170224Ce43623d0B6f,0x3F2789E73E393bd7E69683f73D74Ae19F363e827
6841,15627878,500000,7808238489,500000,0,2,63858,0xa940Bf652F653F5ad6669A0Fe7D62E3DEd502b4B,0x17F1a51dA68d27c94D2a51d92B27B5Bd4718b986
6842,15627878,291597,7808238489,291533,64,10,1264,0x0CA33DA7D10fe5eA69f41a6E0CC32D6f18a24041,0x2Bb70959883302601AcB3C8Fdc83c031D80Be32b
6843,15627878,21000,7808238489,21000,0,2,12383,0x42525B10C8472a5446021A2222465180A21aBACa,0xF7aAb787787631d5d180B54B83747e6654E8f6B6
6844,15627878,55930,7808238489,54986,944,138,3,0x15D4c048F83bd7e37d49eA4C83a07267Ec4203dA,0xF81104d66bE8b2D7bDeadA73FC64BC8d909A0333
6845,15627878,181476,7808238489,179912,1564,394,124,0x1Fa8559e873f698292766790AeCf8080A66433F6,0x9C4C8539FbDc0A1ab8d461E192d20c554fEb9B99
6846,15627878,181476,7808238489,179912,1564,394,2488,0x1Fa8559e873f698292766790AeCf8080A66433F6,0x13a1DB3301fE0dd554aA4Cd4fDA4e27fa1f63Bba
6847,15627878,21000,7808238489,21000,0,2,57305,0x2354d3Ebb064C6610e371e88e26806088D2e443e,0xCfC0F98f30742B6d880f90155d4EbB885e55aB33
6848,15627878,181476,7808238489,179912,1564,394,121,0x1Fa8559e873f698292766790AeCf8080A66433F6,0x9d35139f18e6e45b0c830306e7DD7F41EBc7703E
6849,15627878,46684,7808238489,46124,560,138,1,0x3E343f43B6429956f84726636C336fbcfa90DA27,0x0Fb58DC04ABecA268daeeB4eee206e9063a4E8bC
6850,15627878,181476,7808238489,179912,1564,394,556,0x1Fa8559e873f698292766790AeCf8080A66433F6,0x0c0917Fd70d9644a11390b7bAB1a0E338916DAf6
6851,15627878,107139,7808238489,106935,204,74,123,0x4556561740B7B5F858967A6a4E54e506609704Bd,0xCF06063e20832b047985789A2dF9EAf92f746c76
6852,15627878,181476,7808238489,179912,1564,394,735,0x1Fa8559e873f698292766790AeCf8080A66433F6,0xe28E8446E049fB79b5501Ec5F467130aD9194c9A
6853,15627878,175971,7808238489,173199,2772,842,19,0x68b3465833fb72A70ecDF485E0e4C7bD8665Fc45,0x70ADF2Ab6E7702E973cf86425f3018Fa5CD473e7
6854,15627878,147153,7542868846,140501,6652,1810,232,0x00000000006c3852cbEf3e08E8dF289169EdE581,0xe09A44EB4495C05dD1cB983dF39925EECE33c80b
6855,15627878,45038,7542868846,44974,64,10,175,0xC02aaA39b223FE8D0A0e5C4F27eAD9083C756Cc2,0x4eBf7489301FC3298B372164046AD3f7B0A0cC69
6856,15627878,77755,7542868846,77087,668,138,951,0xd2877702675e6cEb975b4A1dFf9fb7BAF4C91ea9,0x2af76ca7b4dbC1Afb3b4367bf217b75Cbd19230d
6857,15627878,144488,7542868846,137936,6552,1802,12,0x00000000006c3852cbEf3e08E8dF289169EdE581,0x77e4CCF8bE7D72c52F275AF52DDCDa308c04a451
6858,15627878,69163,7523957800,68555,608,138,72,0xdAC17F958D2ee523a2206206994597C13D831ec7,0x7c8CaBA2bC1528713e72852DC4b7c72DB832d01d
6859,15627878,191095,7516739427,190183,912,266,415,0xd588b586D61C826A0e87919b3D1a239206d58bf2,0xd7188770a2962C73CCBc8A451455a29bD38FD965
6860,15627878,191095,7516739427,190183,912,266,88,0xd588b586D61C826A0e87919b3D1a239206d58bf2,0x710E29C9c3bD8904Eb3d993b05E1bE418Bc715aa
6861,15627878,150000,7316111346,149760,240,74,638779,0xA0b86991c6218b36c1d19D4a2e9Eb0cE3606eB48,0x55FE002aefF02F77364de339a1292923A15844B8
6862,15627878,288750,7307675848,285082,3668,906,0,0x197492CCB4B1acaAAcd43432657A17832E36AB49,0x8dcf7a7E18b5D3e6230c00590772968Cc5831A6A
6863,15627878,288768,7178692772,285088,3680,906,0,0x197492CCB4B1acaAAcd43432657A17832E36AB49,0x22B1A498C194427714EF8C72f879c56122d498a7
6864,15627878,288883,7074242278,285203,3680,906,0,0x197492CCB4B1acaAAcd43432657A17832E36AB49,0xac9bd02AD520fC745DAC653149C2Ac84098a8b89
6865,15627878,225889,7061836668,223793,2096,522,63,0xEfF92A263d31888d860bD50809A8D171709b7b1c,0x8Ca38A2Ee63BAF18691dFF6A114507Eb81876e5D
6866,15627878,21000,7061836668,21000,0,2,0,0x912fD21d7a69678227fE6d08C64222Db41477bA0,0x884cD6d146ebF26F26fC7dD6Cdb4FEd43Fd28a0a
6867,15627878,53550,7017302068,52618,932,138,88,0xFca59Cd816aB1eaD66534D82bc21E7515cE441CF,0x82fF77d836738202418E8BF2B1625b23fA6c7898
6868,15627878,46707,7000000000,46219,488,138,2027,0xbef7Dcc0335Ec876e2DC530b883F34c8807d61fc,0xB363188D50BFc47FBd7fd4335CFfbBa82da63d5e
6869,15627878,3078665,6868648232,2860801,217864,29278,0,,0xEbEdB72D69A11a38F932bF6Fdd5E2F3097CD559D
6870,15627878,124935,6867000000,124291,644,138,74,0xA8b12Cc90AbF65191532a12bb5394A714A46d358,0x3f8A410B51F5Dc3A75FB19EB1e1A218d16174a08
6871,15627878,191077,6866903957,190177,900,266,155,0xd588b586D61C826A0e87919b3D1a239206d58bf2,0xFF714e5735424170352E19f0Fcd4Ccb87E86BF2C
6872,15627879,2000000,57300601502,1997880,2120,522,164,0x7a250d5630B4cF539739dF2C5dAcb4c659F2488D,0x3C2a7589f22f4cC06938d33aC80784c6aD784A2F
6873,15627879,499999,50000000000,499055,944,138,1,0xA0b86991c6218b36c1d19D4a2e9Eb0cE3606eB48,0x94F68aa774b6f71C67bA0A699809E0dBBcbc997E
6874,15627879,196665,48329761798,194805,1860,458,18538,0xd9e1cE17f2641f24aE83637ab66a2cca9C378B9F,0x3EaE56964B8CE1Cb52f395444c0f89577Bd6bB49
6875,15627879,310755,26000000000,299771,10984,3466,1412,0x74312363e45DCaBA76c59ec49a7Aa8A65a67EeD3,0x1e4B024b804b6136BEb0a561f566ab0adaB2e211
6876,15627879,21000,15400000000,21000,0,2,2,0x500A746c9a44f68Fe6AA86a92e7B3AF4F322Ae66,0x8f287C2ed010A46C5626bA27a18f7c4d5c8c0A90
6877,15627879,56032,14057821812,55424,608,138,1,0xdAC17F958D2ee523a2206206994597C13D831ec7,0x82f278E9d13bb0992092DBd356Eaf50C1b6aAE09
6878,15627879,21000,14000000000,21000,0,2,2,0x500A746c9a44f68Fe6AA86a92e7B3AF4F322Ae66,0x96A0439A6352BDE202EaA5B15aF0dC0D1EA55c1a
6879,15627879,180023,7300601502,179451,572,90,103244,0x01FF6318440f7D5553a82294D78262D5f5084EFF,0x5AA17fC7F2950ECa85376C3A8CB1509e8e4B39dF
6880,15627879,508582,9300601502,505454,3128,906,71,0x68b3465833fb72A70ecDF485E0e4C7bD8665Fc45,0xD5b5E8a77b87224B1f6712Ba02c34fE163F78c62
6881,15627879,160510,36823357998,159606,904,130,103245,0x01FF6318440f7D5553a82294D78262D5f5084EFF,0x5AA17fC7F2950ECa85376C3A8CB1509e8e4B39dF
6882,15627879,90000,13000000000,89392,608,138,0,0xdAC17F958D2ee523a2206206994597C13D831ec7,0x07159b9e3BA83F7b06516b0F2253b014D7F7c20b
6883,15627879,36015,12300601502,35751,264,74,4066,0xC02aaA39b223FE8D0A0e5C4F27eAD9083C756Cc2,0x0d1d74535bCAbda2dA2CfF5A53C2B899901D423B
6884,15627879,54184,12000000000,53612,572,138,58,0xD27dcbcC8778a8AB33AAc529Df36a634567Be325,0x1B9A633DbF387063ae5F249a0685fA19F4eff1da
6885,15627879,54184,12000000000,53612,572,138,46,0xD27dcbcC8778a8AB33AAc529Df36a634567Be325,0x273BD4824C053388f04C86d5a22160e23DA174ac
6886,15627879,54184,12000000000,53612,572,138,51,0xD27dcbcC8778a8AB33AAc529Df36a634567Be325,0x16044b36aC4671027e785C365cEeeB65E76485F3
6887,15627879,54184,12000000000,53612,572,138,50,0xD27dcbcC8778a8AB33AAc529Df36a634567Be325,0x9e0C615151abA94A8F1Fc9bec1326C0c80bb3ae6
6888,15627879,59421,12000000000,58753,668,138,54,0x22987407FD1fC5A971e3FDA3B3e74C88666cDa91,0xc2F3288Fc86CE94A8473E7A01462159d0F6364D3
6889,15627879,100000,11990027398,99380,620,138,181438,0x473037de59cf9484632f4A27B509CFE8d4a31404,0x6238872A0Bd9F0E19073695532a7Ed77ce93C69E
6890,15627879,21000,11640000000,21000,0,2,6,0xE36067a4c51ff6Cb7Fb6F97D1931bb27a468960B,0xc3FE7b8d4aBd70B9882Fa1b600e8F336af219dA4
6891,15627879,76564,11025819648,75944,620,138,4709931,0xA0b86991c6218b36c1d19D4a2e9Eb0cE3606eB48,0x2FAF487A4414Fe77e2327F0bf4AE2a264a776AD2
6892,15627879,1000000,10391357078,992584,7416,2186,4,0xf18aCC02628009231d7BAAF9a7a24C0860Dda6cb,0xc5b27a5f60bCb24c4030adCE4B98fc24D75A749B
6893,15627879,46121,10300601502,45501,620,138,0,0xdAC17F958D2ee523a2206206994597C13D831ec7,0xCA10Cd8731b053dd375b4ceA64f3F3F1133c8CE7
6894,15627879,102928,10300601502,102296,632,138,1,0xFDBf91A7F2d757A9815326af5E1e60319571984c,0x9A4140FFB57D5272ea009c37a18D2A88B54e6063
6895,15627879,26000000,10000000000,25937796,62204,15306,16090,0x4F4495243837681061C4743b74B3eEdf548D56A5,0x19e34D09c2664d4F0829B1431eA73daC1B2bea93
6896,15627879,21000,9950571151,21000,0,2,24,0xCBD6832Ebc203e49E2B771897067fce3c58575ac,0x2910949849Af9F437f01ae63D85c2533F309A330
6897,15627879,279613,9945178421,268285,11328,3722,58,0x603D022611BfE6A101DCdaB207D96C527F1d4d8e,0x51AF50ae32fC58ab8322Afc4742De22A9c4DbEd7
6898,15627879,21000,9300601502,21000,0,2,72345,0xf2D226F8a35f67F0e494AC5f3517a1CdA86fC393,0xab97925eB84fe0260779F58B7cb08d77dcB1ee2B
6899,15627879,21000,9300601502,21000,0,2,469168,0x65eBE6e591f5ACe20D59686FFaF40D937FA9240F,0xb739D0895772DBB71A89A3754A160269068f0D45
6900,15627879,21000,9300601502,21000,0,2,1783208,0x7f323f2bA367FeA1C0C61Afeb677132CE014E662,0x503828976D22510aad0201ac7EC88293211D23Da
6901,15627879,21000,9300601502,21000,0,2,1228779,0x095E9325c7Aa403c1aBf8d81D1aE15b842E79c7A,0x71660c4005BA85c37ccec55d0C4493E66Fe775d3
6902,15627879,46097,9300601502,45501,596,138,12877,0xdAC17F958D2ee523a2206206994597C13D831ec7,0x6c8dd0e9cC58c07429e065178d88444B60e60b80
6903,15627879,207128,9300601502,207128,0,2,1312156,0xD604fE2Dc2D5f3A400F72f5EEb5d7429665B23cA,0xf60c2Ea62EDBfE808163751DD0d8693DCb30019c
6904,15627879,30732,9300601502,30668,64,10,231,0xC02aaA39b223FE8D0A0e5C4F27eAD9083C756Cc2,0x27c8C6Cbe4CbeA896ee6F61f3B2bdd9Bc0Aa4e39
6905,15627879,21000,9300601502,21000,0,2,469169,0x3aAb510A686966E9E57A0734E0F63Ae588a284a2,0xb739D0895772DBB71A89A3754A160269068f0D45
6906,15627879,191593,9300601502,187989,3604,1162,12167,0x68b3465833fb72A70ecDF485E0e4C7bD8665Fc45,0x36aB75710650754c32e4850D2ad050849EBb5899
6907,15627879,142877,9300601502,141517,1360,394,80,0x2E2234b3A848F895a60B2071F90303CD02f7491D,0x047cbbD15Fcc63218100e0893239f8518c62CE4D
6908,15627879,142877,9300601502,141517,1360,394,85,0x2E2234b3A848F895a60B2071F90303CD02f7491D,0x9917118D1a7dd25C764cF3F7376249F38dc74c62
6909,15627879,21000,9300601502,21000,0,2,88939,0xa2d53BC214Be4F91b088dfc06B00cBcA313bec77,0x3018018c44338B9728d02be12d632C6691E020d1
6910,15627879,142877,9300601502,141517,1360,394,86,0x2E2234b3A848F895a60B2071F90303CD02f7491D,0xC09aED984376ACF1dbfB9AE5eb4a83AE9C59c7CA
6911,15627879,142877,9300601502,141517,1360,394,83,0x2E2234b3A848F895a60B2071F90303CD02f7491D,0xFfaaFe4d78Cc87bC38569330b33A59E07D2Adbf2
6912,15627879,142877,9300601502,141517,1360,394,79,0x2E2234b3A848F895a60B2071F90303CD02f7491D,0x9d758481E7D38Bd367B02d720D94244CbF834150
6913,15627879,142877,9300601502,141517,1360,394,83,0x2E2234b3A848F895a60B2071F90303CD02f7491D,0x95B89929D9D66FB8c158ab858F05CC6Fa36DA50A
6914,15627879,42000,9300601502,42000,0,2,329540,0x1D9B8CcFFB4254415a1Ec1Ac57b8aF406d9b4796,0x9430801EBAf509Ad49202aaBC5F5Bc6fd8A3dAf8
6915,15627879,142877,9300601502,141517,1360,394,518,0x2E2234b3A848F895a60B2071F90303CD02f7491D,0xC79F419598EcAdf64320dc6B5701Bf4fe476057a
6916,15627879,142877,9300601502,141517,1360,394,85,0x2E2234b3A848F895a60B2071F90303CD02f7491D,0xB67E3D9A90D523Db45516e7A1fc8eCA657EC9253
6917,15627879,142877,9300601502,141517,1360,394,78,0x2E2234b3A848F895a60B2071F90303CD02f7491D,0x80A52aae0364715f36e31Fa592D07Aaa02cf410b
6918,15627879,142877,9300601502,141517,1360,394,79,0x2E2234b3A848F895a60B2071F90303CD02f7491D,0xd314Fbcea2cf01237f4b1C31bd6c9F92D59f5AA0
6919,15627879,142877,9300601502,141517,1360,394,436,0x2E2234b3A848F895a60B2071F90303CD02f7491D,0x7BeB23a1B2Ab2103F2344429b543233586833fE6
6920,15627879,142877,9300601502,141517,1360,394,440,0x2E2234b3A848F895a60B2071F90303CD02f7491D,0xE669aF9802D21c30e434c00e0f5Cb2832B850475
6921,15627879,142877,9300601502,141517,1360,394,447,0x2E2234b3A848F895a60B2071F90303CD02f7491D,0x306FDD1d17455E3685646BBC16C6A739Ad99C93C
6922,15627879,142877,9300601502,141517,1360,394,438,0x2E2234b3A848F895a60B2071F90303CD02f7491D,0x4CF72c476d4ff1f69A5A1120f1FF3839e1215d53
6923,15627879,142877,9300601502,141517,1360,394,423,0x2E2234b3A848F895a60B2071F90303CD02f7491D,0x80CDb268e0eA2A22984024FF97C5c536EB8929F3
6924,15627879,142877,9300601502,141517,1360,394,80,0x2E2234b3A848F895a60B2071F90303CD02f7491D,0x091550e34477Ae4F55DE5482a5081745635b4777
6925,15627879,142877,9300601502,141517,1360,394,454,0x2E2234b3A848F895a60B2071F90303CD02f7491D,0x812F332def216F4C4E1Fa56d5Bf3607f1EaEc033
6926,15627879,142877,9300601502,141517,1360,394,531,0x2E2234b3A848F895a60B2071F90303CD02f7491D,0x2FC870C83cb84095715f3B479165CF5e5BfA7350
6927,15627879,181476,9300601502,179912,1564,394,412,0x1Fa8559e873f698292766790AeCf8080A66433F6,0xCE5f56E421cB5428B91AD586Da37e2a68095cd82
6928,15627879,275883,9160721802,273503,2380,586,39,0x53e0e51b5Ed9202110D7Ecd637A4581db8b9879F,0x4f9CaFA722A5304D80c5f5A890283a875709BDa5
6929,15627879,500000,9055492286,498032,1968,650,6497,0x42C02270fa45135087A86288189c53C66dac8EB4,0xbe2c1479B24ffF0B3b69B37A3fb99a737F46B0da
6930,15627879,213887,9000000000,212731,1156,394,63,0xC36442b4a4522E871399CD717aBDD847Ab11FE88,0x680CfEA894cD0Bd8491c348795fa791F7386d235
6931,15627879,413472,8821528521,404512,8960,3018,2147,0x906244f8C11d25fA77b0b35fc075372298AE7c0A,0x0BD4a1eC51D42C1201536877Ab03f139Ef3fd0D7
6932,15627879,46267,8800601502,45691,576,74,487,0x283Af0B28c62C092C9727F1Ee09c02CA627EB7F5,0x36966A187BDEb677078B2c1543F71e911E5d47a2
6933,15627879,46267,8800601502,45691,576,74,27,0x283Af0B28c62C092C9727F1Ee09c02CA627EB7F5,0xF6EB8C9269E1C67ab0e6A54a1F98b866cf94d137
6934,15627879,162719,8800601502,152187,10532,3402,190,0x00000000006c3852cbEf3e08E8dF289169EdE581,0x6a036BEFF41974905a525BdF032C170dE99C492F
6935,15627879,188962,8800601502,188466,496,202,517,0xc9A898518F4072D0A3a4Ac50B3eBd56F86FAcA27,0xADc572b34f685DD1C12c5D1b592877f68Fe5bBB0
6936,15627879,67285,8800601502,67081,204,74,206,0x55f1C36Bb7aE0d7D6caE97902E30A2306686Ec73,0x5bAB06Aab8aEcD0E60c8287391233F2285ad7071
6937,15627879,21000,8800601502,21000,0,2,9,0x6ABe5e63B8C6639382515ddEfe7642E615a88DAd,0xC03c5c5102de33Ad380Cd7Bb85092cC739b338Cb
6938,15627879,46267,8800601502,45691,576,74,25,0x283Af0B28c62C092C9727F1Ee09c02CA627EB7F5,0xfC8CaCDD95cDB797078b7D11fc4cCF8d62B71bA2
6939,15627879,193706,8800601502,183242,10464,3338,2,0x74312363e45DCaBA76c59ec49a7Aa8A65a67EeD3,0xa38da119E19EEacF4f85d54AA95efaF8F3a3d66B
6940,15627879,143196,8800601502,136736,6460,1738,79,0x00000000006c3852cbEf3e08E8dF289169EdE581,0x546367D801a949107A95Cd1D591C741078598fF3
6941,15627879,60715,8800601502,53271,7444,2506,8,0x00000000006c3852cbEf3e08E8dF289169EdE581,0x4a771933F09c667F851CF24CDd4AEBa000f99790
6942,15627879,90618,8800601502,90022,596,138,28,0xA0b86991c6218b36c1d19D4a2e9Eb0cE3606eB48,0xD8Fa208be458DbA09f93EEeB270d1e6DB07Cd985
6943,15627879,21000,8800601502,21000,0,2,3,0x91e6568c0233d80fB5F36dc2F8a4ecb4B35c3ebd,0xAEc4341c0C612753D52aB971a5FAc44f56433D75
6944,15627879,56659,8800601502,55715,944,138,2622,0x9431DE2DFE10BDB30995bd3791dE03a6c9570054,0x5B8f487765cF8F88Db19C19e2409B51A59Df084C
6945,15627879,159195,8800601502,158991,204,74,86,0xa6561830c0Ff7C7c52E85cf062e01740Af216e01,0x7EdE7d2de92305601617DfDA66c16e7dcF0fCD8A
6946,15627879,46267,8800601502,45691,576,74,26,0x283Af0B28c62C092C9727F1Ee09c02CA627EB7F5,0x376CB42C8274D78dD51e8BF750D9c28364CF4C6f
6947,15627879,146822,8800601502,140146,6676,1810,238,0x00000000006c3852cbEf3e08E8dF289169EdE581,0x7FcdAc97a1ae4615024537D892daDb3Ae9A41886
6948,15627879,21000,8800601502,21000,0,2,19,0x42274080309a6Ea30E1f5E9A0D9DA706ea00CcCA,0xAc68f409F57AE85eFf4224e2108aec464D4654e3
6949,15627879,55904,8800601502,54960,944,138,213,0x011b0beAe3eC5953B4805b064cC78f6F892A99cC,0x4f102e320c8046242eEbaD43A6174678CCe1e8CC
6950,15627879,21000,8800601502,21000,0,2,6,0x3BAe41Cf66BD301a7d2E7cCDeCF6fa587BC41868,0x6eF314FE7C08Cb78D58Df1995dE6CdF2060435F9
6951,15627879,243819,8800601502,241023,2796,842,691,0x68b3465833fb72A70ecDF485E0e4C7bD8665Fc45,0x51115F73F927fCf13ef6f27f6bAA170156d44489
6952,15627879,46187,8800601502,45615,572,138,98,0x34Bc797F40Df0445c8429d485232874B15561728,0xa15b1A9477709911eb87A1FF8F85Fdc5bd8449CF
6953,15627879,127878,8800601502,127262,616,202,27,0x084b1c3C81545d370f3634392De611CaaBFf8148,0x07d175E9a075aB47fB36b149207EEB650E5FDdA8
6954,15627879,159762,8800601502,153186,6576,1802,54,0x00000000006c3852cbEf3e08E8dF289169EdE581,0x71F70a99fbbB2f0700c89f4AeF1345f990E530B4
6955,15627879,51406,8800601502,50918,488,138,30,0xF2a9904458d938be0a5B9410cE32af1b3eE00cEa,0xB2362053e77ceb3bFE79a0EF12959E847AB7415a
6956,15627879,21000,8800601502,21000,0,2,20,0xA990D3F121E49c97a2799D35729b72C4de76Ff7e,0xf48E977751858e37912Ff443c6F4F3cd5057A3A6
6957,15627879,60691,8800601502,53271,7420,2506,100,0x00000000006c3852cbEf3e08E8dF289169EdE581,0xd96606522a5C8aE1f69256A041800d926297241C
6958,15627879,52248,8800601502,51628,620,138,665,0x15D4c048F83bd7e37d49eA4C83a07267Ec4203dA,0x7F44Fe06175fe484E2eCC42E5CfBEAA37AF9AC43
6959,15627879,223122,8800601502,220362,2760,842,740,0x68b3465833fb72A70ecDF485E0e4C7bD8665Fc45,0x6B7B6eD83064FBA3cdd3cB05585f2Cad80dF6719
6960,15627879,55953,8800601502,55009,944,138,85,0xb9f79C35C37695ec45851Cd6E29da8C1d0396c11,0x00804aD8aa538E852f5Bb4A49f8957a783ac132f
6961,15627879,27938,8800601502,27874,64,10,377,0xC02aaA39b223FE8D0A0e5C4F27eAD9083C756Cc2,0xADE36882aD0783383Ce4cc2B4c4c768875608102
6962,15627879,278821,8800601502,278617,204,74,472,0x55f1C36Bb7aE0d7D6caE97902E30A2306686Ec73,0x36151eF8bF252eB963235fd76245B98580D595F0
6963,15627879,115427,8800601502,115363,64,10,167,0x12DEb1Cb5732E40Dd55B89aBB6D5C31dF13A6e38,0x7b989E2F025cDF1b39Ca45CA01f694caE71ffed9
6964,15627879,338006,8800601502,324082,13924,4618,1051,0x83C8F28c26bF6aaca652Df1DbBE0e1b56F8baBa2,0x2106d51212C82B481fa397d4C56b2eF98082d4F6
6965,15627879,93319,8800601502,92375,944,138,70,0xbd31EA8212119f94A611FA969881CBa3EA06Fa3d,0x29BE0777A3Ab996D9086c33EbbC0153E2DcC5Dcb
6966,15627879,167994,8800601502,166042,1952,522,888,0xeF3739eE528B8D74D0C2a906Aa469C67233c6B44,0x94833447381805ecDBd6D29a949e6eaa4b02Cb2D
6967,15627879,21000,8800601502,21000,0,2,365,0xFd8069AD37Ff977bc5EC3C9e4fB19643ab13A06D,0x32eAef34302d45536581C9f2F74e10D82836E170
6968,15627879,54260,8800601502,53308,952,202,444,0x0eFf88E66eB717F8F7e0701345f1Cc119b487f86,0x090882db986Fc820404962d6b8E4AEF615eB4ade
6969,15627879,51458,8800601502,50970,488,138,725,0x7F9306FC1978938d5C1C57Bf6044dc67E07eeB8a,0x6748c23CB9D9F40aC75ec2C43106A8BC3197f82E
6970,15627879,256317,8800601502,252641,3676,1162,60,0x68b3465833fb72A70ecDF485E0e4C7bD8665Fc45,0xdC92A66f01c385B5B02853eDb8B7297d42625268
6971,15627879,133676,8800601502,112116,21560,7242,540,0x00000000006c3852cbEf3e08E8dF289169EdE581,0x86339A63B82A4Fb5e1EA888EEA7c760b9662f1C2
6972,15627879,21000,8800601502,21000,0,2,620,0x5346BC9A21B1BB0Fe6EE152f5Af022cab65CE837,0x0a0F313c154338E40bFbf33e946299cDdD259F0d
6973,15627879,22756,8800601502,21000,1756,394,144,0x23Ddd3e3692d1861Ed57EDE224608875809e127f,0x100Ad1b38F1a4DeBcB66f8C89e1f603b8604A27E
6974,15627879,340849,8800601502,336853,3996,1226,174,0x68b3465833fb72A70ecDF485E0e4C7bD8665Fc45,0x2735b6f7921c07b0Dd0a633e857FBE3cE9C913b1
6975,15627879,21000,8800601502,21000,0,2,1,0xAa6ccDA870B6b6fdF97907766470156b13abFBd7,0x1cCA53b755082f428a64F4Fa4c8e146F63887441
6976,15627879,125468,8800601502,125404,64,10,61,0xfc4913214444aF5c715cc9F7b52655e788A569ed,0xa650A90BF2D18dF6F2e032faaF74EC3cA7957649
6977,15627879,262724,8800601502,259384,3340,970,31,0x68b3465833fb72A70ecDF485E0e4C7bD8665Fc45,0x1C2bEc615Ec89674e718b0966c686D5343EDc127
6978,15627879,46707,8800601502,46219,488,138,379,0x68930072647a0d79e601d5eE3914833aE9148247,0x5Db71204C7D9a9a23359676aE159eD28D2fF4523
6979,15627879,227299,8800601502,206799,20500,5002,2247,0x00000000006c3852cbEf3e08E8dF289169EdE581,0x81269781E647eb0843Dc3a8fEbC55a38cE69B4eB
6980,15627879,46135,8800601502,45647,488,138,1049,0x1Fa8559e873f698292766790AeCf8080A66433F6,0xb142AC3a305df594F44D518Fd2B504da2B6Af6Fb
6981,15627879,21000,8800601502,21000,0,2,114,0x2453F30418DaE31a24De168d3b11aE5D7ceF0c55,0xa4b4467BeB88cfaA40F43C684Cd33aCbc5B0beD0
6982,15627879,21000,8800601502,21000,0,2,7,0x013689a92c130Eb3fE5Ad052211AE2C71000FE3E,0x45e7F4D93B33c2296Cb1B410992f5420d4CCD518
6983,15627879,21000,8800601502,21000,0,2,361,0xE4cC4534D807f84fb8ebfBeb0D44D64d5B9734c1,0x69334e638297E37999ef876aDE880C1209DDFC2b
6984,15627879,21000,8800601502,21000,0,2,4,0x6971d694eDC956801C2e6F105E2735505812a555,0x08302592359F6e5846ec03B3b481bC6690bc7eBA
6985,15627879,1000000,8800601502,999332,668,138,4121139,0x59E9261255644c411AfDd00bD89162d09D862e38,0x0D0707963952f2fBA59dD06f2b425ace40b492Fe
6986,15627879,202043,8800601502,199295,2748,650,1893236,0xD1669Ac6044269b59Fa12c5822439F609Ca54F41,0xD2C82F2e5FA236E114A81173e375a73664610998
6987,15627879,21000,8800601502,21000,0,2,487,0x6a614e1089611c6577F690EbbE934786b84A097D,0x4961324ADa486E1Be592B6f73046458e2BBDF82a
6988,15627879,259872,8401601502,259872,0,2,119830,0xeCa2e2D894D19778939bD4DfC34D2a3C45E96456,0xeCa2e2D894D19778939bD4DfC34D2a3C45E96456
6989,15627879,329058,8300601502,324714,4344,1034,166,0x197492CCB4B1acaAAcd43432657A17832E36AB49,0xE5FdBdb64E422aC6CB048B8f0917244968253F39
6990,15627879,1000000,8300601502,997988,2012,522,6334,0xE592427A0AEce92De3Edee1F18E0157C05861564,0x329aFA43F8c89F65Fb6b22397c1A098EA4210D7E
6991,15627879,163881,8300601502,157217,6664,1810,628,0x00000000006c3852cbEf3e08E8dF289169EdE581,0x75CE0A06A40b86D5c9D43F9f9c14D8b060C3E7F8
6992,15627879,190532,8300601502,186940,3592,1162,5,0x68b3465833fb72A70ecDF485E0e4C7bD8665Fc45,0xF2673cb3b22212005f1cCE6515c942B7cD4Aa31c
6993,15627879,120000,8300601502,119392,608,138,5,0xdAC17F958D2ee523a2206206994597C13D831ec7,0xbE952E75380c214021d9a2129a7Ae959F9293B5f
6994,15627879,21000,8300601502,21000,0,2,164,0xeCcfC341614d93885B6E73E8ae8F63432D9FDB38,0xcAbD5Dd3780BD7AA03F10049908e251A94207b33
6995,15627879,120000,8300601502,119404,596,138,96799,0xdAC17F958D2ee523a2206206994597C13D831ec7,0x4c9AF439b1A6761B8E549D8d226A468a6b2803A8
6996,15627879,189230,8300601502,186398,2832,842,384,0x68b3465833fb72A70ecDF485E0e4C7bD8665Fc45,0x1453169a1B1Fb2160B4c64E573c2296CB131143A
6997,15627879,21000,8300601502,21000,0,2,0,0xA0aFeAB9F887c0681493ae14dF442F14853e878c,0x423f845575DCF70DCf61c6bd09b92A74d978f3B6
6998,15627879,171583,8300601502,170051,1532,330,365,0x5D004ddB5D92938dAF8448b9eac1CaA593cd26Ca,0x26DC5D39Bd7A8bc2d792dcAAAC55FE6DCef25593
6999,15627879,250000,8300601502,250000,0,2,45337115,0x7834E65B4a6352bb08BEE22052fD9143C20Ff4fC,0xEA674fdDe714fd979de3EdF0F56AA9716B898ec8
7000,15627879,181476,8300601502,179912,1564,394,54,0x1Fa8559e873f698292766790AeCf8080A66433F6,0xc0452507b41D2da08a1630394D064B45617017C6
7001,15627879,250000,8300601502,250000,0,2,45337116,0x8d34a9A88f35BB199d3e5Bfec5cCf788B0ae56CD,0xEA674fdDe714fd979de3EdF0F56AA9716B898ec8
7002,15627879,250000,8300601502,250000,0,2,45337117,0xCAcd2818457BBD62f6b2ad21a96F4F8CC811954b,0xEA674fdDe714fd979de3EdF0F56AA9716B898ec8
7003,15627879,250000,8300601502,250000,0,2,45337118,0x234513c79A28B3070238140051393e5F61F7db27,0xEA674fdDe714fd979de3EdF0F56AA9716B898ec8
7004,15627879,250000,8300601502,250000,0,2,45337119,0x10aF5b09b83b2323Ac12A832E64fa2940d6dca67,0xEA674fdDe714fd979de3EdF0F56AA9716B898ec8
7005,15627879,250000,8300601502,250000,0,2,45337120,0x3e89E52f8961a3D8D8fb94Df531966808487C662,0xEA674fdDe714fd979de3EdF0F56AA9716B898ec8
7006,15627879,250000,8300601502,250000,0,2,45337121,0xBeddB880f667514a65Ee45C2832d00BEc0271EC5,0xEA674fdDe714fd979de3EdF0F56AA9716B898ec8
7007,15627879,250000,8300601502,250000,0,2,45337122,0xc01fD047575E0a80453d837C8D9f85CCca7320df,0xEA674fdDe714fd979de3EdF0F56AA9716B898ec8
7008,15627879,250000,8300601502,250000,0,2,45337123,0xCcc33adFE93FEaE8B02264de8c25007b7AC62570,0xEA674fdDe714fd979de3EdF0F56AA9716B898ec8
7009,15627879,250000,8300601502,250000,0,2,45337124,0x63034566fcdD21edC814AD4b29C45F3aF660716b,0xEA674fdDe714fd979de3EdF0F56AA9716B898ec8
7010,15627879,250000,8300601502,250000,0,2,45337125,0xa89343d5E4564DE18bbF0B4aF6e447470337eDE8,0xEA674fdDe714fd979de3EdF0F56AA9716B898ec8
7011,15627879,250000,8300601502,250000,0,2,45337126,0x0c1B9Da9B48Da3f7ccd4e89D3A8FBbc9f460589a,0xEA674fdDe714fd979de3EdF0F56AA9716B898ec8
7012,15627879,181476,8300601502,179912,1564,394,904,0x1Fa8559e873f698292766790AeCf8080A66433F6,0x4248E7C9B1f45FC8C479eA9bE8db719c95B0dCA8
7013,15627879,181476,8300601502,179912,1564,394,985,0x1Fa8559e873f698292766790AeCf8080A66433F6,0xF1bEE1Eb3664f3bf7f67aB0A5F8CE8b3631b9d8C
7014,15627879,181458,8300601502,179906,1552,394,726,0x1Fa8559e873f698292766790AeCf8080A66433F6,0xA62ad3B7a2d5A3F2875eFf278bE34A3F0512F272
7015,15627879,62302,8300601502,61610,692,138,113053,0x95aD61b0a150d79219dCF64E1E6Cc01f0B64C4cE,0x6081258689a75d253d87cE902A8de3887239Fe80
7016,15627879,59056,8300601502,58092,964,394,2357,0x645E9324f4be25be581BB62163cfa86c40b01D07,0xc5009AFEd2D6DA219538aD165998F63B553185B1
7017,15627879,295084,8300601502,289468,5616,1802,161,0x68b3465833fb72A70ecDF485E0e4C7bD8665Fc45,0xb46474ED447403367b6fB561B353C1C5995f059F
7018,15627879,27023,8287648684,26451,572,138,48,0x556fB136Ea5bBc08175F21DA904169FA5D113Aa3,0x5a024EF0c8517D7bBBF2b63e906412582Ed67E96
7019,15627879,51334,8287648684,50738,596,138,0,0x083D41d6DD21EE938f0c055CA4fb12268DF0EfaC,0x47EE1eeCDF3205408b5E6B2C39dAA2FCcF4973b6
7020,15627879,150756,8035231859,150692,64,10,23,0x65c2e54a4c75ff6da7b6B32369c1677250075fb2,0x2E257607E7c76D951452Ca9ADEfc188Cb92DC375
7021,15627879,131098,8016320813,125114,5984,1674,1703,0x00000000006c3852cbEf3e08E8dF289169EdE581,0x1D8371019faD402f6089Baf2B312defeA0825883
7022,15627879,180000,8000000000,179392,608,138,444362,0xA0b86991c6218b36c1d19D4a2e9Eb0cE3606eB48,0x48c04ed5691981C42154C6167398f95e8f38a7fF
7023,15627879,50000,8000000000,50000,0,2,0,0x077D360f11D220E4d5D831430c81C26c9be7C4A4,0x6E5f29d49613D72038Fa1f96E710624632B028e5
7024,15627879,170689,8000000000,170485,204,74,5,0x7F9306FC1978938d5C1C57Bf6044dc67E07eeB8a,0x04Ef3980187CFa014b282be0A3cbaC861B2Aea22
7025,15627879,139263,8000000000,138835,428,138,503,0x4Ae2Cd1F5B8806a973953B76f9Ce6d5FAB9cdcfd,0xf083b5e401619a64a91aDC5470DB816606872d48
7026,15627879,70834,7993351599,69890,944,138,49,0x72aE9B987A851D85D2Df14E5cB4023C0e895522f,0x2AE835333b6525D90d44a57E606506eeE764F47f
7027,15627879,146673,7808238489,140177,6496,1738,1478,0x00000000006c3852cbEf3e08E8dF289169EdE581,0xD710c25b900C6827352001c98aDFf4E702533eFC
7028,15627879,67109,7536523327,66501,608,138,9,0xdAC17F958D2ee523a2206206994597C13D831ec7,0xf151e3a7409bD420C10Eb1C96550A03A7237139c
7029,15627879,63197,7509665081,62601,596,138,51,0xdAC17F958D2ee523a2206206994597C13D831ec7,0xCD8F79C321807C14827e2f1D6F86Ff08c82c5fA0
7030,15627879,26000,7300601502,26000,0,2,12029,0x388C818CA8B9251b393131C08a736A67ccB19297,0xDAFEA492D9c6733ae3d56b7Ed1ADB60692c98Bc5
7031,15627880,307272,212416808670,305872,1400,234,6167,0xc7EE7c66636f407586afa431C19A916e04928942,0xD8bb08f6760EE8ffADc3242320F11aB0f8029ff5
7032,15627880,233684,7253675974,231500,2184,650,119381,0xA69babEF1cA67A37Ffaf7a485DfFF3382056e78C,0x0cac3d1a887206e0f6169222C4504301A8b4b993
7033,15627880,71000,16128398575,71000,0,2,2396,0xac8Ce0981248195D2699A6e96cc093b69E424894,0xac8Ce0981248195D2699A6e96cc093b69E424894
7034,15627880,236862,7253675974,234678,2184,650,131297,0xA69babEF1cA67A37Ffaf7a485DfFF3382056e78C,0x60b86AF869f23aEb552fB7F3CaBD11B829f6Ab2F
7035,15627880,534155,175534029674,526539,7616,1524,196482,0x0000000000007F150Bd6f54c40A34d7C3d5e9f56,0x0197ABe48f0a9826D10F44DaD7050f26586Eb9bA
7036,15627880,21000,53000000000,21000,0,2,9,0x27315f5F282c31fBADE4aE952d2631C05cD3a26F,0x32028474B9599EeE3cfD80E00EE51E98568F5B42
7037,15627880,5049560,17000000000,5042424,7136,1098,291,0x0a39DA505DfB5E0BBc6bd84428281A8ba1bC7753,0x495E889d1A6cEB447a57dcc1C68410299392380c
7038,15627880,21000,16253675974,21000,0,2,2,0xB17Fe9F5A2b3E016c653E101845121421e2b225a,0x447D3C3F4333b3Fad43580d1A148F3548C228786
7039,15627880,21000,15400000000,21000,0,2,2,0x500A746c9a44f68Fe6AA86a92e7B3AF4F322Ae66,0x386585a904cf952D13A05aF6d9d93a2a7127E963
7040,15627880,169065,15000000000,167205,1860,458,2363,0x7a250d5630B4cF539739dF2C5dAcb4c659F2488D,0xa12e1462d0ceD572f396F58B6E2D03894cD7C8a4
7041,15627880,54184,12406089892,53612,572,138,20,0xD27dcbcC8778a8AB33AAc529Df36a634567Be325,0x9421E7934E35e841db6c052BDF298544108440BE
7042,15627880,54184,12406089892,53612,572,138,11,0xD27dcbcC8778a8AB33AAc529Df36a634567Be325,0xFcfEfe991BdEE2F937F60Fc856E51CDCb277C91B
7043,15627880,79448,12406089892,78508,940,202,56,0xD27dcbcC8778a8AB33AAc529Df36a634567Be325,0xA62F52A52A351D63b079517ACA35e6beBf55C474
7044,15627880,54184,12000000000,53612,572,138,22,0xD27dcbcC8778a8AB33AAc529Df36a634567Be325,0xea6cD4f447C8C3ef56396c8B1B8253B87A537905
7045,15627880,54184,12000000000,53612,572,138,19,0xD27dcbcC8778a8AB33AAc529Df36a634567Be325,0x622F7Cb1aF297f744A948c32a40aEafA47442e90
7046,15627880,54184,12000000000,53612,572,138,17,0xD27dcbcC8778a8AB33AAc529Df36a634567Be325,0x9662EF7FA1F1D141191481d3d02737D36864C890
7047,15627880,181458,12000000000,179906,1552,394,553,0x1Fa8559e873f698292766790AeCf8080A66433F6,0x5b0051e4EA8Eaf6Ec523aB2Aa76fe0149E68B040
7048,15627880,21000,12000000000,21000,0,2,22,0x75e89d5979E4f6Fba9F97c104c2F0AFB3F1dcB88,0x3aDaDbAde67CfD5e2360b4DA865A256aa8141860
7049,15627880,350000,11930770383,349392,608,138,6925057,0xdAC17F958D2ee523a2206206994597C13D831ec7,0x46340b20830761efd32832A74d7169B29FEB9758
7050,15627880,350000,12405234083,349392,608,138,6925058,0xdAC17F958D2ee523a2206206994597C13D831ec7,0x46340b20830761efd32832A74d7169B29FEB9758
7051,15627880,350000,12405234083,349392,608,138,6925059,0xdAC17F958D2ee523a2206206994597C13D831ec7,0x46340b20830761efd32832A74d7169B29FEB9758
7052,15627880,57058,11253675974,56282,776,138,9385,0xCcbA0b2bc4BAbe4cbFb6bD2f1Edc2A9e86b7845f,0xf18D90929e3EC5D3BeA4aA16b9451AD3216a7764
7053,15627880,162918,11253675974,161322,1596,230,5390,0x9507c04B10486547584C37bCBd931B2a4FeE9A41,0x934ed35e39f5D9B1D42041B3f6B74C0ce452F4Ac
7054,15627880,100000,10496246200,99380,620,138,1050388,0xA0b73E1Ff0B80914AB6fe0444E65848C4C34450b,0xf16E9B0D03470827A95CDfd0Cb8a8A3b46969B91
7055,15627880,216459,10253675974,214495,1964,522,1289,0x7a250d5630B4cF539739dF2C5dAcb4c659F2488D,0x1DC26ff48AbEf2d01c2A572b74117D7a19a2cD02
7056,15627880,46121,10253675974,45501,620,138,0,0xdAC17F958D2ee523a2206206994597C13D831ec7,0xdFD135B9a7Fa7CC0f39c0f5121B516ff1BCe870C
7057,15627880,106000,10253675974,106000,0,2,165,0xCac0F1A06D3f02397Cfb6D7077321d73b504916e,0x3C2a7589f22f4cC06938d33aC80784c6aD784A2F
7058,15627880,31549,9760721802,31549,0,2,8,0x3e2265c89240D2C6c925b91AF08Be23b24e08D5E,0xffBC4dc0e46cC44FCf2265944846828C0AA33699
7059,15627880,97224,9753675974,96752,472,202,201,0xB8395c38Ae36C309B059dE8aB33f1fAEcD5f5D7a,0xDB11249D40E05c050348ecA59cF90Fdd6b161aCb
7060,15627880,70186,9753675974,69614,572,138,208,0x47Bd71b482B27eBDb57af6e372cab46c7280bf44,0x70D925A6CC9c6184FE15D4c3900DFa6B750c337d
7061,15627880,150756,9753675974,150692,64,10,5,0x65c2e54a4c75ff6da7b6B32369c1677250075fb2,0x61100474bb813BB87dE8f8b9ededE4D8AeD9FaFE
7062,15627880,1814467,9753675974,1814275,192,74,144,0x87A314DF010535910A84BDD078e8a2cb459baCc9,0xA101064ebF57549e47E955c746744342BdF613B5
7063,15627880,21000,9673675976,21000,0,2,6270,0xFDe0d1575Ed8E06FBf36256bcdfA1F359281455A,0xFDe0d1575Ed8E06FBf36256bcdfA1F359281455A
7064,15627880,21000,9380000000,21000,0,2,21,0xB10D87Cb282021c7785b91dda7989ddbF401f21C,0x1ededA79094cA9fa8098d431a692a8Fe36B1E225
7065,15627880,353127,9253675974,348263,4864,1546,643,0x68b3465833fb72A70ecDF485E0e4C7bD8665Fc45,0xdc5821f21AD12F38FF2259B3BC4C9f9bD06E4BB1
7066,15627880,207128,9253675974,206508,620,138,4468956,0xdAC17F958D2ee523a2206206994597C13D831ec7,0x21a31Ee1afC51d94C2eFcCAa2092aD1028285549
7067,15627880,207128,9253675974,207128,0,2,1679531,0x2C2A1b21DdEb552Bcb0493bf66b9602f77d62fEc,0x4976A4A02f38326660D17bf34b431dC6e2eb2327
7068,15627880,207128,9253675974,207128,0,2,3199177,0x82a81d66f5cA300E9c979c56a87bf2fDdC8966Fa,0x9696f59E4d72E237BE84fFD425DCaD154Bf96976
7069,15627880,207128,9253675974,207128,0,2,3492283,0x282f3914471189B20A1D80FFE70411829aF95baB,0x56Eddb7aa87536c09CCc2793473599fD21A8b17F
7070,15627880,207128,9253675974,206484,644,138,4708710,0xC011a73ee8576Fb46F5E1c5751cA3B9Fe0af2a6F,0x28C6c06298d514Db089934071355E5743bf21d60
7071,15627880,250285,9253675974,246597,3688,1162,237,0x68b3465833fb72A70ecDF485E0e4C7bD8665Fc45,0x5F7AC769e181cA1472b28b8Ac1100194e7D4E0b1
7072,15627880,207128,9253675974,207128,0,2,4468957,0x32D0364b0Ac5c7b1e14E7DE17127783d573AE29a,0x21a31Ee1afC51d94C2eFcCAa2092aD1028285549
7073,15627880,42000,9253675974,42000,0,2,329541,0x737E3FcC809545eE343007B7bB0936177d0b8c41,0x9430801EBAf509Ad49202aaBC5F5Bc6fd8A3dAf8
7074,15627880,21000,9253675974,21000,0,2,1,0x6B08d85c678dBbD08Ebd82E42F12a0689EE2525C,0xf4eE30dE712940aAd245Fb299531933b3cd78c57
7075,15627880,39630,9253675974,39354,276,74,751,0xC02aaA39b223FE8D0A0e5C4F27eAD9083C756Cc2,0x7b1437fE59e68267839844bF09Cc06f88750e893
7076,15627880,76720,9253675974,67476,9244,1354,76,0xBaAa2B1F770c8AA0f86203C77A6b01E8315b3238,0x5012e2f6b9d81e96622BFA2F2764fcB406d8e6C1
7077,15627880,21000,9253675974,21000,0,2,6578037,0x608D46CE5f5B04c88D8801E8c3ccc6d40a108a4E,0xeB2629a2734e272Bcc07BDA959863f316F4bD4Cf
7078,15627880,70000,9253675974,69404,596,138,535,0xdAC17F958D2ee523a2206206994597C13D831ec7,0xf5491f793D47A6Ea22f5e0B9AD3990CF66c4b40B
7079,15627880,140088,9253675974,138524,1564,394,145,0x1Fa8559e873f698292766790AeCf8080A66433F6,0x5A0b48E90717c172daD1C8F4018D31533B357095
7080,15627880,140073,9253675974,138521,1552,394,179,0x1Fa8559e873f698292766790AeCf8080A66433F6,0x607CCBe0D994D7D58AeA202Ed47656bCf6F5Fa7f
7081,15627880,140088,9253675974,138524,1564,394,134,0x1Fa8559e873f698292766790AeCf8080A66433F6,0x3824814c5A422673b729771Cd38c0663e290B28c
7082,15627880,140088,9253675974,138524,1564,394,153,0x1Fa8559e873f698292766790AeCf8080A66433F6,0x103C0297f381319592AD889712E98ab330EF85BC
7083,15627880,143289,9253675974,136689,6600,1802,591,0x00000000006c3852cbEf3e08E8dF289169EdE581,0xCB405895fe35Ca438BF87Bf59fa490ad16c45500
7084,15627880,140088,9253675974,138524,1564,394,136,0x1Fa8559e873f698292766790AeCf8080A66433F6,0x207199a9F8B14Cb1f960F8e0DC1f6561a2C221DD
7085,15627880,140088,9253675974,138524,1564,394,92,0x1Fa8559e873f698292766790AeCf8080A66433F6,0xBaefb988E45c0125410fB8bDbF0A2037dC19d391
7086,15627880,140088,9253675974,138524,1564,394,82,0x1Fa8559e873f698292766790AeCf8080A66433F6,0x67725A67d67cd2E56633fBf38b2A688D13654c72
7087,15627880,1000000,9194558459,999568,432,74,34712,0x278dC748edA1d8eFEf1aDFB518542612b49Fcd34,0xBB437059584e30598b3AF0154472E47E6e2a45B9
7088,15627880,120000,9110984938,119332,668,138,1210291,0x4Fabb145d64652a948d72533023f6E7A623C7C53,0x912fD21d7a69678227fE6d08C64222Db41477bA0
7089,15627880,50000,9110984938,50000,0,2,476121,0x92526B99715AFeEd324Fb56EcAFcac8056379300,0x4d846dA8257BB0Ebd164EFf513DfF0F0c2C3c0ba
7090,15627880,21000,9000000000,21000,0,2,1,0x39F6a6C85d39d5ABAd8A398310c52E7c374F2bA3,0xD06B90f29F11eC11902F269fBD1F9D24f79d7f39
7091,15627880,21000,9000000000,21000,0,2,0,0x4E5B2e1dc63F6b91cb6Cd759936495434C7e972F,0x6cCB3d618aFC2bB119a071f02Dc0B7D8Ae89cae9
7092,15627880,70824,8953675974,69880,944,138,12,0x12b6893cE26Ea6341919FE289212ef77e51688c8,0xbae0c7d23c8bdB8A41ecF1F9841818f8D82c86Ed
7093,15627880,84354,8863675974,84150,204,74,11,0x9b9D659D4f2cF68b6616Cc0a65683f1951Eb725C,0xE4040731b3DB6CadE24766D90dE4E01b8f0A0926
7094,15627880,84354,8863675974,84150,204,74,11,0x9b9D659D4f2cF68b6616Cc0a65683f1951Eb725C,0x9Cac51E8C6f73600787B3c20F64Fc28549aEae34
7095,15627880,84354,8863675974,84150,204,74,16,0x9b9D659D4f2cF68b6616Cc0a65683f1951Eb725C,0x0093467dE3E397aaa00674471d73a653821eCC18
7096,15627880,84354,8863675974,84150,204,74,23,0x9b9D659D4f2cF68b6616Cc0a65683f1951Eb725C,0xD5E88cF364a48AdA9f55Ca74b3770398926E72c5
7097,15627880,523555,8763675974,508171,15384,2762,2550,0x23E79722Bb8B55a0d04f3AFbCFC34eb771526Adb,0x9b1acD4336EBF7656f49224d14A892566fd48e68
7098,15627880,143229,8753675974,136689,6540,1802,80,0x00000000006c3852cbEf3e08E8dF289169EdE581,0x546367D801a949107A95Cd1D591C741078598fF3
7099,15627880,21000,8753675974,21000,0,2,468,0xBa9dfe65e1fC38cDaD5175336b915aAF430B884B,0x8318777F8b8A1e81243Abb5e58B3483D2138F257
7100,15627880,21000,8753675974,21000,0,2,13,0xbBE1416c55587cE73A92aE13B04f05F61B55F57A,0x6D23Bd9DC29cDdbF1a097E2dcd8489C41CB62dC6
7101,15627880,46103,8753675974,45615,488,138,808,0x34Bc797F40Df0445c8429d485232874B15561728,0x7Bab03E0BC808Bc6643da50fD14FEB5EE6ff1956
7102,15627880,72878,8753675974,71006,1872,458,109,0xFbdDaDD80fe7bda00B901FbAf73803F2238Ae655,0x17c852867106C351516D4ccC2bd5810D49B224B2
7103,15627880,194250,8753675974,187818,6432,1802,8,0x00000000006c3852cbEf3e08E8dF289169EdE581,0xB54Fc14472E3bE241D4b66833dB13A84D44689c4
7104,15627880,46170,8753675974,45682,488,138,9,0x020cdC4775366aE436f13A7D333143432e884934,0xc7AC62Dd619B4f910Df8C6C56e08b2Cbe5129869
7105,15627880,46267,8753675974,45691,576,74,212,0x283Af0B28c62C092C9727F1Ee09c02CA627EB7F5,0xb4a53b85a873A5fFa6fBe995E39107C9C1bCd935
7106,15627880,535062,8753675974,531922,3140,906,23,0x68b3465833fb72A70ecDF485E0e4C7bD8665Fc45,0xB715cdB77806d154D4cEf39B7374f98054Bcc298
7107,15627880,21000,8753675974,21000,0,2,3608,0xbBc00e0e99087172FDb6e94A87Da869663467F12,0x9308c261Dc19178a8b81C07b80CaaDe0fF057f6e
7108,15627880,107939,8753675974,106987,952,202,892,0x60E4d786628Fea6478F785A6d7e704777c86a7c6,0x87BC2f2ba8C83F412feD5c3151de0ffBDC959984
7109,15627880,150144,8753675974,143528,6616,1810,89,0x00000000006c3852cbEf3e08E8dF289169EdE581,0x1095d6C40aBFf548BFF36342E923E5AdC04D1E88
7110,15627880,21000,8753675974,21000,0,2,2,0x58E02619FFC810A6Cf8eE8eC894d2B5589D56697,0x708c2b6c119ee68cA5C43e72B7833BB3BaB6440a
7111,15627880,201916,8753675974,199180,2736,842,10,0x68b3465833fb72A70ecDF485E0e4C7bD8665Fc45,0xf51f8d02F3361EFC60D11Ac5d91360D81168B217
7112,15627880,235444,8753675974,233608,1836,458,226,0x7a250d5630B4cF539739dF2C5dAcb4c659F2488D,0x839DD8E20c9ccE759B393607D00F64e954f9D566
7113,15627880,21000,8753675974,21000,0,2,110,0xD0471582c70d35B2A1928552F4D0f82fE4C6cFBa,0x5B3FDeDC929BEB803ad5a4d5CCe12Feba42Cc8CF
7114,15627880,48320,8753675974,47724,596,138,43,0x2260FAC5E5542a773Aa44fBCfeDf7C193bc2C599,0xe120550468513d17709DBd000d1C0b80d3F5Fb0e
7115,15627880,21000,8753675974,21000,0,2,93,0xC97B83f31A3AF82FFAE7fEc5cbc8302306c9a191,0x128D2B740E9fDed3B56C81D2352Ce8a296336b77
7116,15627880,21000,8753675974,21000,0,2,67,0x06CaC378D3cCCEda4AF7a7C1FC35838Db95BE932,0x30379F151e4FE4C50a3Fa15F797A34Db6374b10B
7117,15627880,36003,8753675974,35751,252,74,504,0xC02aaA39b223FE8D0A0e5C4F27eAD9083C756Cc2,0x58858EDA382541D8Ec29df08d77f7AED73613B92
7118,15627880,646377,8753675974,631689,14688,4490,30159,0xDEF171Fe48CF0115B1d80b88dc8eAB59176FEe57,0x65A8F07Bd9A8598E1b5B6C0a88F4779DBC077675
7119,15627880,55917,8753675974,54973,944,138,0,0x295B42684F90c77DA7ea46336001010F2791Ec8c,0xd35A3dc146d9238B12E9868280448B1019BA0522
7120,15627880,21000,8753675974,21000,0,2,440,0xFda13fFab1D19b97094580AFC05a8A7c1427e0cA,0x078222FD09B5bfa50Ce41C8E92e51eFED467f69A
7121,15627880,21000,8753675974,21000,0,2,50,0xD0471582c70d35B2A1928552F4D0f82fE4C6cFBa,0x78Ba4a0A7CF71fd7211c1dD6174fa22114211417
7122,15627880,115944,8753675974,115448,496,202,928,0xD930c1C055C96aD8f58c9d6761Ab4Cbb71E176F4,0x74CeE29D6d5c3c7974ED0DDDC94d40485cc46811
7123,15627880,21000,8753675974,21000,0,2,125,0xD0471582c70d35B2A1928552F4D0f82fE4C6cFBa,0x5a1b6a10c9dd5AE4b9BCD239AfE0dC92d3FD9725
7124,15627880,21000,8753675974,21000,0,2,118,0xD0471582c70d35B2A1928552F4D0f82fE4C6cFBa,0x213308370cbb4D77742B370866Df6dED2877ED3d
7125,15627880,21000,8753675974,21000,0,2,91,0xD0471582c70d35B2A1928552F4D0f82fE4C6cFBa,0x6b54a8Ecb8a823A6Bd3Fc9A3D7e1292bfA32369D
7126,15627880,21000,8753675974,21000,0,2,164,0xD0471582c70d35B2A1928552F4D0f82fE4C6cFBa,0x02a6db44D636945e2F335e985D499f4eb9F1B80D
7127,15627880,117887,8753675974,112319,5568,842,537,0x69d4584080EdC5d058D5C51Ac61ec0c14E417E70,0x02cE1f30Dc9f77C00CA1F227e75267D2C470CD80
7128,15627880,21000,8753675974,21000,0,2,80,0xD0471582c70d35B2A1928552F4D0f82fE4C6cFBa,0x2d5D9Db9886dA6Cd782E4425bB34094B949bD314
7129,15627880,95140,8753675974,94936,204,74,42,0xB092Ec81F41c619EEa434357477ea8A4b1455755,0xBfFEa57972fc6BD0498992CE29FFb8c14B904327
7130,15627880,53827,8753675974,53339,488,138,154,0xa9BA1A433Ec326bca975aef9a1641B42717197e7,0xd55Cf76DEe4eE9cBBe78a41BF3Fab65ED65A6F32
7131,15627880,21000,8753675974,21000,0,2,78,0xD0471582c70d35B2A1928552F4D0f82fE4C6cFBa,0xcC6E6f78ad32C0f0d8400f9f59B1e9e6eb8e6973
7132,15627880,185835,8753675974,183671,2164,586,163,0xFbdDaDD80fe7bda00B901FbAf73803F2238Ae655,0xB78F8440a21a3128439BE04ac257703EE549a41E
7133,15627880,21000,8753675974,21000,0,2,70,0xD0471582c70d35B2A1928552F4D0f82fE4C6cFBa,0xBCC483aA03FCb5C6F7c70983978bA9ADCD883B35
7134,15627880,205498,8753675974,201870,3628,1162,478,0x68b3465833fb72A70ecDF485E0e4C7bD8665Fc45,0x4bBDEc9fBbaEFc56b3b12d60605766552a8B35eF
7135,15627880,21000,8753675974,21000,0,2,73,0xD0471582c70d35B2A1928552F4D0f82fE4C6cFBa,0x7F6c313eBd7D90A55eE6Fc871f01aabC66A5a906
7136,15627880,180942,8753675974,177690,3252,1034,571,0x68b3465833fb72A70ecDF485E0e4C7bD8665Fc45,0xD25B0DBcf6FD24D05EE90d64042C79ba290c6D19
7137,15627880,46107,8753675974,45619,488,138,380,0x920A8d9e9F0DefD6F86e4388a5503B04CaC83b57,0x5Db71204C7D9a9a23359676aE159eD28D2fF4523
7138,15627880,21000,8753675974,21000,0,2,43,0xD0471582c70d35B2A1928552F4D0f82fE4C6cFBa,0x7E60D9593F34b983a4B48D6f5241ABBbE00b3c73
7139,15627880,21000,8753675974,21000,0,2,41,0xD0471582c70d35B2A1928552F4D0f82fE4C6cFBa,0xadD7b8Cba47761D6a5E9D22Bca31d1E37eC829F3
7140,15627880,21000,8753675974,21000,0,2,43,0xD0471582c70d35B2A1928552F4D0f82fE4C6cFBa,0x8530cdB7BB122B146B745A05C27F11e1937ef813
7141,15627880,52906,8753675974,52250,656,138,5,0x12b6893cE26Ea6341919FE289212ef77e51688c8,0x8Ada305556Ec6d68830EC896aD0D5752dD5903f6
7142,15627880,21000,8753675974,21000,0,2,40,0xD0471582c70d35B2A1928552F4D0f82fE4C6cFBa,0x25FAA2E226241Fe045806a4FACf57e472145185b
7143,15627880,172009,8753675974,169925,2084,522,983,0xd9e1cE17f2641f24aE83637ab66a2cca9C378B9F,0x0FED94bA4F477AE9cDDF413a4b16f6e63405d043
7144,15627880,46157,8753675974,45669,488,138,31,0x69d4584080EdC5d058D5C51Ac61ec0c14E417E70,0xB2362053e77ceb3bFE79a0EF12959E847AB7415a
7145,15627880,100569,8753675974,100517,52,10,140,0x1F78bF06b1b14aaF29833Efa371fC090e11D1420,0xFF2C00c056Af3bF2dad57400C8249DEf4744AF7A
7146,15627880,21000,8753675974,21000,0,2,32,0xD0471582c70d35B2A1928552F4D0f82fE4C6cFBa,0xa0F88717Bc577E4A25BD89ec1ac716e510B3FD11
7147,15627880,21000,8753675974,21000,0,2,40,0xD0471582c70d35B2A1928552F4D0f82fE4C6cFBa,0x9C0DEC7759508Ac03DE1b116FDe170561f4E82F3
7148,15627880,309289,8753675974,294809,14480,4746,147,0xaE9C73fd0Fd237c1c6f66FE009d24ce969e98704,0x01481a08FeFE6F3013A3b8F7f38BBea4e43927a9
7149,15627880,261206,8753675974,255322,5884,1738,17,0x68b3465833fb72A70ecDF485E0e4C7bD8665Fc45,0x18bD1d8e0bcC62E4E7066871d9116BD47A338DF5
7150,15627880,534336,8753675974,526804,7532,1524,105724,0x0000000000007F150Bd6f54c40A34d7C3d5e9f56,0x60530f5Ca4CB9907e0FBE67cA3AFCbFE56D19A5c
7151,15627880,21000,8753675974,21000,0,2,40,0xD0471582c70d35B2A1928552F4D0f82fE4C6cFBa,0x24AF2791A5AEA103e23280AaD15650C3de297b4e
7152,15627880,21000,8753675974,21000,0,2,41,0xD0471582c70d35B2A1928552F4D0f82fE4C6cFBa,0xAaac79F8A7871fB672bA9a3e9cb0AC84C65816a1
7153,15627880,49175,8753675974,48687,488,138,1070,0xE4AC79FBa1A7f826e80D092b869Cf622f92c3036,0x65C806378a5876B4cD74C3d62c338Ca29DDbE088
7154,15627880,48612,8753675974,47944,668,138,1,0x7D1AfA7B718fb893dB30A3aBc0Cfc608AaCfeBB0,0xC3353149119D3eF1b3a26F058deb0CC0f8B5f661
7155,15627880,21000,8753675974,21000,0,2,41,0xD0471582c70d35B2A1928552F4D0f82fE4C6cFBa,0xFFAC342103D23f594BBb3eC14c26DF62ee29D8d4
7156,15627880,130146,8753675974,129306,840,266,1618,0x65c25FADd9b88df5c8C101A3b99a5D614B708596,0x96Acf191C0112806f9709366BaD77642B99B21a9
7157,15627880,110542,8753675974,109834,708,266,732,0x283Af0B28c62C092C9727F1Ee09c02CA627EB7F5,0x1425C88ce0780E5bcE5f405333C81f9336dC52eA
7158,15627880,21000,8753675974,21000,0,2,39,0xD0471582c70d35B2A1928552F4D0f82fE4C6cFBa,0x46E723A38D41fFFeE8f5644D3DAB0E3C6041924F
7159,15627880,73170,8753675974,72574,596,138,98,0xA0b86991c6218b36c1d19D4a2e9Eb0cE3606eB48,0x05ea15707C8dD24e86b857B10ABcE37A8Ba5A93C
7160,15627880,21560,8753675974,21000,560,138,14,0x5E40037d3C0b2aFA1495582431f27a83d199a6D8,0x682Cad157D79d73Eb1D93d036B438d6F05084736
7161,15627880,195360,8753675974,188772,6588,1802,132,0x00000000006c3852cbEf3e08E8dF289169EdE581,0x6A50896247dEbf458394BD5ec52E91a5Eee045B5
7162,15627880,21000,8753675974,21000,0,2,36,0xD0471582c70d35B2A1928552F4D0f82fE4C6cFBa,0x6C5430c14Cd56BdBcA56E0F2CE0C94D248D35347
7163,15627880,211966,8753675974,206950,5016,1418,153,0x68b3465833fb72A70ecDF485E0e4C7bD8665Fc45,0x2486C9FC111b30Db51390dE9568E9001caC45169
7164,15627880,21000,8753675974,21000,0,2,26,0xD0471582c70d35B2A1928552F4D0f82fE4C6cFBa,0x4DFdcae3a4f7ab543a6329AeF3C76A5ec22c77bC
7165,15627880,3000000,8489597799,2997564,2436,320,2232,0xbD6a2bfcCFc6a4f7EcE6c005d50D01428Fb9c086,0x0037825fD75af7EEaCe28889665e3FAC8fdb6300
7166,15627880,302506,8465876974,302506,0,2,111460,0x065e3DbaFCb2C26A978720f9eB4Bce6aD9D644a1,0x065e3DbaFCb2C26A978720f9eB4Bce6aD9D644a1
7167,15627880,220326,8254733294,218962,1364,402,35,0x1111111254fb6c44bAC0beD2854e76F90643097d,0xd4eD780239E7ACD61321c5fE473e67F1f2E0dAc3
7168,15627880,51036,8254733294,50092,944,138,2,0x4b7265D153886a7Dc717e815862AcDE6FF7B5bc8,0xaE835202C62D33B921e3752B03659c287F50294F
7169,15627880,21000,8253675974,21000,0,2,27,0x3197D952d1Bf7C4Cdf38aCB6bB2dEf06FD4C9643,0x94fa8b1ab2840eAFdCc55011C6ba20859Dcfd3e8
7170,15627880,181476,8253675974,179912,1564,394,837,0x1Fa8559e873f698292766790AeCf8080A66433F6,0x3B34Bbe8A4a6FF559438B0b7EBCf3a01685BB66d
7171,15627880,181476,8253675974,179912,1564,394,1009,0x1Fa8559e873f698292766790AeCf8080A66433F6,0xf26695516E5418e534e8d466afA8857411cb1E36
7172,15627880,181476,8253675974,179912,1564,394,640,0x1Fa8559e873f698292766790AeCf8080A66433F6,0x98BDd55fd7B988630fF2bFFB059CF20682a5a612
7173,15627880,68974,8253675974,68318,656,138,80403,0x4E15361FD6b4BB609Fa63C81A2be19d873717870,0xA294cCa691e4C83B1fc0c8d63D9a3eeF0A196DE1
7174,15627880,43597,8253675974,43165,432,74,1,0x84C56E518C5b855f1ca404407fA03D20B5D47Ab8,0x5C0c82e42b7632ce9D92BBC3f0a0A9ab7FA1762c
7175,15627880,250000,8253675974,250000,0,2,45337127,0x847Dd792Fc466C38b78Ed2078cf1EE3C7E4bd7af,0xEA674fdDe714fd979de3EdF0F56AA9716B898ec8
7176,15627880,55904,8253675974,54960,944,138,20,0x011b0beAe3eC5953B4805b064cC78f6F892A99cC,0x70ADF2Ab6E7702E973cf86425f3018Fa5CD473e7
7177,15627880,21000,8253675974,21000,0,2,2,0xEe2439BF2434bB3849B3c86357CD493BaECdd39d,0x16D6746d7158432B1206227f3425D7936EDA95d2
7178,15627880,175971,8253675974,173199,2772,842,52,0x68b3465833fb72A70ecDF485E0e4C7bD8665Fc45,0x4D84fA2Ff21E328080930565Ecaeca6FE52E6ee5
7179,15627880,500000,8253675974,500000,0,2,63859,0xc0341f9617398eabd2E185121383546d4e4a5ee9,0x17F1a51dA68d27c94D2a51d92B27B5Bd4718b986
7180,15627880,21000,7993351599,21000,0,2,13,0x000F422887eA7d370FF31173FD3B46c8F66A5B1c,0xa9D1e48516255f395f5BFc2008f51a45Be09A461
7181,15627880,457536,7864078688,456020,1516,196,288,0xdb7A53E6AE058E1Dcf4502341E2ADFA522E2B29F,0xa23cABeCa2145Ce4e6fdD81a45be8fB53A4F9535
7182,15627880,94813,7553993170,94205,608,138,9348,0xdAC17F958D2ee523a2206206994597C13D831ec7,0xffeCC4533AFb260Ae7B0cfaE3DAF352167346548
7183,15627880,1000000,7506112326,998288,1712,330,109719,0x2796317b0fF8538F253012862c06787Adfb8cEb6,0x230A1AC45690B9Ae1176389434610B9526d2f21b
7184,15627880,332844,7489597799,161836,171008,21582,183250,0x5E4e65926BA27467555EB562121fac00D24E9dD2,0x6887246668a3b87F54DeB3b94Ba47a6f63F32985
7185,15627880,300000,7489597799,299452,548,138,39,0xb12494C8824fc069757F47d177E666c571Cd49aE,0xF7be43c8a3d2d7e098594fA9920A7D4D0b4Ca526
7186,15627880,30000,7253675974,30000,0,2,3672,0x40638C53D6EF529243A981844B7192744640DD40,0xF2f5C73fa04406b1995e397B55c24aB1f3eA726C
7187,15627881,293696,7134214218,291512,2184,650,100938,0xA69babEF1cA67A37Ffaf7a485DfFF3382056e78C,0x431B5A84aCC1297Eda88259f300262F1bc3A74f3
7188,15627881,233712,7134214218,231528,2184,650,119831,0xA69babEF1cA67A37Ffaf7a485DfFF3382056e78C,0xeCa2e2D894D19778939bD4DfC34D2a3C45E96456
7189,15627881,300001,7134214218,298593,1408,394,224457,0x98C3d3183C4b8A650614ad179A1a98be0a8d6B8E,0x91aaE0aAfd9D2d730111b395c6871f248d7Bd728
7190,15627881,274940,7134214218,272792,2148,650,117900,0xA69babEF1cA67A37Ffaf7a485DfFF3382056e78C,0x26bce6eCb5b10138e4bf14aC0ffcc8727FEF3B2e
7191,15627881,256098,7134214218,253962,2136,650,111041,0xA69babEF1cA67A37Ffaf7a485DfFF3382056e78C,0x36a454aEF52938c8637CD4689B2980C1Cfd43389
7192,15627881,21014,94002162546,21014,0,2,92674,0x5E2B6c6B2240d582995537D3FafdB556E4A3822F,0x5E2B6c6B2240d582995537D3FafdB556E4A3822F
7193,15627881,200000,30250000000,199332,668,138,1205082,0x514910771AF9Ca656af840dff83E8264EcF986CA,0xFfec0067F5a79CFf07527f63D83dD5462cCf8BA4
7194,15627881,210000,30000000000,210000,0,2,78546,0x4c9AF439b1A6761B8E549D8d226A468a6b2803A8,0xD7efCbB86eFdD9E8dE014dafA5944AaE36E817e4
7195,15627881,99396,14057821812,98788,608,138,0,0xdAC17F958D2ee523a2206206994597C13D831ec7,0xCDe5f34f873Bec5B32D76Aee30D901c4F498F549
7196,15627881,21000,14000000000,21000,0,2,1,0x500A746c9a44f68Fe6AA86a92e7B3AF4F322Ae66,0x580dB5f90742363dfc0Eb0751dDe24Bd55219F97
7197,15627881,21000,14000000000,21000,0,2,1,0x500A746c9a44f68Fe6AA86a92e7B3AF4F322Ae66,0x3abE88196d93F882c34521FCD4475a6Af36dD6f6
7198,15627881,142877,12406089892,141517,1360,394,21,0x2E2234b3A848F895a60B2071F90303CD02f7491D,0x9421E7934E35e841db6c052BDF298544108440BE
7199,15627881,142877,12406089892,141517,1360,394,12,0x2E2234b3A848F895a60B2071F90303CD02f7491D,0xFcfEfe991BdEE2F937F60Fc856E51CDCb277C91B
7200,15627881,33600,12134214218,33600,0,2,12,0xB18FE18b6BEa40DB0440a833855bd09570E7A45c,0x11a839fc79F822f9b869Bb820A51DD5D25Caf13A
7201,15627881,75851,11640000000,75243,608,138,153,0xdAC17F958D2ee523a2206206994597C13D831ec7,0x156338886A8d4a2f305f9Be51Ccc55c2d120698a
7202,15627881,178867,11538214219,177343,1524,230,2327,0x9507c04B10486547584C37bCBd931B2a4FeE9A41,0xB00Fe43AA83A6315661884b9189FD556c1954b81
7203,15627881,164312,11134214218,162728,1584,230,2371,0x9507c04B10486547584C37bCBd931B2a4FeE9A41,0x9380Fbf3c062D638989fcD6D15b1f5B2cB3372D8
7204,15627881,111588,11000000000,109636,1952,330,7,0x00000000000C2E074eC69A0dFb2997BA6C7d2e1e,0x03cc71FBe5E1620f5a3D9aC2135642260ADC82bb
7205,15627881,76548,10863143473,75512,1036,202,4709932,0x320623b8E4fF03373931769A31Fc52A4E78B5d70,0x2FAF487A4414Fe77e2327F0bf4AE2a264a776AD2
7206,15627881,74624,10863143473,73600,1024,202,4709933,0x42bBFa2e77757C645eeaAd1655E0911a7553Efbc,0x2FAF487A4414Fe77e2327F0bf4AE2a264a776AD2
7207,15627881,76207,10859432364,75231,976,202,355155,0xdAC17F958D2ee523a2206206994597C13D831ec7,0x7abE0cE388281d2aCF297Cb089caef3819b13448
7208,15627881,90000,10376784444,90000,0,2,784414,0x51C84b91C5BBeFA22E5Dd2a232fAdBF643feb5C0,0xcaD621da75a66c7A8f4FF86D30A2bF981Bfc8FdD
7209,15627881,90000,10376784444,90000,0,2,784415,0x808dd2A92e823EF37e7ad0623117383289118Dd8,0xcaD621da75a66c7A8f4FF86D30A2bF981Bfc8FdD
7210,15627881,181476,10134214218,179912,1564,394,789,0x1Fa8559e873f698292766790AeCf8080A66433F6,0xF5889E6a7618A6e70d294DcD64fE5f0D1d27F650
7211,15627881,181476,10134214218,179912,1564,394,656,0x1Fa8559e873f698292766790AeCf8080A66433F6,0x9274E50E3922fBc7A3CE99f94EFc32D3BECa6c39
7212,15627881,191041,10000000000,190165,876,266,1396,0xd588b586D61C826A0e87919b3D1a239206d58bf2,0xC22d03e13B888Dabb33A1575e4F6542f0e996622
7213,15627881,21000,10000000000,21000,0,2,172,0xB00B6D69822dA235a99d2242376066507C9a97b7,0x4Efaf884B0F9B5261618F52d11BaA7E698a3546f
7214,15627881,21000,10000000000,21000,0,2,144,0xB00B6D69822dA235a99d2242376066507C9a97b7,0xEE17C9e5BE6fB3c22787380C3f86a2f6C1977F57
7215,15627881,21000,10000000000,21000,0,2,150,0xB00B6D69822dA235a99d2242376066507C9a97b7,0x919eF9d63Dce0F1236613c594Bb932c2354840aE
7216,15627881,21000,10000000000,21000,0,2,144,0xB00B6D69822dA235a99d2242376066507C9a97b7,0xf168041fc1C22292AF049B037743BF3e97136B8E
7217,15627881,21000,10000000000,21000,0,2,148,0xB00B6D69822dA235a99d2242376066507C9a97b7,0x79636263EE08003350E0af73f625806B13bEf075
7218,15627881,21000,10000000000,21000,0,2,151,0xB00B6D69822dA235a99d2242376066507C9a97b7,0xea4cc6FD14dd8d53F16fa4A86AD5fb4E25c9F556
7219,15627881,50000,9797480325,50000,0,2,476122,0x7f9f42AfA0Aa8E9168db848E1179beCc790D123C,0x4d846dA8257BB0Ebd164EFf513DfF0F0c2C3c0ba
7220,15627881,150756,9634214218,150692,64,10,27,0x65c2e54a4c75ff6da7b6B32369c1677250075fb2,0x68774a38142D6d8fD582d9d5b02521a8b0e54803
7221,15627881,106088,9634214218,105768,320,138,163,0x0fC262e7D808652D7aEFD2a7535a0Abf13865A1f,0x618BAfB947e11955DB7aa4473809eA739253f6E9
7222,15627881,125808,9634214218,125152,656,138,13,0x2aA297c3208bD98a9a477514d3C80ace570A6deE,0xd51266568d8f60Bc85Ddc2A94d375b4c4B5Dcbe4
7223,15627881,329032,9634214218,324688,4344,1034,0,0x197492CCB4B1acaAAcd43432657A17832E36AB49,0x201Db591566e839Baffe5f1c2aaa0e458b3221f9
7224,15627881,94813,9184214218,94205,608,138,17,0xdAC17F958D2ee523a2206206994597C13D831ec7,0x45c2afA950fBd34759Cee38eD2516921615Ae9e3
7225,15627881,140073,9134214218,138521,1552,394,67,0x1Fa8559e873f698292766790AeCf8080A66433F6,0x9AD0A9d911F20b2D0f2E006Efb1840b586053003
7226,15627881,140088,9134214218,138524,1564,394,77,0x1Fa8559e873f698292766790AeCf8080A66433F6,0x908eB78E0743d55062DA89A9Bc3DD260BcE258d1
7227,15627881,21000,9134214218,21000,0,2,2759945,0xa3020FFE845cdc30DCADe2f5459afa91815F4093,0x267be1C1D684F78cb4F6a176C4911b741E4Ffdc0
7228,15627881,21000,9134214218,21000,0,2,2759946,0x510Ef78DB64D4521356F9b1BD04129D42BAEDFcf,0x267be1C1D684F78cb4F6a176C4911b741E4Ffdc0
7229,15627881,140073,9134214218,138521,1552,394,65,0x1Fa8559e873f698292766790AeCf8080A66433F6,0x9df9F28Ded7C0C1296D79C2B125A3A994DF92653
7230,15627881,140073,9134214218,138521,1552,394,63,0x1Fa8559e873f698292766790AeCf8080A66433F6,0xC93df46FF35CEfc7E1BfEC8265668c93D01992b0
7231,15627881,140088,9134214218,138524,1564,394,79,0x1Fa8559e873f698292766790AeCf8080A66433F6,0xB101e45A9954c47E27bC244FCD37a469Ce9607D2
7232,15627881,181476,9134214218,179912,1564,394,2434,0x1Fa8559e873f698292766790AeCf8080A66433F6,0x85026596042Cf8CAB1b521bCca86C56cf2D2ecAe
7233,15627881,140088,9134214218,138524,1564,394,69,0x1Fa8559e873f698292766790AeCf8080A66433F6,0xC5F6b5A7a0a273b63dD3F881D3725163F5944fdF
7234,15627881,140088,9134214218,138524,1564,394,65,0x1Fa8559e873f698292766790AeCf8080A66433F6,0x4CF0e892b7AA3DC245dF7a317b07eECa0EB4C70f
7235,15627881,46267,9134214218,45691,576,74,607,0x283Af0B28c62C092C9727F1Ee09c02CA627EB7F5,0x476c8712bf3A84f5a04db2D6a81d374f3F1AAD99
7236,15627881,140088,9134214218,138524,1564,394,64,0x1Fa8559e873f698292766790AeCf8080A66433F6,0xb7b74f89ED6D4175DDc9e3B1C6Bdb6d7D47cd246
7237,15627881,140088,9134214218,138524,1564,394,48,0x1Fa8559e873f698292766790AeCf8080A66433F6,0x9C28DEDB92F1F218C74A32BeEAa9c068A34FD3fe
7238,15627881,205789,9134214218,202149,3640,1162,784,0x68b3465833fb72A70ecDF485E0e4C7bD8665Fc45,0xfDdd273FbA4b480947eCE837f45f50ef3CBb8cBf
7239,15627881,140088,9134214218,138524,1564,394,46,0x1Fa8559e873f698292766790AeCf8080A66433F6,0x6Dfe0e87db93CD5De3592966B5ede015428eb0d6
7240,15627881,21000,9134214218,21000,0,2,346925,0xAa37f3FDBdd320dd065FEE9ac7cdB99C07367CEa,0x77696bb39917C91A0c3908D577d5e322095425cA
7241,15627881,140088,9134214218,138524,1564,394,100,0x1Fa8559e873f698292766790AeCf8080A66433F6,0x1f2e4ec486ADdBd5583c3cf3AE79Bc6956cc84aE
7242,15627881,500000,9134214218,498236,1764,458,973,0xa24787320ede4CC19D800bf87B41Ab9539c4dA9D,0x517061E21a3aAa14219D895d29e66e02a3A50e75
7243,15627881,140073,9134214218,138521,1552,394,44,0x1Fa8559e873f698292766790AeCf8080A66433F6,0xf8a5Bf83cE9cEAD52331c81b17a882c3521457d7
7244,15627881,140088,9134214218,138524,1564,394,44,0x1Fa8559e873f698292766790AeCf8080A66433F6,0x2ea11190F1Ce880572ac25544A0276fB1b66df9f
7245,15627881,771000,9134214218,766292,4708,1162,16,0xe66B31678d6C16E9ebf358268a790B763C133750,0x9ef2d2b53026b863dEb58a2Fc53F2c9195Bf47AD
7246,15627881,140073,9134214218,138521,1552,394,44,0x1Fa8559e873f698292766790AeCf8080A66433F6,0x9d4887c40bdB403ce30043B440aA89F295Ee38f1
7247,15627881,167934,9134214218,167362,572,138,15,0x3a18d6AaB7f6C7F10444424b061F4A0c2c80e087,0x341188BDCF66eCA2F4Ef7BB00Ea91f73D8C8aa48
7248,15627881,295951,9134214218,291647,4304,1098,0,0xe66B31678d6C16E9ebf358268a790B763C133750,0x6a820102208f750328Cd503771607c4e78850Df0
7249,15627881,42000,9134214218,42000,0,2,329542,0xD306F71193D82BCE69786dBCb76d5658a818C965,0x9430801EBAf509Ad49202aaBC5F5Bc6fd8A3dAf8
7250,15627881,140059,9134214218,138519,1540,394,40,0x1Fa8559e873f698292766790AeCf8080A66433F6,0x7Df09e6330F797f5C5cF7028D1bB57Bd7b0b91a3
7251,15627881,140088,9134214218,138524,1564,394,44,0x1Fa8559e873f698292766790AeCf8080A66433F6,0x44c79AbeF5028E86A769d9Ed93bA44933D877BE5
7252,15627881,85000,9134214218,84428,572,138,83,0xD27dcbcC8778a8AB33AAc529Df36a634567Be325,0x9c4977fA2399CAaF1D16140438D4156767595350
7253,15627881,85000,9134214218,84428,572,138,58,0xD27dcbcC8778a8AB33AAc529Df36a634567Be325,0x0351c552fD6633cF0828486bA7B75980084Efcf9
7254,15627881,140088,9134214218,138524,1564,394,38,0x1Fa8559e873f698292766790AeCf8080A66433F6,0x3A414c71330CBaEd14Bb71B5c1d570B0594B5935
7255,15627881,54022,9134214218,53758,264,74,313,0xC02aaA39b223FE8D0A0e5C4F27eAD9083C756Cc2,0x9e456247026Ac3a6f38B4885e6A593089732861D
7256,15627881,54022,9134214218,53758,264,74,14,0xC02aaA39b223FE8D0A0e5C4F27eAD9083C756Cc2,0x1f41509DC6F3777EF62b20645a0dc58D77c3dB51
7257,15627881,21000,9134214218,21000,0,2,34,0x8D438Fc9C0C4c0f01F32943810b6955bb39B9AE0,0x4C30A441E5Ae890474EbaA841F782A76AF6E3979
7258,15627881,140088,9134214218,138524,1564,394,30,0x1Fa8559e873f698292766790AeCf8080A66433F6,0xD6c9B03143d29dd6Db29578f166d29c77A59f49b
7259,15627881,140088,9134214218,138524,1564,394,41,0x1Fa8559e873f698292766790AeCf8080A66433F6,0xbF4182376ff5797F5797A1f9762DF6cf32AdE3e0
7260,15627881,140088,9134214218,138524,1564,394,34,0x1Fa8559e873f698292766790AeCf8080A66433F6,0xB361fc49EEc31E34fda61FfD760f2181079A1A57
7261,15627881,140088,9134214218,138524,1564,394,24,0x1Fa8559e873f698292766790AeCf8080A66433F6,0x8d7f473d354A2CA091AB7cd4D583eBf65D5840a7
7262,15627881,21000,9134214218,21000,0,2,1228780,0x5eaF17f3Da46eD21047e52f54736BB4bAC125749,0x71660c4005BA85c37ccec55d0C4493E66Fe775d3
7263,15627881,21000,9134214218,21000,0,2,72346,0x113478641A02913Cf123bfF4f9C99Df6CEA4d267,0xab97925eB84fe0260779F58B7cb08d77dcB1ee2B
7264,15627881,140088,9134214218,138524,1564,394,24,0x1Fa8559e873f698292766790AeCf8080A66433F6,0x03Cb28e3A99F72eAe71e0e6Ce543dF9326F2e7BF
7265,15627881,181458,9134214218,179906,1552,394,0,0x1Fa8559e873f698292766790AeCf8080A66433F6,0x6430261a32428147C273d57272C03ff11885581f
7266,15627881,140088,9134214218,138524,1564,394,24,0x1Fa8559e873f698292766790AeCf8080A66433F6,0x3D159BE58f59aCF896E4859AD9a483a1890F317e
7267,15627881,21000,9134214218,21000,0,2,72347,0xB55982bEa848240314C8F2968b32FF3BF21aBb57,0xab97925eB84fe0260779F58B7cb08d77dcB1ee2B
7268,15627881,21000,9134214218,21000,0,2,7100803,0x6eE33e145C0f8cC86D9630A915efd30Ec33312B9,0xddfAbCdc4D8FfC6d5beaf154f18B778f892A0740
7269,15627881,48792,9134214218,48184,608,138,16526,0xA0b86991c6218b36c1d19D4a2e9Eb0cE3606eB48,0x4B23d52eFf7C67F5992C2aB6D3f69b13a6a33561
7270,15627881,140088,9134214218,138524,1564,394,25,0x1Fa8559e873f698292766790AeCf8080A66433F6,0xe10b97cD61e9a8B03672c42f51A8Bfc9406155F0
7271,15627881,48792,9134214218,48184,608,138,18568,0xA0b86991c6218b36c1d19D4a2e9Eb0cE3606eB48,0x90E18a6920985DBACc3d76Cf27a3F2131923C720
7272,15627881,48792,9134214218,48184,608,138,12878,0xA0b86991c6218b36c1d19D4a2e9Eb0cE3606eB48,0x6c8dd0e9cC58c07429e065178d88444B60e60b80
7273,15627881,21000,9134214218,21000,0,2,28,0x5b7717121976449B1dF58C870f1c2AD6931e713A,0x7b972f73ADB4ADd26AdB0a092027C6EC7662ca53
7274,15627881,140073,9134214218,138521,1552,394,25,0x1Fa8559e873f698292766790AeCf8080A66433F6,0xA8FA026dEafD32312c7730B54aAd57B2d4b59401
7275,15627881,21000,9134214218,21000,0,2,0,0xddfAbCdc4D8FfC6d5beaf154f18B778f892A0740,0x1232A18C318E5b33af9933edD81BB7BC8e6A1838
7276,15627881,140088,9134214218,138524,1564,394,25,0x1Fa8559e873f698292766790AeCf8080A66433F6,0xA2829781D4ba32bCbC3B1808381796Ac6AaE1324
7277,15627881,48780,9134214218,48184,596,138,14658,0xA0b86991c6218b36c1d19D4a2e9Eb0cE3606eB48,0xBc8Ec259E3026aE0D87bc442D034d6882ce4a35C
7278,15627881,140088,9134214218,138524,1564,394,24,0x1Fa8559e873f698292766790AeCf8080A66433F6,0x4C23FDE8C671D17B8792A4444b64E09761e8f4Dc
7279,15627881,21000,9134214218,21000,0,2,46,0xddfAbCdc4D8FfC6d5beaf154f18B778f892A0740,0xdeB35278D298d781faBd43Db9e22F56f81C21AF6
7280,15627881,307530,9000000000,304238,3292,970,12,0x68b3465833fb72A70ecDF485E0e4C7bD8665Fc45,0x99A104700f99FbB66b9079aAD4e60653D65ED141
7281,15627881,184505,8984949412,182717,1788,458,14,0x53e0e51b5Ed9202110D7Ecd637A4581db8b9879F,0x22638A0155732C3bEA770341Db62A65CD35602e5
7282,15627881,668421,8744214218,656733,11688,3914,297,0xDEF171Fe48CF0115B1d80b88dc8eAB59176FEe57,0x17D065070486Ca0fC8b4B382b946BE79Fb4fF10D
7283,15627881,103064,8634214218,99788,3276,1034,263,0x0000000000c2d145a2526bD8C716263bFeBe1A72,0x52EAf342132696563bf4bda8171f586AB2679d5f
7284,15627881,21000,8634214218,21000,0,2,32,0xD0471582c70d35B2A1928552F4D0f82fE4C6cFBa,0xD2929138D887c8399fa7e9f0739E5584eDbEaB8F
7285,15627881,21000,8634214218,21000,0,2,30,0xD0471582c70d35B2A1928552F4D0f82fE4C6cFBa,0x091EA3B1F9FED6eCa002e4cb9bd9736EADDAA4Ea
7286,15627881,78538,8634214218,77894,644,138,2,0x12b6893cE26Ea6341919FE289212ef77e51688c8,0x9760199B6509Cf3263a91696ADC2C78c12234da5
7287,15627881,21000,8634214218,21000,0,2,33,0xD0471582c70d35B2A1928552F4D0f82fE4C6cFBa,0x21fa35CA99eF5DB157eb3232928412D235BC5148
7288,15627881,48558,8634214218,47926,632,138,106,0x7D1AfA7B718fb893dB30A3aBc0Cfc608AaCfeBB0,0xaEDF74546Caa4e1e13fAa01b153c1e8099d4623b
7289,15627881,21000,8634214218,21000,0,2,32,0xD0471582c70d35B2A1928552F4D0f82fE4C6cFBa,0x9572208C73E2EB324cD2E669eCc405Ec7E540D3d
7290,15627881,21000,8634214218,21000,0,2,17,0xD0471582c70d35B2A1928552F4D0f82fE4C6cFBa,0xF0716d60356c058BfE7B4DFE3839F88b64342B8c
7291,15627881,21000,8634214218,21000,0,2,28,0xD0471582c70d35B2A1928552F4D0f82fE4C6cFBa,0x52F0332598088E399ad502001bD7F048980cc6D8
7292,15627881,21000,8634214218,21000,0,2,27,0xD0471582c70d35B2A1928552F4D0f82fE4C6cFBa,0x4Baca8Bcb96D04aEDAfF986CF1a3EDC1d782D779
7293,15627881,21000,8634214218,21000,0,2,26,0xD0471582c70d35B2A1928552F4D0f82fE4C6cFBa,0x5Dfb44e9af81Bf290B75c0F1f7d3A44d622FA3C6
7294,15627881,198771,8634214218,180331,18440,4554,261,0x00000000006c3852cbEf3e08E8dF289169EdE581,0xf7303F4944A25237cDB7D0efb306afB5649Fad97
7295,15627881,46170,8634214218,45682,488,138,10,0x020cdC4775366aE436f13A7D333143432e884934,0xc7AC62Dd619B4f910Df8C6C56e08b2Cbe5129869
7296,15627881,49308,8634214218,48356,952,202,29,0xb18380485f7bA9C23Deb729bEDD3A3499Dbd4449,0x56Aa3fe61A40d8D8d476253C47E488a26b507B36
7297,15627881,21000,8634214218,21000,0,2,26,0xD0471582c70d35B2A1928552F4D0f82fE4C6cFBa,0xd5a515Ff7C0a46dce9FA0F713c3B00dcB73BcF09
7298,15627881,21000,8634214218,21000,0,2,17,0xD0471582c70d35B2A1928552F4D0f82fE4C6cFBa,0x483685051853532ac51532209AD086B49B533B64
7299,15627881,183826,8634214218,180186,3640,1162,180,0x68b3465833fb72A70ecDF485E0e4C7bD8665Fc45,0x63b79BF8A11EF582CC97CD7C3B0D48C0ed408BC9
7300,15627881,21000,8634214218,21000,0,2,13,0xD0471582c70d35B2A1928552F4D0f82fE4C6cFBa,0xCd4AD36163fAa9c233CfB0ea4e38f2b67f205dAB
7301,15627881,21000,8634214218,21000,0,2,21,0x2108Ced73A30674A9dB5A8B22bE3BC8f5c79D8E3,0x76b36A038cd2086406120b2807258cD7b857308F
7302,15627881,157481,8634214218,155609,1872,842,527,0x7239F01C663f3c9fD7A44cB2BC8d19B67bdD1336,0xa8771fD60920f165Fb4E4CFCA2Cb1ab055f9ED53
7303,15627881,21000,8634214218,21000,0,2,16,0xD0471582c70d35B2A1928552F4D0f82fE4C6cFBa,0xa63F2d195CA78962035cEb8872d258d23CEb9e89
7304,15627881,21000,8634214218,21000,0,2,13,0xD0471582c70d35B2A1928552F4D0f82fE4C6cFBa,0x9621DD2D3Bfba115a6d6b49912330C2F5cdB3F3c
7305,15627881,143293,8634214218,136689,6604,1810,81,0x00000000006c3852cbEf3e08E8dF289169EdE581,0x546367D801a949107A95Cd1D591C741078598fF3
7306,15627881,21000,8634214218,21000,0,2,13,0xD0471582c70d35B2A1928552F4D0f82fE4C6cFBa,0x94fE4878513330ebC7CDe5Ba3C07a8f766b3559B
7307,15627881,176558,8634214218,169982,6576,1802,115,0x00000000006c3852cbEf3e08E8dF289169EdE581,0xafd4a3232a0345f5D15159e6E8f3A5960CDeC89E
7308,15627881,21000,8634214218,21000,0,2,13,0xD0471582c70d35B2A1928552F4D0f82fE4C6cFBa,0xeB0d71436178d29366Bae0aE4080a1ca45979c4D
7309,15627881,21000,8634214218,21000,0,2,13,0xD0471582c70d35B2A1928552F4D0f82fE4C6cFBa,0xBe8f24F0B7C7Da483033Af1Aee8752a90F51b826
7310,15627881,46080,8634214218,45592,488,138,800,0x12ce6B9fd2236042b9Ffe70d55f527875A89F6a9,0x0a5C6E05CEAA5E9C91C13bD9d8bf23ac8bd4B2D6
7311,15627881,21000,8634214218,21000,0,2,13,0xD0471582c70d35B2A1928552F4D0f82fE4C6cFBa,0x74648f4484c1e1D4860BaFdD5af11a2A330558c3
7312,15627881,21000,8634214218,21000,0,2,21,0x9300c7652375B202096D3E87D4B40A93F04137f6,0xf48E977751858e37912Ff443c6F4F3cd5057A3A6
7313,15627881,21000,8634214218,21000,0,2,13,0xD0471582c70d35B2A1928552F4D0f82fE4C6cFBa,0x4a1dDC63b351B58313eb47D6F2E705488068Eb28
7314,15627881,21000,8634214218,21000,0,2,7,0x404583ebd340981AfD4D03abC0476C2bb593281b,0x5a3850a9159d64275D46fbEEceF7101b852c349C
7315,15627881,21000,8634214218,21000,0,2,13,0xD0471582c70d35B2A1928552F4D0f82fE4C6cFBa,0x2e5fBFC5c7337562fB77e373Ec24D869C87ABeBE
7316,15627881,21000,8634214218,21000,0,2,13,0xD0471582c70d35B2A1928552F4D0f82fE4C6cFBa,0xF910f25585af453Cef0Da6591C108672f02373F5
7317,15627881,131198,8634214218,125114,6084,1682,191,0x00000000006c3852cbEf3e08E8dF289169EdE581,0xE74C9142b98bB85bdE035a98373C69177680e9a6
7318,15627881,21000,8634214218,21000,0,2,13,0xD0471582c70d35B2A1928552F4D0f82fE4C6cFBa,0x37Aa7E5e910C6222757B887003974523F7Ab6896
7319,15627881,196090,8634214218,189526,6564,1802,138,0x00000000006c3852cbEf3e08E8dF289169EdE581,0x89714D3465caB529B94F22dd5b779131B05AE278
7320,15627881,94813,8634214218,94205,608,138,16,0xdAC17F958D2ee523a2206206994597C13D831ec7,0xf2669039FCFC8472CEFEf5CCD42e825646A16e2e
7321,15627881,21000,8634214218,21000,0,2,13,0xD0471582c70d35B2A1928552F4D0f82fE4C6cFBa,0x65b88757359cd11EC7Dc646BcdE4A1630CA9BD44
7322,15627881,53999,8634214218,53427,572,138,170,0x6de7aC835EC6841Af9b94fd1273dB83B8d69e3f7,0x778cB85B6D8a48817C25E6714d3e0E03517e5C3b
7323,15627881,21000,8634214218,21000,0,2,13,0xD0471582c70d35B2A1928552F4D0f82fE4C6cFBa,0x2A3e86C924235dda42769D4e212E324B3bD121E6
7324,15627881,152257,8634214218,151649,608,138,129,0xc5fB36dd2fb59d3B98dEfF88425a3F425Ee469eD,0xFc30c771c795b4d23A44B861d91A542365f21e33
7325,15627881,21000,8634214218,21000,0,2,205,0x52a817BF1bc488E3916575E5c919783cd5293d95,0x5ca7134593f4498eEB8b381d4ea878Cd9D35A953
7326,15627881,51533,8634214218,50961,572,138,1269,0x7fef3f3364C7d8B9BFabB1b24D5CE92A402c6Bd3,0x7c03C6FC64293c460bE652F4015aD232E695aC8e
7327,15627881,167190,8634214218,166618,572,138,29,0xBC6f8c94979207b5206A3E82A3d84dC82F987829,0x6a614e1089611c6577F690EbbE934786b84A097D
7328,15627881,21000,8634214218,21000,0,2,13,0xD0471582c70d35B2A1928552F4D0f82fE4C6cFBa,0x8478712fB4318a79e66dCd2B172024681d83289a
7329,15627881,213383,8634214218,195003,18380,4554,401,0x00000000006c3852cbEf3e08E8dF289169EdE581,0x7cFBfE6a6C5a1089a542534C0c7F69e749f6b80f
7330,15627881,21000,8634214218,21000,0,2,3036,0x68a1F25D55230A9224395Db7f50F57e7b460C93D,0xf2E9db3c5D06015833Df31eD3C37172a2B34EE7F
7331,15627881,46635,8634214218,46147,488,138,360,0x8cFC27c666a31638AD5Cce720c5d09373517F58b,0x1Ab5d274F499C602E2281dEcaa717AD29bcBB4E5
7332,15627881,21000,8634214218,21000,0,2,13,0xD0471582c70d35B2A1928552F4D0f82fE4C6cFBa,0x0527beb38da888F88Deb2B5927ea41132B5377f6
7333,15627881,234588,8634214218,232976,1612,394,19,0xd9e1cE17f2641f24aE83637ab66a2cca9C378B9F,0x1E759C0af530cc66D0E0283Aa0748a79Dc9228DF
7334,15627881,21000,8634214218,21000,0,2,13,0xD0471582c70d35B2A1928552F4D0f82fE4C6cFBa,0xe4Aa3EFC89cF2b915Ce8f811496593FE7a465243
7335,15627881,178822,8634214218,171590,7232,1938,675,0x00000000006c3852cbEf3e08E8dF289169EdE581,0x99E8A13E77CEC29a3C64cEA54A82a53A22496917
7336,15627881,56652,8634214218,55708,944,138,1,0x892ED660Ba89BEAb93E35dF7fFa909048c3bB115,0xEbEdB72D69A11a38F932bF6Fdd5E2F3097CD559D
7337,15627881,21000,8634214218,21000,0,2,6,0xD0471582c70d35B2A1928552F4D0f82fE4C6cFBa,0xFd44f1836Fb9f513354234bef108D3cD9c535cb6
7338,15627881,51406,8634214218,50918,488,138,381,0x5b3eFf90fF5541c68463434f4301D5e8C297A471,0x5Db71204C7D9a9a23359676aE159eD28D2fF4523
7339,15627881,21000,8634214218,21000,0,2,13,0xD0471582c70d35B2A1928552F4D0f82fE4C6cFBa,0x1B187f5BD9452400AF4549Ca94D2373B63E4ad25
7340,15627881,175074,8634214218,173534,1540,394,4219,0x1Fa8559e873f698292766790AeCf8080A66433F6,0xfcDAA268c4d2933DF7D37E8C8726884228CA1566
7341,15627881,124047,8634214218,122903,1144,394,98,0x9beC8252AC5ea0D3040f0Df876e8F2558F9Da43e,0x7Aa96077eB5c3DE1c061ca20fa1920A8562097f7
7342,15627881,21000,8634214218,21000,0,2,13,0xD0471582c70d35B2A1928552F4D0f82fE4C6cFBa,0x132d254D9b5966FD0C8078f747b81042f0c901D0
7343,15627881,21000,8634214218,21000,0,2,6,0xD0471582c70d35B2A1928552F4D0f82fE4C6cFBa,0x5Be5905167F69B2B517a2613DF35991EfcA3ab61
7344,15627881,21000,8634214218,21000,0,2,6,0xD0471582c70d35B2A1928552F4D0f82fE4C6cFBa,0xBf2493E2B2D08620eEbef238B0C3E8ce8F7aA1C2
7345,15627881,21000,8634214218,21000,0,2,6,0xD0471582c70d35B2A1928552F4D0f82fE4C6cFBa,0x56900aA4668De0Edf910c5c608A10aD1977273cA
7346,15627881,21000,8634214218,21000,0,2,6,0xD0471582c70d35B2A1928552F4D0f82fE4C6cFBa,0xe98F21FdBeC89B1346306e8AEB13D16167bfB767
7347,15627881,57322,8634214218,55582,1740,458,142,0x495f947276749Ce646f68AC8c248420045cb7b5e,0x5b54877EE512b1B840F0E6e5926ed9baD0f02dd6
7348,15627881,21000,8634214218,21000,0,2,283,0xF38cdB531b4eE965018c7FaA656aF1eE6aA90dEe,0x76863bBFb2046598192FAdA39152A5A3748Edc97
7349,15627881,21000,8634214218,21000,0,2,6,0xD0471582c70d35B2A1928552F4D0f82fE4C6cFBa,0x001ba3A5428648f09bA6084cBdD8cD02598826ff
7350,15627881,21000,8634214218,21000,0,2,6,0xD0471582c70d35B2A1928552F4D0f82fE4C6cFBa,0x11a08c37FC6C89CC1F87081969c9174ab4c0124B
7351,15627881,46149,8634214218,45661,488,138,246,0xD88b94cbB4dA334191f6a3268FF2D0752Ac7B646,0x6E36Efec92219538444A964F136fB57cF5ae3b3E
7352,15627881,48558,8634214218,47926,632,138,1,0x7D1AfA7B718fb893dB30A3aBc0Cfc608AaCfeBB0,0x561E2F8bb1CfE6fbDe820D56C964dF00FAFcFaBE
7353,15627881,52846,8634214218,51894,952,202,385,0xC5a6afbE82EB9A119ac0d15392CA43B683AE8136,0x7fDCFDBeC152714BaC6E97c6f3A19844cA2D2D84
7354,15627881,97732,8634214218,96528,1204,394,238,0x710515Bf543fDb6834144F9269BBf0D1d32B1702,0x794DceEDd37e140553C161Fe230Ea80c76cdB622
7355,15627881,21000,8634214218,21000,0,2,6,0xD0471582c70d35B2A1928552F4D0f82fE4C6cFBa,0x1955A6555Dc6BDD5dc529E35e0e02B1A095DC2C1
7356,15627881,3422059,8634214218,3351143,70916,9264,0,,0xDa7AB0C15b74327EF904919bD075aC503C4fF905
7357,15627881,72866,8634214218,71006,1860,458,40,0xFbdDaDD80fe7bda00B901FbAf73803F2238Ae655,0xD0f47e51338ea28A5fe363e5e73115904c4cEd39
7358,15627881,21000,8634214218,21000,0,2,6,0xD0471582c70d35B2A1928552F4D0f82fE4C6cFBa,0x963B830B815998C1EE5Df6F67d3095E4C66Ad0d7
7359,15627881,195566,8634214218,188954,6612,1802,1176,0x00000000006c3852cbEf3e08E8dF289169EdE581,0xA0AEF95618167fBBCf880789a78C4Bb3AB48aa08
7360,15627881,44453,8634214218,42717,1736,522,1073,0xD152f549545093347A162Dce210e7293f1452150,0x565cea2Fd86FF22694ad53167E715FB81F4395AE
7361,15627881,289780,8634214218,287420,2360,522,348,0x283Af0B28c62C092C9727F1Ee09c02CA627EB7F5,0xd3AfEA7C924cBbFe8C3B514cefb6dbd505788Fa3
7362,15627881,51406,8634214218,50918,488,138,32,0xc42267799fdc17030a8a68A58228144b2e7eCe07,0xB2362053e77ceb3bFE79a0EF12959E847AB7415a
7363,15627881,21000,8634214218,21000,0,2,3609,0xaCCE4bcABFde92502B55de25e38986Bc40e58E56,0x9308c261Dc19178a8b81C07b80CaaDe0fF057f6e
7364,15627881,21000,8634214218,21000,0,2,1,0xD0471582c70d35B2A1928552F4D0f82fE4C6cFBa,0xd7073dd48F701Bd1f2F764441b5bBd5e1fe58aba
7365,15627881,21000,8634214218,21000,0,2,1,0xD0471582c70d35B2A1928552F4D0f82fE4C6cFBa,0x8902B83c1Dde5C036fCa16Eb632B970d29a16D10
7366,15627881,59305,8634214218,57941,1364,330,2,0x4976fb03C32e5B8cfe2b6cCB31c09Ba78EBaBa41,0x5B072e124297e7C5e39575174c609220b230CEd8
7367,15627881,97246,8634214218,82690,14556,4874,3115,0x00000000006c3852cbEf3e08E8dF289169EdE581,0x76951F6E84213f189FeE1524D382B312dFd85EbC
7368,15627881,21000,8634214218,21000,0,2,1,0xD0471582c70d35B2A1928552F4D0f82fE4C6cFBa,0x5AAC710703a01C4E17c41d2A7b219faf94E559d1
7369,15627881,21000,8634214218,21000,0,2,1,0xD0471582c70d35B2A1928552F4D0f82fE4C6cFBa,0xe21EF81Fbc67f99cA982505B7A9Fff25dD6A5D90
7370,15627881,21000,8634214218,21000,0,2,469,0x121bC3F63618F477ec51b5a6D588BF6de38897F1,0x8318777F8b8A1e81243Abb5e58B3483D2138F257
7371,15627881,21000,8634214218,21000,0,2,0,0xde966336241D42fBFAEC26548f6A037eed079FAB,0x9F32537B56E13AF8E3617807fF10b79227E11A2e
7372,15627881,21000,8634214218,21000,0,2,43,0xadAaEFEc963165AfB05718262EDAeB1B99764BcE,0x0a4DA7a0CBD58aFe60C3ca4243e627cEe602149f
7373,15627881,21000,8634214218,21000,0,2,6,0xD0471582c70d35B2A1928552F4D0f82fE4C6cFBa,0x537D37ebE583142b6D5Fec56Ed02C4225F657D8c
7374,15627881,200000,8634214218,199344,656,138,0,0x1F573D6Fb3F13d689FF844B4cE37794d79a7FF1C,0xCFE25B38215682Dc4D2d7C534Fb4976fc75434c7
7375,15627881,46267,8634214218,45691,576,74,25,0x283Af0B28c62C092C9727F1Ee09c02CA627EB7F5,0xE77e5Ed25e0cA94c88b9Cc72cF758E0ac5cd4BDf
7376,15627881,120605,8320000000,120541,64,10,2,0x65c2e54a4c75ff6da7b6B32369c1677250075fb2,0x0d02A7Aa7a6a6A5f590cf5C59598eFf8917b2059
7377,15627881,181458,8134214218,179906,1552,394,6370,0x1Fa8559e873f698292766790AeCf8080A66433F6,0xFa89ec40699Bbfd749c4eb6643dC2B22fF0e2aa6
7378,15627881,120000,8134214218,119392,608,138,96800,0xdAC17F958D2ee523a2206206994597C13D831ec7,0x4c9AF439b1A6761B8E549D8d226A468a6b2803A8
7379,15627881,181476,8134214218,179912,1564,394,539,0x1Fa8559e873f698292766790AeCf8080A66433F6,0xab18Dd4e8090dE887E50776d66A9924a648d5759
7380,15627881,181476,8134214218,179912,1564,394,110,0x1Fa8559e873f698292766790AeCf8080A66433F6,0x680f5AC6f7b8d064bc8a9c8CA5bCdA84AfCbA51A
7381,15627881,232020,8134214218,231768,252,74,174,0x39AA39c021dfbaE8faC545936693aC917d5E7563,0x94aEc6a2Fd64b63cd501960E920A4D5562d35d40
7382,15627881,181476,8134214218,179912,1564,394,242,0x1Fa8559e873f698292766790AeCf8080A66433F6,0xCdc12396c0f7811F807e73Ea5cf1A8da1fCF8c6F
7383,15627881,181476,8134214218,179912,1564,394,3484,0x1Fa8559e873f698292766790AeCf8080A66433F6,0xC458e1a4eC03C5039fBF38221C54Be4e63731E2A
7384,15627881,181476,8134214218,179912,1564,394,53,0x1Fa8559e873f698292766790AeCf8080A66433F6,0x758AdE17A8C57056d211c63963b703e86CD0E260
7385,15627881,175110,8134214218,173546,1564,394,373,0x1Fa8559e873f698292766790AeCf8080A66433F6,0x998B25538486e05F863D29061Cc95554DeAE3AEa
7386,15627881,181476,8134214218,179912,1564,394,24,0x1Fa8559e873f698292766790AeCf8080A66433F6,0xE4cC4534D807f84fb8ebfBeb0D44D64d5B9734c1
7387,15627881,58035,8134214218,56307,1728,458,89,0x4976fb03C32e5B8cfe2b6cCB31c09Ba78EBaBa41,0x02fFC99ED8867340e2755D6ABd7f9F8FDc95c93B
7388,15627881,21000,8134214218,21000,0,2,0,0x3ea983b2D60D84E2024aA5B72Aa8Bf507035c667,0xD6801b79Be7acEDb3B417A840d4748B92Fd7E055
7389,15627881,178398,8134214218,178194,204,74,2358,0x645E9324f4be25be581BB62163cfa86c40b01D07,0xc5009AFEd2D6DA219538aD165998F63B553185B1
7390,15627881,58131,8134214218,56307,1824,458,31,0x4976fb03C32e5B8cfe2b6cCB31c09Ba78EBaBa41,0x061F16fA27e2E76179F01fB5810526C9b08d21b2
7391,15627881,65000,8046963241,64392,608,138,646170,0xdAC17F958D2ee523a2206206994597C13D831ec7,0x29D5527CaA78f1946a409FA6aCaf14A0a4A0274b
7392,15627881,150756,7868844575,150692,64,10,3,0x65c2e54a4c75ff6da7b6B32369c1677250075fb2,0xb749476A29098A88b554C0f1fcE273a98609f9FA
7393,15627881,225863,7536523327,223791,2072,522,46,0xEfF92A263d31888d860bD50809A8D171709b7b1c,0xc18C24d43ee5cE1064941A563E096B7e882c0a7f
7394,15627881,60000,7489597799,59200,800,138,0,0x352E504813B9E0b30F9cA70eFc27A52D298F6697,0x46464eb702Dd3096f5D7d7F7d968855a2Df72a16
7395,15627881,60000,7489597799,59200,800,138,2,0x352E504813B9E0b30F9cA70eFc27A52D298F6697,0xDFBb5C494D64D1978e6e85c9A9F7De3a402A0E8D
7396,15627881,1000000,7386650570,997368,2632,586,109720,0x2796317b0fF8538F253012862c06787Adfb8cEb6,0x230A1AC45690B9Ae1176389434610B9526d2f21b
7397,15627881,46507,7376784444,45563,944,138,2,0xB4a81261b16b92af0B9F7C4a83f1E885132D81e4,0xE7824aB41a68b79207Ff5ddCd11Aa7908A3aF963
7398,15627881,143122,7354446828,141434,1688,330,20272,0x765277EebeCA2e31912C9946eAe1021199B39C61,0x647dC1366Da28f8A64EB831fC8E9F05C90d1EA5a
7399,15627881,30000,7134214218,30000,0,2,3673,0x5bE9B269a83018e3192D6139DC6431DE5656Ea8a,0xF2f5C73fa04406b1995e397B55c24aB1f3eA726C
7400,15627882,21000,11303823331,21000,0,2,196176,0xC8494E41032680dD05F95Cc8CF806041F673E563,0xd108FD0E8c8E71552a167E7a44FF1d345D233BA6
7401,15627882,21000,11303823331,21000,0,2,195478,0x2D2dDb169Cbc8eeB867A642cc45fF40Ec110d659,0xB287eaC48aB21c5FB1d3723830d60b4c797555B0
7402,15627882,46327,10382823331,45659,668,138,56,0x7105AA393b9cF9b2497b460837313EA3dBA67Da0,0x25ceE3a836286d1D9188e54bc563E5C74BE984A9
7403,15627882,21000,10000000000,21000,0,2,4,0x7Fe9fE42f684d13e80EE8DDCe5Ac9544dd1eAf2C,0xC3b367eae57E0754865ca8A803078834c1936754
7404,15627882,21000,9882823331,21000,0,2,65,0x4fB46Af158d2d0d99A952F42Ce6a161E3Fdc3CC4,0x59C8A548c0CbA1D89b9e13D19c31Ec45967B465d
7405,15627882,140088,9382823331,138524,1564,394,24,0x1Fa8559e873f698292766790AeCf8080A66433F6,0x2625c9B5FbeF260FDFb88460046c3bAe0C179B7d
7406,15627882,23300,9382823331,23300,0,2,11,0xA9D1e08C7793af67e9d92fe308d5697FB81d3E43,0x2bECa0942AD36fC10a767a91411B2C35249BBb54
7407,15627882,23300,9382823331,23300,0,2,446241,0xA9D1e08C7793af67e9d92fe308d5697FB81d3E43,0xA090e606E30bD747d4E6245a1517EbE430F0057e
7408,15627882,23300,9382823331,23300,0,2,3,0xA9D1e08C7793af67e9d92fe308d5697FB81d3E43,0x954da37b9322349898efa17d175618Ffc5AF9B8C
7409,15627882,23300,9382823331,23300,0,2,4,0xA9D1e08C7793af67e9d92fe308d5697FB81d3E43,0x3588d9d60C1AD05DD05aB94A78BAC0393ddF8c90
7410,15627882,23300,9382823331,23300,0,2,1,0xA9D1e08C7793af67e9d92fe308d5697FB81d3E43,0x2328A4EF885B92f0649844Bacc320de7C25943d6
7411,15627882,23300,9382823331,23300,0,2,22,0xA9D1e08C7793af67e9d92fe308d5697FB81d3E43,0x22D1D975E06F4cfA837253954151D3e2d7031f45
7412,15627882,21000,9382823331,21000,0,2,0,0xddfAbCdc4D8FfC6d5beaf154f18B778f892A0740,0xa7b68442E86cF3d7069fc9B3BA9bb9D8163bd1f0
7413,15627882,21000,9382823331,21000,0,2,5,0xddfAbCdc4D8FfC6d5beaf154f18B778f892A0740,0x835cfb6200399c8Ac5339787f59099EeE4eA2f29
7414,15627882,21000,9382823331,21000,0,2,5724,0xddfAbCdc4D8FfC6d5beaf154f18B778f892A0740,0x4675C7e5BaAFBFFbca748158bEcBA61ef3b0a263
7415,15627882,21000,9382823331,21000,0,2,0,0xddfAbCdc4D8FfC6d5beaf154f18B778f892A0740,0x8A38c3f48a8f9779D44591b492b3FF0A5B4Cf58E
7416,15627882,21000,9382823331,21000,0,2,0,0xddfAbCdc4D8FfC6d5beaf154f18B778f892A0740,0x7BFA21068ba50f2D25c1bf44c35A59A603D59029
7417,15627882,21000,9382823331,21000,0,2,14,0xddfAbCdc4D8FfC6d5beaf154f18B778f892A0740,0x4B758c64B83DaD8Fea640428DF0aFddb7C97Cd3F
7418,15627882,500000,9382823331,488560,11440,2506,17458,0xd0BB178dEdC71470BA68380CBd99c4A963d01507,0x9850E11D2c33B43AB80d478CCC69042b46ab3857
7419,15627882,23300,9382823331,23300,0,2,33,0xA9D1e08C7793af67e9d92fe308d5697FB81d3E43,0xc0341f9617398eabd2E185121383546d4e4a5ee9
7420,15627882,23300,9382823331,23300,0,2,6,0xA9D1e08C7793af67e9d92fe308d5697FB81d3E43,0x57E349CbEdcfBA90BE4928130BA12fBb2F388083
7421,15627882,21000,9382823331,21000,0,2,4,0xddfAbCdc4D8FfC6d5beaf154f18B778f892A0740,0xD9418F1e5e78eb9991F09F44578aE694D1Ebbff4
7422,15627882,23300,9382823331,23300,0,2,33,0xA9D1e08C7793af67e9d92fe308d5697FB81d3E43,0xBeddB880f667514a65Ee45C2832d00BEc0271EC5
7423,15627882,21000,9382823331,21000,0,2,440,0xddfAbCdc4D8FfC6d5beaf154f18B778f892A0740,0x96Db3ab394c0af77c857ec8b4012a73aBb38f7Bc
7424,15627882,21000,9382823331,21000,0,2,0,0xddfAbCdc4D8FfC6d5beaf154f18B778f892A0740,0x47E386410EA0e969229878F91EF76e11CAFfC77E
7425,15627882,140088,9382823331,138524,1564,394,25,0x1Fa8559e873f698292766790AeCf8080A66433F6,0x2d1047911158fC4477c94F839829D39C86DA6Ca4
7426,15627882,39603,9382823331,39351,252,74,917,0xC02aaA39b223FE8D0A0e5C4F27eAD9083C756Cc2,0x6D393876B5769774C4F12FF13Fac693d4caBBf67
7427,15627882,140073,9382823331,138521,1552,394,24,0x1Fa8559e873f698292766790AeCf8080A66433F6,0xa0574de0e9878a25489CcA3B0B07A4bC4f00dDc3
7428,15627882,140088,9382823331,138524,1564,394,15,0x1Fa8559e873f698292766790AeCf8080A66433F6,0x826441d501389c222Fc9F4AffF0AE6481026b571
7429,15627882,140088,9382823331,138524,1564,394,15,0x1Fa8559e873f698292766790AeCf8080A66433F6,0x3b08b26F65400dEaBa320703a77d0Ae29bB0ebd6
7430,15627882,140088,9382823331,138524,1564,394,17,0x1Fa8559e873f698292766790AeCf8080A66433F6,0xE98A154FbD924CDE0B093911CFB6d51B69b79c24
7431,15627882,140088,9382823331,138524,1564,394,15,0x1Fa8559e873f698292766790AeCf8080A66433F6,0x2B7Bfbbe13b17415D1d4208d211c439a4D3Da3c9
7432,15627882,1155978,9082823331,1141534,14444,4554,71,0x3b3ae790Df4F312e745D270119c6052904FB6790,0x29BE0777A3Ab996D9086c33EbbC0153E2DcC5Dcb
7433,15627882,180000,9000000000,179368,632,138,444363,0xA8b919680258d369114910511cc87595aec0be6D,0x48c04ed5691981C42154C6167398f95e8f38a7fF
7434,15627882,21000,9000000000,21000,0,2,168678,0xD43780909ECf1Cc34CE0ce6cC74bEF7817751985,0x4E5B2e1dc63F6b91cb6Cd759936495434C7e972F
7435,15627882,64200,8980250875,63488,712,202,3479110,0x5f65f7b609678448494De4C87521CdF6cEf1e932,0xd24400ae8BfEBb18cA49Be86258a3C749cf46853
7436,15627882,21000,8882823331,21000,0,2,1,0xD0471582c70d35B2A1928552F4D0f82fE4C6cFBa,0xc8625c5fd6651fAa5986BA89D97fBd2F2B453b88
7437,15627882,21000,8882823331,21000,0,2,1,0xD0471582c70d35B2A1928552F4D0f82fE4C6cFBa,0xeD36b9b455F95FFe0117c48F4F05Bb2006b10B3c
7438,15627882,21000,8882823331,21000,0,2,1,0xD0471582c70d35B2A1928552F4D0f82fE4C6cFBa,0x71Cd128551c8B8b11c843e91Ce2Cb94E0C0fA31C
7439,15627882,21000,8882823331,21000,0,2,1,0xD0471582c70d35B2A1928552F4D0f82fE4C6cFBa,0x0d1dCA0feC37CfB0a5C73763ecc118d0A80Da264
7440,15627882,21000,8882823331,21000,0,2,1,0xD0471582c70d35B2A1928552F4D0f82fE4C6cFBa,0x1B7eFCF4f771beb88fb7F5C186867D7573bE2aC4
7441,15627882,45890,8882823331,45402,488,138,1,0xc36cF0cFcb5d905B8B513860dB0CFE63F6Cf9F5c,0x527F0f06972a5dA75Cdf05E0bd4c7fF21444aAb4
7442,15627882,21000,8882823331,21000,0,2,1,0xD0471582c70d35B2A1928552F4D0f82fE4C6cFBa,0xEF928ccF78B76A98686eDA092aBfC321e05611E8
7443,15627882,21000,8882823331,21000,0,2,1,0xD0471582c70d35B2A1928552F4D0f82fE4C6cFBa,0x6763796357c2D9eF88579A021868222F54E99067
7444,15627882,21000,8882823331,21000,0,2,1,0xD0471582c70d35B2A1928552F4D0f82fE4C6cFBa,0xBD1d3e0842D1e32D1d751adD0906517530264677
7445,15627882,21000,8882823331,21000,0,2,1,0xD0471582c70d35B2A1928552F4D0f82fE4C6cFBa,0x7Ebe3a14d75292f7464B59A66A679A8f2c63D884
7446,15627882,21000,8882823331,21000,0,2,7,0x5E97Af995C9384E5328d3B1F779552b5A64A109d,0x61fFA59EE11D292d11bFFa14D10faCC12633905D
7447,15627882,248900,8882823331,246140,2760,842,5548,0x68b3465833fb72A70ecDF485E0e4C7bD8665Fc45,0x26663DF4bdB9983466FC83cDF527c973F92428e7
7448,15627882,21000,8882823331,21000,0,2,113814,0xDd5D36a076463Ed42B2E1a6a66DADFC48Bf845Fc,0xd5FBDa4C79F38920159fE5f22DF9655FDe292d47
7449,15627882,21000,8882823331,21000,0,2,1,0xD0471582c70d35B2A1928552F4D0f82fE4C6cFBa,0x96bB185aa3B115d4FD016A6640916Ec651Cc8F05
7450,15627882,21000,8882823331,21000,0,2,1,0xD0471582c70d35B2A1928552F4D0f82fE4C6cFBa,0x5d4d1b76865a2ab7EF3aF2590B2d814571D46476
7451,15627882,21000,8882823331,21000,0,2,1,0xD0471582c70d35B2A1928552F4D0f82fE4C6cFBa,0xEf548aC3f4f2b2418E5BbB6A6255D7581420C254
7452,15627882,29929,8882823331,29865,64,10,784,0x00000000006c3852cbEf3e08E8dF289169EdE581,0x6040a8F2C2BB3789BAfb6232114ff941B0e1bE16
7453,15627882,21000,8882823331,21000,0,2,1,0xD0471582c70d35B2A1928552F4D0f82fE4C6cFBa,0x5Cea5Ce361422b003c1BfF95e3F1627d55B8E462
7454,15627882,117739,8882823331,116211,1528,394,80,0x3ee18B2214AFF97000D974cf647E7C347E8fa585,0x2eC485B94616cd724a84e1212C6f0822FA1Cea25
7455,15627882,21000,8882823331,21000,0,2,1,0xD0471582c70d35B2A1928552F4D0f82fE4C6cFBa,0x1d0E79a272Ab88bE7D9Ac80543899BB363A36414
7456,15627882,21000,8882823331,21000,0,2,1,0xD0471582c70d35B2A1928552F4D0f82fE4C6cFBa,0x375d7544472179282C8531acD7ec671AF3D9F84d
7457,15627882,21000,8882823331,21000,0,2,1,0xD0471582c70d35B2A1928552F4D0f82fE4C6cFBa,0x8118f30AD971AFB328DF6bc07ad5A185C1bDbF1D
7458,15627882,175110,8382823331,173546,1564,394,801,0x1Fa8559e873f698292766790AeCf8080A66433F6,0x5caCCeC0cda0dD50c56d026F9F37430595017BA3
7459,15627882,150756,8117453688,150692,64,10,2,0x65c2e54a4c75ff6da7b6B32369c1677250075fb2,0xbc5aae5ACFf16Cecc7aF4682B06500838BBa76a4
7460,15627882,228420,8000000000,208632,19788,4682,1133,0x00000000006c3852cbEf3e08E8dF289169EdE581,0xecDA2c559aDE78ff0A3B1e5cF0ECd0d23143827b
7461,15627882,66121,7984752916,65501,620,138,463303,0xdAC17F958D2ee523a2206206994597C13D831ec7,0xB8001C3eC9AA1985f6c747E25c28324E4A361ec1
7462,15627882,94813,7625393557,94205,608,138,26,0xdAC17F958D2ee523a2206206994597C13D831ec7,0x706FF7657E27d8513F4508AB3ad96C6f293eBf49
7463,15627882,100000,7618745156,99392,608,138,705884,0xdAC17F958D2ee523a2206206994597C13D831ec7,0x6dfc34609a05bC22319fA4Cce1d1E2929548c0D7
7464,15627882,57262,7489597799,56286,976,202,890837,0xA0b86991c6218b36c1d19D4a2e9Eb0cE3606eB48,0x340d693ED55d7bA167D184ea76Ea2Fd092a35BDc
7465,15627883,120000,68000000000,119392,608,138,318096,0xdAC17F958D2ee523a2206206994597C13D831ec7,0x618fFD1cDAbeE36CE5992a857Cc7463f21272bD7
7466,15627883,233684,6685714081,231500,2184,650,93263,0xA69babEF1cA67A37Ffaf7a485DfFF3382056e78C,0xFF82BF5238637B7E5E345888BaB9cd99F5Ebe331
7467,15627883,21000,53000000000,21000,0,2,1,0xea2c14dDd140ee58637D59cC820E62c697C525Eb,0x4477C9aAEf2Cd9f1eC651132b83eD443405De8fa
7468,15627883,230312,6685714081,229728,584,78,5188,0x00000000A991C429eE2Ec6df19d40fe0c80088B8,0x77ad3a15b78101883AF36aD4A875e17c86AC65d1
7469,15627883,319806,9900000000,317810,1996,466,1970,0x1111111254fb6c44bAC0beD2854e76F90643097d,0x800874e6f4f8B6028f607292Aa7B3D8a9EB83395
7470,15627883,202740,124735686715,201836,904,118,5189,0x00000000A991C429eE2Ec6df19d40fe0c80088B8,0x77ad3a15b78101883AF36aD4A875e17c86AC65d1
7471,15627883,176629,25204847444,175341,1288,190,2263,0x9507c04B10486547584C37bCBd931B2a4FeE9A41,0xd2c5b711E50c592A46f96C6e76E714178FD9AD89
7472,15627883,250000,21000000000,250000,0,2,9097,0x039dC9849dcf14058D81Bf3a1cc0e6A3D15160F8,0x083D7668e578F3938f84D9a2B75A5292d9873Ca8
7473,15627883,5049304,17000000000,5042216,7088,1098,292,0x0a39DA505DfB5E0BBc6bd84428281A8ba1bC7753,0x495E889d1A6cEB447a57dcc1C68410299392380c
7474,15627883,94831,15257429774,94235,596,138,2188242,0xdAC17F958D2ee523a2206206994597C13D831ec7,0x75e89d5979E4f6Fba9F97c104c2F0AFB3F1dcB88
7475,15627883,77356,15257429774,76772,584,138,2188243,0x467719aD09025FcC6cF6F8311755809d45a5E5f3,0x75e89d5979E4f6Fba9F97c104c2F0AFB3F1dcB88
7476,15627883,21000,14000000000,21000,0,2,2,0x500A746c9a44f68Fe6AA86a92e7B3AF4F322Ae66,0x3563cFBA9356839841918dEe1e33365A9f29d7C2
7477,15627883,21000,13370136043,21000,0,2,59669,0x2330CcD19f72B5435Ae25640C9834DdebD7c725B,0x354e9Fa5c6Ee7e6092158a8c1B203CcAc932D66d
7478,15627883,181476,13000000000,179912,1564,394,162,0x1Fa8559e873f698292766790AeCf8080A66433F6,0x4675E04F4686348E735F1EBEee376b9F8212C2F0
7479,15627883,268839,12685714081,267015,1824,458,242,0x7a250d5630B4cF539739dF2C5dAcb4c659F2488D,0x4Fd47Ead21BA0be8F1efe7217be88ddD82ec40e2
7480,15627883,35062,12406089892,34502,560,138,22,0xD27dcbcC8778a8AB33AAc529Df36a634567Be325,0x9421E7934E35e841db6c052BDF298544108440BE
7481,15627883,35062,12406089892,34502,560,138,13,0xD27dcbcC8778a8AB33AAc529Df36a634567Be325,0xFcfEfe991BdEE2F937F60Fc856E51CDCb277C91B
7482,15627883,21000,12000000000,21000,0,2,661,0x33dCa2a698E4188ED43B054F1F33a75f6618Abc4,0xB21e0Fed6E13c1bb2D8d6a83406BF548eD23f200
7483,15627883,350000,10995947049,349392,608,138,6925060,0xdAC17F958D2ee523a2206206994597C13D831ec7,0x46340b20830761efd32832A74d7169B29FEB9758
7484,15627883,80000,10500000000,80000,0,2,6593,0x732CB71F3cCD5840189142C200cF329481518c9D,0x3DE0cFe6985A95Cc9CB69c056b9d210418a1E1F4
7485,15627883,63000,10414643336,63000,0,2,2710055,0x459D781A74B53BD7a6744CA793D7Bd7C86ae2601,0xC098B2a3Aa256D2140208C3de6543aAEf5cd3A94
7486,15627883,63000,10414643336,63000,0,2,2710056,0x289ce746DDD824D66e18401a446446A66329f295,0xC098B2a3Aa256D2140208C3de6543aAEf5cd3A94
7487,15627883,21000,10000000000,21000,0,2,1,0x7Fe9fE42f684d13e80EE8DDCe5Ac9544dd1eAf2C,0x4272Dd8C721133596E1Fe904af7bce6f10E8a84C
7488,15627883,21000,9880561948,21000,0,2,7,0xCBD6832Ebc203e49E2B771897067fce3c58575ac,0xffB1D8D7b5Cc692C194037Dc747DE2C8F9a0D003
7489,15627883,21000,9704411168,21000,0,2,5,0x7b719f9518F4DDCd341D28838a06A78395A7d5fC,0x26cBB09c8b72eDAEE40ab83CeaCBB97423d29720
7490,15627883,453437,9685714081,451401,2036,522,208,0x7a250d5630B4cF539739dF2C5dAcb4c659F2488D,0x5D7876BDF88c0dbF241C5d62DB344C1332288513
7491,15627883,60760,9432038107,59816,944,138,9,0xA0b86991c6218b36c1d19D4a2e9Eb0cE3606eB48,0x92f28291EB9cd5261fDa739a3B95fAA95090fb17
7492,15627883,342770,9432038107,311038,31732,5578,666,0xA0c68C638235ee32657e8f720a23ceC1bFc77C77,0x7F44Fe06175fe484E2eCC42E5CfBEAA37AF9AC43
7493,15627883,236194,9310714081,229794,6400,1738,779,0x00000000006c3852cbEf3e08E8dF289169EdE581,0x5Fc7FCB1f482CE9E0BE586b0Da2cA6248ed37c87
7494,15627883,305869,9185714081,298893,6976,970,1369,0x9b3B6974531d8AA15A87908FFd821A64863Ede5B,0x109440CBe5b508A7063ca126c88b0F81D3829575
7495,15627883,21000,9185714081,21000,0,2,56,0x17d035769a5Cd06B2d725A33d9BB8d1b0bb62ed9,0x296F7Df48c911998e9c6a834cb899969a75907cD
7496,15627883,153837,9185714081,152809,1028,330,206,0x6D7c44773C52D396F43c2D511B81aa168E9a7a42,0xE36067a4c51ff6Cb7Fb6F97D1931bb27a468960B
7497,15627883,70120,9185714081,69548,572,138,209,0x0C6822ca73dE6871f27ACD9ca05A05b99294B805,0x70D925A6CC9c6184FE15D4c3900DFa6B750c337d
7498,15627883,120182,9185714081,119978,204,74,3951,0x4556561740B7B5F858967A6a4E54e506609704Bd,0x35C7f81E953c61ab42d0a052F0fadeA82fb0f362
7499,15627883,146353,9000000000,144821,1532,330,51,0x33EeCbf908478C10614626A9D304bfe18B78DD73,0xD990DDC4CC295C3Ba5822c6EF73D618A66D7EA43
7500,15627883,50000,8686714081,50000,0,2,57202,0x09c9f73f4CbEF8bB486ba31338D2C942B1a0f8db,0x4207837D4Cd914467EB76bf88c4d6e7Ba11ccDf9
7501,15627883,140088,8685714081,138524,1564,394,15,0x1Fa8559e873f698292766790AeCf8080A66433F6,0x05E0C5DD897aa65fA19D8F24152B56c3b1501603
7502,15627883,140088,8685714081,138524,1564,394,15,0x1Fa8559e873f698292766790AeCf8080A66433F6,0xC245ec71a3beD79fE0a7138B3feD43b9A96A5672
7503,15627883,140088,8685714081,138524,1564,394,15,0x1Fa8559e873f698292766790AeCf8080A66433F6,0xf4be71a310aa0feeF95fa31D49107e80199045E0
7504,15627883,140073,8685714081,138521,1552,394,16,0x1Fa8559e873f698292766790AeCf8080A66433F6,0x959B30babc8300A574C72D70d8863a9F36967619
7505,15627883,500000,8685714081,499380,620,138,1262742,0xdAC17F958D2ee523a2206206994597C13D831ec7,0x89e51fA8CA5D66cd220bAed62ED01e8951aa7c40
7506,15627883,293953,8685714081,291121,2832,842,47,0x68b3465833fb72A70ecDF485E0e4C7bD8665Fc45,0x9Eb3dff53b69Cb0efc912731ab3a7842D4776350
7507,15627883,55953,8685714081,55009,944,138,405,0xb9f79C35C37695ec45851Cd6E29da8C1d0396c11,0x9b122ab8CBE7c7E81e8C24Ab78a20b8c86A7455F
7508,15627883,207128,8685714081,207128,0,2,3492284,0xcCa628E56FE945b78A7f4A3f44CD3b8c8de113ec,0x56Eddb7aa87536c09CCc2793473599fD21A8b17F
7509,15627883,207128,8685714081,207128,0,2,4468958,0x9A07Cc8ee90F397456c0fC676058B9d82599C108,0x21a31Ee1afC51d94C2eFcCAa2092aD1028285549
7510,15627883,207128,8685714081,206532,596,138,4232342,0xdAC17F958D2ee523a2206206994597C13D831ec7,0xDFd5293D8e347dFe59E90eFd55b2956a1343963d
7511,15627883,181476,8685714081,179912,1564,394,187,0x1Fa8559e873f698292766790AeCf8080A66433F6,0xc54924c392F489Dc7D4e3564286ff32815d07a0d
7512,15627883,207128,8685714081,206520,608,138,4232343,0xA0b86991c6218b36c1d19D4a2e9Eb0cE3606eB48,0xDFd5293D8e347dFe59E90eFd55b2956a1343963d
7513,15627883,207128,8685714081,206520,608,138,3492285,0xdAC17F958D2ee523a2206206994597C13D831ec7,0x56Eddb7aa87536c09CCc2793473599fD21A8b17F
7514,15627883,42000,8685714081,42000,0,2,329543,0xD28675440eC5d232A29018f6760ff92246076237,0x9430801EBAf509Ad49202aaBC5F5Bc6fd8A3dAf8
7515,15627883,207128,8685714081,206472,656,138,4232344,0x4a220E6096B25EADb88358cb44068A3248254675,0xDFd5293D8e347dFe59E90eFd55b2956a1343963d
7516,15627883,70000,8685714081,69392,608,138,536,0xdAC17F958D2ee523a2206206994597C13D831ec7,0xf5491f793D47A6Ea22f5e0B9AD3990CF66c4b40B
7517,15627883,144503,8685714081,137911,6592,1810,6,0x00000000006c3852cbEf3e08E8dF289169EdE581,0x5c37D7eDdB52c1572e6511739529865e14D16300
7518,15627883,100000,8685714081,99392,608,138,88940,0xdAC17F958D2ee523a2206206994597C13D831ec7,0x3018018c44338B9728d02be12d632C6691E020d1
7519,15627883,181422,8685714081,179894,1528,394,423,0x1Fa8559e873f698292766790AeCf8080A66433F6,0x66FBfCBBB2a2b1077D91063d9FF8af1ca50400De
7520,15627883,319052,8685714081,314188,4864,1546,644,0x68b3465833fb72A70ecDF485E0e4C7bD8665Fc45,0xdc5821f21AD12F38FF2259B3BC4C9f9bD06E4BB1
7521,15627883,181476,8685714081,179912,1564,394,320,0x1Fa8559e873f698292766790AeCf8080A66433F6,0x481c6116506B890308C239Cc6E7053Fe72AD0Cdd
7522,15627883,70000,8685714081,69392,608,138,91,0xdAC17F958D2ee523a2206206994597C13D831ec7,0x3A966b4222d7338211caa4b15350cd0934f99c51
7523,15627883,2000000,8685714081,1994332,5668,1354,171050,0xA9D1e08C7793af67e9d92fe308d5697FB81d3E43,0x7830c87C02e56AFf27FA8Ab1241711331FA86F43
7524,15627883,21000,8685714081,21000,0,2,8265757,0x2c0Ad04bb96B062272FFF2989527D571C3c24d95,0xb5d85CBf7cB3EE0D56b3bB207D5Fc4B82f43F511
7525,15627883,21000,8685714081,21000,0,2,1783209,0x56850538373f6E38B6699a2eA9C16DdF9dE2B1D2,0x503828976D22510aad0201ac7EC88293211D23Da
7526,15627883,323308,8685714081,313904,9404,2700,5,0x881D40237659C251811CEC9c364ef91dC08D300C,0xc91aF7f1452c115C785eA6Abc907Be4cF99F57a2
7527,15627883,2000000,8685714081,1991032,8968,1930,171051,0xA9D1e08C7793af67e9d92fe308d5697FB81d3E43,0x7830c87C02e56AFf27FA8Ab1241711331FA86F43
7528,15627883,42000,8685714081,42000,0,2,23238,0x40E255648795679a323D1A5b221327590Ad96988,0x50BE13b54f3EeBBe415d20250598D81280e56772
7529,15627883,568174,8685714081,564486,3688,1162,238,0x68b3465833fb72A70ecDF485E0e4C7bD8665Fc45,0x5F7AC769e181cA1472b28b8Ac1100194e7D4E0b1
7530,15627883,152592,8685714081,147088,5504,1674,46020,0x5959cF520d115f7979F60e3aF235C69Ff8d25DaD,0x421F3dac4Fe3BD06FA4D51c53647511AeB8cCf69
7531,15627883,181476,8685714081,179912,1564,394,133,0x1Fa8559e873f698292766790AeCf8080A66433F6,0x291259567C069555FF04e7D789cACE6a397caf65
7532,15627883,215071,8685714081,213247,1824,458,588,0x7a250d5630B4cF539739dF2C5dAcb4c659F2488D,0x15A15Fe79A268668eEc2573F81E67Bd648B3c1B9
7533,15627883,350220,8685714081,348656,1564,394,10,0x1Fa8559e873f698292766790AeCf8080A66433F6,0x1d2BE2483cf12839c1d4731302FA3bbd61214C3B
7534,15627883,350220,8685714081,348656,1564,394,14,0x1Fa8559e873f698292766790AeCf8080A66433F6,0x56718ED1AdB1BAf9D16f7a694BF20C55908EEEE2
7535,15627883,350184,8685714081,348632,1552,394,14,0x1Fa8559e873f698292766790AeCf8080A66433F6,0x72aB80c13704fcC0B59Dc6EE02320F09004a9a7E
7536,15627883,350220,8685714081,348656,1564,394,12,0x1Fa8559e873f698292766790AeCf8080A66433F6,0xE0B86D2c02CE9D2D2471E434Ea094a235b749228
7537,15627883,350184,8685714081,348632,1552,394,14,0x1Fa8559e873f698292766790AeCf8080A66433F6,0xaf847500C793a8c205CA5927c8248640B4Ca6342
7538,15627883,350220,8685714081,348656,1564,394,12,0x1Fa8559e873f698292766790AeCf8080A66433F6,0x3F3A80494b23Ca2a1fb481bd2D045a0FCCEffAb4
7539,15627883,350220,8685714081,348656,1564,394,12,0x1Fa8559e873f698292766790AeCf8080A66433F6,0x15a070cC20F108Eb3844bD3e69b2e08F072a3729
7540,15627883,350220,8685714081,348656,1564,394,14,0x1Fa8559e873f698292766790AeCf8080A66433F6,0x90C756DAace8E9A83685A3b743E0a191A41b28A2
7541,15627883,350220,8685714081,348656,1564,394,12,0x1Fa8559e873f698292766790AeCf8080A66433F6,0xF8a0cd3f07a979D27CDe8e532540238553F31943
7542,15627883,350220,8685714081,348656,1564,394,12,0x1Fa8559e873f698292766790AeCf8080A66433F6,0x3e644480087a460a5747EBb2789F243A62cbb917
7543,15627883,350220,8685714081,348656,1564,394,9,0x1Fa8559e873f698292766790AeCf8080A66433F6,0x84751FA4566048ae1AA46f9e7284af506e0f24Ab
7544,15627883,350220,8685714081,348656,1564,394,14,0x1Fa8559e873f698292766790AeCf8080A66433F6,0x82dDBcc9840494E31f735549523Ff0a85CabaF26
7545,15627883,350220,8685714081,348656,1564,394,11,0x1Fa8559e873f698292766790AeCf8080A66433F6,0x909FE9D1e5d91Aa482C1faFe9bA2983C0B1dF50c
7546,15627883,350220,8685714081,348656,1564,394,14,0x1Fa8559e873f698292766790AeCf8080A66433F6,0x1Ca974922Fe74E6B8369917099444D0D9401e149
7547,15627883,350220,8685714081,348656,1564,394,10,0x1Fa8559e873f698292766790AeCf8080A66433F6,0x6D4F261302f110f31BbcB15b345Ce19504117e57
7548,15627883,350184,8685714081,348632,1552,394,9,0x1Fa8559e873f698292766790AeCf8080A66433F6,0xe06F955E0d4ea95f3d02E03045Cae04C86C84aE0
7549,15627883,350184,8685714081,348632,1552,394,12,0x1Fa8559e873f698292766790AeCf8080A66433F6,0xd5215890A22fB8Cd0Df94F15D8cA62A4d8a070AF
7550,15627883,350220,8685714081,348656,1564,394,14,0x1Fa8559e873f698292766790AeCf8080A66433F6,0x3a4bEF748F80268eeff5Cd3849d63322f54789ab
7551,15627883,350220,8685714081,348656,1564,394,14,0x1Fa8559e873f698292766790AeCf8080A66433F6,0xaca30D1c16cf2A373a0f14c45aeD4D8D94623eDb
7552,15627883,350220,8685714081,348656,1564,394,11,0x1Fa8559e873f698292766790AeCf8080A66433F6,0x9490B180C14873D208CD718A8b73b14736718Dd8
7553,15627883,350220,8685714081,348656,1564,394,11,0x1Fa8559e873f698292766790AeCf8080A66433F6,0xb88bF4Cf936D0B30F69C5d366f70d49c717FE89f
7554,15627883,350184,8685714081,348632,1552,394,10,0x1Fa8559e873f698292766790AeCf8080A66433F6,0x195bc46811d1F953B4dc335D00FD45D6533E3258
7555,15627883,350220,8685714081,348656,1564,394,10,0x1Fa8559e873f698292766790AeCf8080A66433F6,0xfE8a6d8Fca8769EE67d98a01E61a688AD2efB5F6
7556,15627883,350220,8685714081,348656,1564,394,11,0x1Fa8559e873f698292766790AeCf8080A66433F6,0x17b2eA8e86F3BA5B67b3EA7745435850cdeB9A3E
7557,15627883,350220,8685714081,348656,1564,394,12,0x1Fa8559e873f698292766790AeCf8080A66433F6,0xEa999C987153a49aF1DB46b6217720D80b804398
7558,15627883,350220,8685714081,348656,1564,394,10,0x1Fa8559e873f698292766790AeCf8080A66433F6,0x876d49C31B8afba8c6288a6D8856D1229DF36f0F
7559,15627883,350220,8685714081,348656,1564,394,10,0x1Fa8559e873f698292766790AeCf8080A66433F6,0xb8D086381Da23CF6Ff8B64E05998c1065581D971
7560,15627883,350220,8685714081,348656,1564,394,10,0x1Fa8559e873f698292766790AeCf8080A66433F6,0x95e9465E509aB6928d59b68149aE9F4d2e7bf021
7561,15627883,350220,8685714081,348656,1564,394,9,0x1Fa8559e873f698292766790AeCf8080A66433F6,0x2048D8194d698a67b421eAc3A997427836be1068
7562,15627883,350220,8685714081,348656,1564,394,10,0x1Fa8559e873f698292766790AeCf8080A66433F6,0xA59469e61B22d7a9BF8E8C9bbe177fE1293eB6F4
7563,15627883,350220,8685714081,348656,1564,394,12,0x1Fa8559e873f698292766790AeCf8080A66433F6,0x4dC021B415BB88Dc1d7FBdfC5e53a752025fD660
7564,15627883,350220,8685714081,348656,1564,394,10,0x1Fa8559e873f698292766790AeCf8080A66433F6,0xF37C0Fd2bD73ae7B3BDD126F6Fb884DFD3071523
7565,15627883,350220,8685714081,348656,1564,394,10,0x1Fa8559e873f698292766790AeCf8080A66433F6,0x8cf8689280BA91aa845b5814B27Af8B584A91a59
7566,15627883,350184,8685714081,348632,1552,394,9,0x1Fa8559e873f698292766790AeCf8080A66433F6,0x5af379Ec69657E2014d50c8d0F5CbA00e261D9CE
7567,15627883,350148,8685714081,348608,1540,394,11,0x1Fa8559e873f698292766790AeCf8080A66433F6,0x8BCB05963907938e58CCa25BbB9f72e3D534c89B
7568,15627883,85000,8685714081,84512,488,138,59,0xD27dcbcC8778a8AB33AAc529Df36a634567Be325,0x0351c552fD6633cF0828486bA7B75980084Efcf9
7569,15627883,85000,8685714081,84512,488,138,84,0xD27dcbcC8778a8AB33AAc529Df36a634567Be325,0x9c4977fA2399CAaF1D16140438D4156767595350
7570,15627883,350220,8685714081,348656,1564,394,10,0x1Fa8559e873f698292766790AeCf8080A66433F6,0xe7c441ec4cff20A1E33c3FdfCeF783152A5A1dbF
7571,15627883,350184,8685714081,348632,1552,394,13,0x1Fa8559e873f698292766790AeCf8080A66433F6,0x28401b280C94bbFA1029fF0bFeDAcD177326f1Db
7572,15627883,350184,8685714081,348632,1552,394,14,0x1Fa8559e873f698292766790AeCf8080A66433F6,0xf668A1A94FB55B2d2668ac48ddcdfEb093548d73
7573,15627883,350220,8685714081,348656,1564,394,10,0x1Fa8559e873f698292766790AeCf8080A66433F6,0x823e17dE477245b75f0EF6aAEEfD2e7A537E8eCD
7574,15627883,350220,8685714081,348656,1564,394,9,0x1Fa8559e873f698292766790AeCf8080A66433F6,0xD61a61754FD11BA2091D912803A0D4F0eAd1d1D2
7575,15627883,332223,8555714081,330303,1920,458,13,0x3b3ae790Df4F312e745D270119c6052904FB6790,0xbae0c7d23c8bdB8A41ecF1F9841818f8D82c86Ed
7576,15627883,21000,8512556924,21000,0,2,40,0x6238872A0Bd9F0E19073695532a7Ed77ce93C69E,0x4f9CaFA722A5304D80c5f5A890283a875709BDa5
7577,15627883,69516,8195714081,68920,596,138,2,0xdAC17F958D2ee523a2206206994597C13D831ec7,0x2C9dEff8185F3E02e67e3d2b2D26B137895a2802
7578,15627883,21000,8195714081,21000,0,2,32,0xe1E9c80D8141e4B81f8254e5110aeCE359B32446,0x43a59EFBd7D2b16661535418125A139D762a6CD1
7579,15627883,21000,8185714081,21000,0,2,1,0xD0471582c70d35B2A1928552F4D0f82fE4C6cFBa,0x2142dDbcFd90A40AD2AA29c634C32Ab1b078e44c
7580,15627883,21000,8185714081,21000,0,2,1,0xD0471582c70d35B2A1928552F4D0f82fE4C6cFBa,0x434304E0800C65deD0C9B0eC0C2961C602F537be
7581,15627883,21000,8185714081,21000,0,2,1,0xD0471582c70d35B2A1928552F4D0f82fE4C6cFBa,0x91F5E297Dd9C72B1272DC68216a99DCC9B2f378e
7582,15627883,21000,8185714081,21000,0,2,1,0xD0471582c70d35B2A1928552F4D0f82fE4C6cFBa,0x6bF9bfc814089C878B5c97B515dBb0A3Ec8c683f
7583,15627883,21000,8185714081,21000,0,2,1,0xD0471582c70d35B2A1928552F4D0f82fE4C6cFBa,0x3500eDb0F5Fed55b0360E3A286bdE979906fAdCD
7584,15627883,21000,8185714081,21000,0,2,1,0xD0471582c70d35B2A1928552F4D0f82fE4C6cFBa,0xD99F469a08461B3c55E2A25E2d8D7eB7bb083c03
7585,15627883,21000,8185714081,21000,0,2,1,0xD0471582c70d35B2A1928552F4D0f82fE4C6cFBa,0x44b7f9A947FaaBeA50b148967D57d1a3Da042f22
7586,15627883,21000,8185714081,21000,0,2,1,0xD0471582c70d35B2A1928552F4D0f82fE4C6cFBa,0xACc01D7Acd955b5DA425e338A0Ce4063e6752B53
7587,15627883,61435,8185714081,53271,8164,2506,216,0x00000000006c3852cbEf3e08E8dF289169EdE581,0xe367c5C826A79109C85a930a48CfC3A3E970CE70
7588,15627883,21000,8185714081,21000,0,2,1023,0x8107c36a244C3391E0233ABCEc84BE1DA0407f8C,0xde52fF09ECac44BA59E652635059A3a307c33c9F
7589,15627883,100000,8185714081,99404,596,138,23,0xdAC17F958D2ee523a2206206994597C13D831ec7,0xb9e83009aa3E15Ac4a6fC255C3642D8f66B9725c
7590,15627883,21000,8185714081,21000,0,2,1,0xD0471582c70d35B2A1928552F4D0f82fE4C6cFBa,0x818e63fB7Df6FfB523A07F93ED8cA28D0A39Dd54
7591,15627883,21000,8185714081,21000,0,2,1,0xD0471582c70d35B2A1928552F4D0f82fE4C6cFBa,0x8482aDB09BfDb95E82EcE7FF2a0216909b42Fb36
7592,15627883,51571,8185714081,50951,620,138,273,0x467719aD09025FcC6cF6F8311755809d45a5E5f3,0xcC5410dFa396DB634428405E81Ba6CF79337Af73
7593,15627883,99226,8185714081,98630,596,138,38,0xA0b86991c6218b36c1d19D4a2e9Eb0cE3606eB48,0x348186d5743793b61E17325F38C557076B59c4e4
7594,15627883,21000,8185714081,21000,0,2,1,0xD0471582c70d35B2A1928552F4D0f82fE4C6cFBa,0x4cFcfC5a236F99b849e5573CE6970aB6c0822912
7595,15627883,405701,8185714081,404793,908,330,140,0xfB8814D005C5f32874391e888da6eB2fE7a27902,0x0B86b1bccBb0222c8d877EfAD8fB06c4116AFA08
7596,15627883,21000,8185714081,21000,0,2,1,0xD0471582c70d35B2A1928552F4D0f82fE4C6cFBa,0x0F3EDa6587B468AA556A82deAd2ef2f1e09c4E24
7597,15627883,21000,8185714081,21000,0,2,1,0xD0471582c70d35B2A1928552F4D0f82fE4C6cFBa,0x98c0404C8047B3bE5a4f428A594A95ba3eCB7A11
7598,15627883,278821,8185714081,278617,204,74,473,0x55f1C36Bb7aE0d7D6caE97902E30A2306686Ec73,0x36151eF8bF252eB963235fd76245B98580D595F0
7599,15627883,26645,8185714081,26157,488,138,11,0x020cdC4775366aE436f13A7D333143432e884934,0xc7AC62Dd619B4f910Df8C6C56e08b2Cbe5129869
7600,15627883,21000,8185714081,21000,0,2,1,0xD0471582c70d35B2A1928552F4D0f82fE4C6cFBa,0xe7272348eA4Dcc5e7835Ee3dAF72594eeA912bdc
7601,15627883,164110,8185714081,157510,6600,1802,95,0x00000000006c3852cbEf3e08E8dF289169EdE581,0x4CeA0b9E396BDADf051bEBB8187E8Ab26d41A3d6
7602,15627883,169588,8185714081,167504,2084,522,984,0xd9e1cE17f2641f24aE83637ab66a2cca9C378B9F,0x0FED94bA4F477AE9cDDF413a4b16f6e63405d043
7603,15627883,21000,8185714081,21000,0,2,1,0xD0471582c70d35B2A1928552F4D0f82fE4C6cFBa,0xfa80cBc76516B9bA69F8dB8BD36E816e14D385d7
7604,15627883,21000,8185714081,21000,0,2,1,0xD0471582c70d35B2A1928552F4D0f82fE4C6cFBa,0x3A62896C27879e3b8557B862e0841734e532a177
7605,15627883,49175,8185714081,48687,488,138,1445,0xD27dcbcC8778a8AB33AAc529Df36a634567Be325,0xCA705afF2c65e9525174bd4654Ca5Dc855Fd8a20
7606,15627883,21000,8185714081,21000,0,2,1,0xD0471582c70d35B2A1928552F4D0f82fE4C6cFBa,0x0630cC517173E493D1C593F64a73e5C01A663C25
7607,15627883,46176,8185714081,45688,488,138,112,0xD62899A44ddd9c57A5320D86c421123f8EC4C6bF,0xbE468d4ffF9190DAdCE6956d20E878B9D482c9c5
7608,15627883,21000,8185714081,21000,0,2,1,0xD0471582c70d35B2A1928552F4D0f82fE4C6cFBa,0x75DEF8a617882E94D172690ad052afE590FbF318
7609,15627883,273069,8185714081,269741,3328,970,2,0x68b3465833fb72A70ecDF485E0e4C7bD8665Fc45,0xbE56C177E41a2B8a37216b7816231b1C19B20594
7610,15627883,21000,8185714081,21000,0,2,1,0xD0471582c70d35B2A1928552F4D0f82fE4C6cFBa,0x4bE143F5EBE0ff036Ad0A63CABA53135ab7B4c34
7611,15627883,322747,8185714081,317167,5580,842,0,0xC1E729cd98766b2cbDD337f4E76268a7A9Ea467b,0x73f2289be0414C159F7a785F0eF3525344AE9Df1
7612,15627883,21000,8185714081,21000,0,2,7095,0xC2dC853b149EA213f0C995c92C98E001Ed9F6627,0x0457bDD7d70c82f4cb1C850bd49064a544630978
7613,15627883,61896,8185714081,60808,1088,138,202,0x5FDCCA53617f4d2b9134B29090C87D01058e27e9,0xAD0bc71Da62040A4204bbbB0D83c4F4DCE5c8B03
7614,15627883,291223,8185714081,288839,2384,522,372,0x283Af0B28c62C092C9727F1Ee09c02CA627EB7F5,0x9AB5657982689c38eDC358004e8cAB744aA710b0
7615,15627883,46267,8185714081,45691,576,74,24,0x283Af0B28c62C092C9727F1Ee09c02CA627EB7F5,0x211149D84eD093B17015A824C8bafc9FED2eCfE6
7616,15627883,46114,8185714081,45626,488,138,382,0xE2609354791Bf57E54B3f7F9A26b2dacBed61DA1,0x5Db71204C7D9a9a23359676aE159eD28D2fF4523
7617,15627883,143007,8185714081,136407,6600,1802,112,0x00000000006c3852cbEf3e08E8dF289169EdE581,0xCc1dD65746D5910362bE6201D598BE868C83dF32
7618,15627883,129456,8185714081,123552,5904,1418,542,0x4a848F44146Ca6D1D6AA34bcdF3C41093deF1761,0x26104955B8280C28CA392f42422fdBdbF93C7003
7619,15627883,334964,8185714081,331964,3000,650,3,0x7a250d5630B4cF539739dF2C5dAcb4c659F2488D,0x88fc3d68D7723770A189a8330B784616bB353C48
7620,15627883,142103,8185714081,135451,6652,1810,1236,0x00000000006c3852cbEf3e08E8dF289169EdE581,0x6F73736012cE8dAF37BC06CC78c78c4B3F4313C0
7621,15627883,45399,8185714081,44447,952,202,401,0xC86664e7d2608f881f796ee8E24FA9d4d7598406,0x7D3E5dD617EAF4A3d42EA550C41097086605c4aF
7622,15627883,312138,8185714081,311274,864,266,132,0x69F0b8C5e94f6B64D832B7D9B15F3A88cB2f6F4b,0xBf32569aEfB2b39aa86F057D34F68EDB867CD781
7623,15627883,67544,8185714081,66068,1476,458,987,0x7F7B17Ec3962B140E3eDec6DC105377aAC57FF3E,0x743C1803693020b57Aaf8FBBF3A11F0B8f2A11Df
7624,15627883,166745,8185714081,160145,6600,1802,20,0x00000000006c3852cbEf3e08E8dF289169EdE581,0x57B2F7aA809645765E4a9a2e19ECb83fde4F24bF
7625,15627883,21000,8185714081,21000,0,2,1139,0xF5e44e8a29D578006ca4909DdE6B389A9550F0C5,0xbA4F13f545022a4772E1F0fd2c00E25EC37cF667
7626,15627883,21000,8185714081,21000,0,2,2,0x4e237AB9fE2b5801Be6DD90ce33ef523f6046029,0xc425418Af7958E213e88D14099920f46d085B79D
7627,15627883,201931,8185714081,199183,2748,842,144,0x68b3465833fb72A70ecDF485E0e4C7bD8665Fc45,0xFd18F14008465616509d111240cB245cEFC91eD1
7628,15627883,55926,8185714081,54982,944,138,86,0x456cD8af1E936AD47a31579A5fB462393c6A6851,0x00804aD8aa538E852f5Bb4A49f8957a783ac132f
7629,15627883,193401,8185714081,186761,6640,1810,13,0x00000000006c3852cbEf3e08E8dF289169EdE581,0xE0b92A7aeB2639BC48a81b8b7d5FD9f5739B08F5
7630,15627883,226130,8185714081,215110,11020,3466,5,0x74312363e45DCaBA76c59ec49a7Aa8A65a67EeD3,0x7B2C05FDdd0d3d9179226Ca3dEd46A130338444F
7631,15627883,136080,8185714081,135876,204,74,120,0xa6561830c0Ff7C7c52E85cf062e01740Af216e01,0xBb0C445eddA1364Bedd6e90CF0407986E719Eb01
7632,15627883,176650,8185714081,170010,6640,1810,450,0x00000000006c3852cbEf3e08E8dF289169EdE581,0xA2ED0D7C779D1Be821cB1FC1865C80e8fBddAb43
7633,15627883,21000,8185714081,21000,0,2,1082,0xC409134827440024347e27b2826dFd3D42A2967b,0x9e47BFC71E13848dF7446afc1EADBf307105c257
7634,15627883,95737,8185714081,94801,936,266,282,0x0Eb65B4c3d3dE340e1b15384f8F211784247a37A,0xAFfB93AfaD9570199BFdB00f1cA297287c30dcaf
7635,15627883,46323,8185714081,45835,488,138,33,0xB60C2019DDB48623ed1d134b2bb42F437c6A0202,0xB2362053e77ceb3bFE79a0EF12959E847AB7415a
7636,15627883,181476,8185714081,179912,1564,394,64,0x1Fa8559e873f698292766790AeCf8080A66433F6,0xE7771A0a73735875Ca09b32B7aaB8BB29ffd800e
7637,15627883,21000,8185714081,21000,0,2,332,0x84E210b896B982A6C6cCD6775F3F3328b8178AeE,0xa8BF05B33c1d02C7CAA3061aC0D9CcC32eDcE883
7638,15627883,289707,8185714081,287179,2528,522,488,0x283Af0B28c62C092C9727F1Ee09c02CA627EB7F5,0x36966A187BDEb677078B2c1543F71e911E5d47a2
7639,15627883,181476,8185714081,179912,1564,394,373,0x1Fa8559e873f698292766790AeCf8080A66433F6,0xd9493D3f51C84Cedead582a2E55Fe4381f17DF0a
7640,15627883,46931,8185714081,46299,632,138,21,0xBbd900e05b4aF2124390D206F70bc4E583B1bE85,0x00078176806bB881832c31Ab2530Ac88Ac913871
7641,15627883,21000,8185714081,21000,0,2,13,0xDFE78941ec18C55f1061e49A9C4d71F20266f2Cc,0xd8Efe6bc32371e3a8166c1360B9af675d05b0fd0
7642,15627883,21000,8185714081,21000,0,2,56,0xf5Ac5Cf5391a129fdF15614Ec9dB52Dee0e3E065,0x3DAeC34E0C0Fb425A14bc074bBfA080824953834
7643,15627883,21000,8185714081,21000,0,2,132,0x977551e712E99105fD16c1B9115717aa6961eA43,0xc39521Ba44f39a3107AACbF8c0B191b5aD9405af
7644,15627883,46135,8185714081,45647,488,138,90,0x1Fa8559e873f698292766790AeCf8080A66433F6,0xcBB3E90883062AA91b92D529b8E2b8577F0567B7
7645,15627883,181219,8185714081,177579,3640,1162,93,0x68b3465833fb72A70ecDF485E0e4C7bD8665Fc45,0x61EfF3b64387D1D34da277e375F48ADf1172B64B
7646,15627883,571600,8185714081,568184,3416,1098,0,0xa6B71E26C5e0845f74c812102Ca7114b6a896AB2,0x77ce3525Af90D1D42dfFa0A309561bb05222b07F
7647,15627883,500000,8185714081,498028,1972,394,60928,0x585C3d4Da9b533C7e3dF8AC7356C882859298cEe,0xd5cf0Cb9a8DF9B46f077f561d8b76c34A69bD82F
7648,15627883,44296,8185714081,42796,1500,458,414,0x145b250cce77604209e52F9CAbbb408721F01f9c,0x608A22a203dc383A766037f6Ac2C11dc5a3ff6B6
7649,15627883,94991,8185714081,81263,13728,4106,5,0x00000000006c3852cbEf3e08E8dF289169EdE581,0x77E1d603C69dE58aA8Da1BCe2808CB72Ee003487
7650,15627883,215920,8185714081,212316,3604,1162,608,0x68b3465833fb72A70ecDF485E0e4C7bD8665Fc45,0x0254b349c49D1c3375453140Be3674C028C81251
7651,15627883,53827,8185714081,53339,488,138,633,0xa9BA1A433Ec326bca975aef9a1641B42717197e7,0x2b95620d41D5488D1018350C562b52622E68f0a5
7652,15627883,21000,8185714081,21000,0,2,501,0xF1828624CDfed14Ba2b855dda9fF6FDDcE0EABcb,0xB6F16010beb0Fa054593823851E68DbAf288dd51
7653,15627883,290933,8185714081,288525,2408,522,296,0x283Af0B28c62C092C9727F1Ee09c02CA627EB7F5,0xBd3aE808d527a8d17531274A4a604eEd708f73Dd
7654,15627883,724258,8185714081,703394,20864,6474,126,0x3Aa694EbDC97E4465614057A9E070817CD844DD9,0x910E413DBF3F6276Fe8213fF656726bDc142E08E
7655,15627883,60000,8107149647,59356,644,138,862750,0x84c808F7FcAFd0d101800a70eD57081857Ab4043,0xA910f92ACdAf488fa6eF02174fb86208Ad7722ba
7656,15627883,181476,8000000000,179912,1564,394,345,0x1Fa8559e873f698292766790AeCf8080A66433F6,0xA4b6fbA434A9F28DE372748136c0BAbd253c0455
7657,15627883,222222,8000000000,220658,1564,394,164,0x1Fa8559e873f698292766790AeCf8080A66433F6,0x74aa71cCA2bE62417FA2F058Fbd9629535594466
7658,15627883,34783,8000000000,34127,656,138,15,0x95aD61b0a150d79219dCF64E1E6Cc01f0B64C4cE,0xa0E460016F708D3d2Fe4Ba009705197A97AF5bE3
7659,15627883,61400,7984752916,60184,1216,394,3479111,0x5f65f7b609678448494De4C87521CdF6cEf1e932,0xd24400ae8BfEBb18cA49Be86258a3C749cf46853
7660,15627883,271641,7865323206,270145,1496,402,79,0x1111111254fb6c44bAC0beD2854e76F90643097d,0xc50e05B4802c643Cd0873f5dE9B793f2F988A12e
7661,15627883,481464,7786714081,481464,0,2,106630,0x9AAb3F81604c683a1a0D14019FBfe15bef7aA1ee,0x9AAb3F81604c683a1a0D14019FBfe15bef7aA1ee
7662,15627883,65099,7720000000,64443,656,138,2,0x0F5D2fB29fb7d3CFeE444a200298f468908cC942,0xb98f48B0f6a51b8363AA41CD1642837181951810
7663,15627883,181476,7685714081,179912,1564,394,73,0x1Fa8559e873f698292766790AeCf8080A66433F6,0xEe2bEc7129D723ED887933c847B30e78Eec5e5f5
7664,15627883,261249,7685714081,255329,5920,1738,789,0x68b3465833fb72A70ecDF485E0e4C7bD8665Fc45,0xcCcD6bC9ae993Dbc778b146e5be811626940b8d5
7665,15627883,233420,7685714081,230660,2760,842,405,0x68b3465833fb72A70ecDF485E0e4C7bD8665Fc45,0x1a8eE34dFc9a9C41284767508d8eAAD26CC2890E
7666,15627883,181476,7685714081,179912,1564,394,527,0x1Fa8559e873f698292766790AeCf8080A66433F6,0x868F1a4B5dCffcd1022b9C01dA047eedF755efBd
7667,15627883,257938,7685714081,254262,3676,1162,18,0x68b3465833fb72A70ecDF485E0e4C7bD8665Fc45,0x59Ec91f28d45CFEDe48373B270A47C1abCff5D4e
7668,15627883,181476,7685714081,179912,1564,394,505,0x1Fa8559e873f698292766790AeCf8080A66433F6,0x58858EDA382541D8Ec29df08d77f7AED73613B92
7669,15627883,305947,7685714081,298959,6988,970,4,0x9b3B6974531d8AA15A87908FFd821A64863Ede5B,0x78539a263e8280D0b409d64098288009A2B7416E
7670,15627883,181476,7685714081,179912,1564,394,832,0x1Fa8559e873f698292766790AeCf8080A66433F6,0xeC1676fae70827cB96ee31bb9ad2583dD0934C39
7671,15627883,150756,7685714081,150692,64,10,5,0x65c2e54a4c75ff6da7b6B32369c1677250075fb2,0x2354d3Ebb064C6610e371e88e26806088D2e443e
7672,15627883,150756,7685714081,150692,64,10,2,0x65c2e54a4c75ff6da7b6B32369c1677250075fb2,0xd032853c1BA987B29fbC58937710d47a0B101D28
7673,15627883,181476,7685714081,179912,1564,394,191,0x1Fa8559e873f698292766790AeCf8080A66433F6,0xA8040304dc8Bc4C2612D67Ca7515b60207d5B904
7674,15627883,308258,7685714081,304994,3264,1034,9,0x68b3465833fb72A70ecDF485E0e4C7bD8665Fc45,0x6c096Ea3C809A5F4C7795Dc0360031414b3ca17a
7675,15627883,181476,7685714081,179912,1564,394,387,0x1Fa8559e873f698292766790AeCf8080A66433F6,0xF56bcAcA6495FcC2fcC78599075415787E2C2351
7676,15627883,175110,7685714081,173546,1564,394,311,0x1Fa8559e873f698292766790AeCf8080A66433F6,0x8c4B4408E8B160191c739D4EeAB0b4c4D36036aE
7677,15627883,240729,7685714081,234809,5920,1738,16,0x68b3465833fb72A70ecDF485E0e4C7bD8665Fc45,0x630D329fEbE98a0ee24c1D9AC451a04476FeC43e
7678,15627883,181476,7685714081,179912,1564,394,118,0x1Fa8559e873f698292766790AeCf8080A66433F6,0xAe5C2b1Dd2094bf9CCFA181942f317F2F7D7452e
7679,15627883,293967,7685714081,291123,2844,842,155,0x68b3465833fb72A70ecDF485E0e4C7bD8665Fc45,0x47BFA351ec8EfA6cB57bdFC8679A56698062FeAA
7680,15627883,181476,7685714081,179912,1564,394,757,0x1Fa8559e873f698292766790AeCf8080A66433F6,0x41dCce099a3Df0259d1f97FdAA0e68eF599afDE0
7681,15627883,181458,7685714081,179906,1552,394,1920,0x1Fa8559e873f698292766790AeCf8080A66433F6,0x253ae13B5e9d0B789e6e0e4335df8C5b48060908
7682,15627883,21000,7618745156,21000,0,2,3,0x787B8840100d9BaAdD7463f4a73b5BA73B00C6cA,0x35224967C73453617389Db1a1631da28D08B51c9
7683,15627883,100000,7489597799,99056,944,138,1885,0xC02aaA39b223FE8D0A0e5C4F27eAD9083C756Cc2,0xEB95ff72EAb9e8D8fdb545FE15587AcCF410b42E
7684,15627883,175150,7489597799,172390,2760,842,1886,0x68b3465833fb72A70ecDF485E0e4C7bD8665Fc45,0xEB95ff72EAb9e8D8fdb545FE15587AcCF410b42E
7685,15627883,80000,7370136043,79056,944,138,0,0x95aD61b0a150d79219dCF64E1E6Cc01f0B64C4cE,0x0Bc14DE57b59C43F0B0FE9D8943836A537b74CF9
7686,15627883,479099,7285292820,478003,1096,160,5124,0x507888e987257a8DdE6F8AFa46375CEfe2CbF504,0x678111a6cA5749f1744b5E080A855CEC8d631E20
7687,15627883,51712,7158267806,50724,988,202,890838,0xdAC17F958D2ee523a2206206994597C13D831ec7,0x340d693ED55d7bA167D184ea76Ea2Fd092a35BDc
7688,15627883,57262,8472942607,56286,976,202,890839,0xA0b86991c6218b36c1d19D4a2e9Eb0cE3606eB48,0x340d693ED55d7bA167D184ea76Ea2Fd092a35BDc
7689,15627883,57262,11081820539,56286,976,202,890840,0xA0b86991c6218b36c1d19D4a2e9Eb0cE3606eB48,0x340d693ED55d7bA167D184ea76Ea2Fd092a35BDc
7690,15627883,105000,7008449953,105000,0,2,138572,0x5A3049830c8bD59316FEB53399695Fc4f0D7FfA7,0x974CaA59e49682CdA0AD2bbe82983419A2ECC400
7691,15627883,105000,7008449953,105000,0,2,138573,0x1700749308F542BEd70728C47f62a7ad71B79869,0x974CaA59e49682CdA0AD2bbe82983419A2ECC400
7692,15627883,105000,7536523327,105000,0,2,138574,0x71bE8f0e2cb1feEB6619DeA8a7D9E081C9E7EB72,0x974CaA59e49682CdA0AD2bbe82983419A2ECC400
7693,15627883,245833,7008449953,245369,464,138,14,0x7f5f854FfB6b7701540a00C69c4AB2De2B34291D,0x029481B801393B4f7E68eEc1327beE74a4D95b88
7694,15627883,242776,7008449953,240904,1872,458,2197,0xEfF92A263d31888d860bD50809A8D171709b7b1c,0x1A63CD1aaF13e424DFA370D8D4dD326b5Fb4014a
7695,15627883,21000,7008449953,21000,0,2,10,0x974CaA59e49682CdA0AD2bbe82983419A2ECC400,0xd59b0dA2e9CEbA8e51AE268fBdB40B8A3869b5BB
7696,15627883,181476,7008449953,179912,1564,394,115,0x1Fa8559e873f698292766790AeCf8080A66433F6,0xcc4585Ca5D7D39A5bB0356eD46bd772b6C1aba5e
7697,15627883,181476,7008449953,179912,1564,394,116,0x1Fa8559e873f698292766790AeCf8080A66433F6,0xcc4585Ca5D7D39A5bB0356eD46bd772b6C1aba5e
7698,15627883,222442,7008449953,220594,1848,458,1652,0xEfF92A263d31888d860bD50809A8D171709b7b1c,0x3d26b43dD2181471b46cF484dd8c06C47c050d4C
7699,15627883,287746,7001629241,284978,2768,714,10306,0x54DB3f82bd08682e7CEc6BF81573f000609Ff7c7,0x75B8d4D81377d4B0F11790779563462264914A24
7700,15627883,46995,7000000000,45843,1152,458,609,0x43C345d604dcfB2195392AB3E4b0aafB254f8687,0xa7c3f481810149f3853993abC4E85C49023CD2B6
7701,15627883,21000,6927917948,21000,0,2,890841,0x9CAEb899C564e1Ef58fe65B68CD8C59d9f055c2B,0x340d693ED55d7bA167D184ea76Ea2Fd092a35BDc
7702,15627883,100000,6921635906,99392,608,138,705885,0xdAC17F958D2ee523a2206206994597C13D831ec7,0x6dfc34609a05bC22319fA4Cce1d1E2929548c0D7
7703,15627883,21000,9530000000,21000,0,2,705886,0x23beF28c250b14471987EB8378D951247457ea90,0x6dfc34609a05bC22319fA4Cce1d1E2929548c0D7
7704,15627883,21000,9530000000,21000,0,2,705887,0x3eA017AC3C48D5263159aa22CDAA466670b6bC12,0x6dfc34609a05bC22319fA4Cce1d1E2929548c0D7
7705,15627883,28932,6808238489,28668,264,74,71,0x17C8F5aE96487967CE72E78a2A52E0711A87772E,0xBa412D28e82D6f087C7D155c5875A46C97a82442
7706,15627883,21000,6750909967,21000,0,2,890842,0x22416cd18fC3806083C10c9c57BD1Fc8DAb859d6,0x340d693ED55d7bA167D184ea76Ea2Fd092a35BDc
7707,15627883,21000,11404349014,21000,0,2,890843,0x892e8d53D4b2eCA7B8Da72d201E5BEcAe26631D5,0x340d693ED55d7bA167D184ea76Ea2Fd092a35BDc
7708,15627883,21000,12682779604,21000,0,2,890844,0x966B1B520de639d84c9A566eED51b898226B1DBa,0x340d693ED55d7bA167D184ea76Ea2Fd092a35BDc
7709,15627883,57274,9973024026,56286,988,202,890845,0xA0b86991c6218b36c1d19D4a2e9Eb0cE3606eB48,0x340d693ED55d7bA167D184ea76Ea2Fd092a35BDc
7710,15627883,57262,7656402000,56286,976,202,890846,0xA0b86991c6218b36c1d19D4a2e9Eb0cE3606eB48,0x340d693ED55d7bA167D184ea76Ea2Fd092a35BDc
7711,15627883,21000,7488670991,21000,0,2,890847,0x5303809D740173a9C87466a4205D23833995743f,0x340d693ED55d7bA167D184ea76Ea2Fd092a35BDc
7712,15627883,57262,13700604399,56286,976,202,890848,0xA0b86991c6218b36c1d19D4a2e9Eb0cE3606eB48,0x340d693ED55d7bA167D184ea76Ea2Fd092a35BDc
7713,15627883,57262,13764510449,56286,976,202,890849,0xA0b86991c6218b36c1d19D4a2e9Eb0cE3606eB48,0x340d693ED55d7bA167D184ea76Ea2Fd092a35BDc
7714,15627883,21000,13995480729,21000,0,2,890850,0x76930D281F21936f8576dC1E6D40d1bcd8De5ccf,0x340d693ED55d7bA167D184ea76Ea2Fd092a35BDc
7715,15627883,51700,12920615606,50724,976,202,890851,0xdAC17F958D2ee523a2206206994597C13D831ec7,0x340d693ED55d7bA167D184ea76Ea2Fd092a35BDc
7716,15627883,21000,12920615606,21000,0,2,890852,0xcB8a0225a3CfAE3a670386Ea7C7924a1ECb8db82,0x340d693ED55d7bA167D184ea76Ea2Fd092a35BDc
7717,15627883,57262,13270637661,56286,976,202,890853,0xA0b86991c6218b36c1d19D4a2e9Eb0cE3606eB48,0x340d693ED55d7bA167D184ea76Ea2Fd092a35BDc
7718,15627883,21000,13516500235,21000,0,2,890854,0x727F81a59Ca78Ddd7e8B812fd885bD261D95B709,0x340d693ED55d7bA167D184ea76Ea2Fd092a35BDc
7719,15627883,57262,13516500235,56286,976,202,890855,0xA0b86991c6218b36c1d19D4a2e9Eb0cE3606eB48,0x340d693ED55d7bA167D184ea76Ea2Fd092a35BDc
7720,15627883,57262,13516500235,56286,976,202,890856,0xA0b86991c6218b36c1d19D4a2e9Eb0cE3606eB48,0x340d693ED55d7bA167D184ea76Ea2Fd092a35BDc
7721,15627883,21000,12227571114,21000,0,2,890857,0xD10Dd3EcF548FA0b716c69C03d8942746b26A8F0,0x340d693ED55d7bA167D184ea76Ea2Fd092a35BDc
7722,15627883,21000,12227571114,21000,0,2,890858,0x93130B2f422Af0CE8eE20A9c470FB792d6a38c56,0x340d693ED55d7bA167D184ea76Ea2Fd092a35BDc
7723,15627883,21000,11046906140,21000,0,2,890859,0x82C3FcE7B8beB04bc8Acb0C4a98AA80331FAC8Ae,0x340d693ED55d7bA167D184ea76Ea2Fd092a35BDc
7724,15627883,21000,13919356499,21000,0,2,890860,0xD10Dd3EcF548FA0b716c69C03d8942746b26A8F0,0x340d693ED55d7bA167D184ea76Ea2Fd092a35BDc
7725,15627883,57262,13171746292,56286,976,202,890861,0xA0b86991c6218b36c1d19D4a2e9Eb0cE3606eB48,0x340d693ED55d7bA167D184ea76Ea2Fd092a35BDc
7726,15627883,42511,12101933069,41451,1060,202,890862,0x95aD61b0a150d79219dCF64E1E6Cc01f0B64C4cE,0x340d693ED55d7bA167D184ea76Ea2Fd092a35BDc
7727,15627883,57262,12449816775,56286,976,202,890863,0xA0b86991c6218b36c1d19D4a2e9Eb0cE3606eB48,0x340d693ED55d7bA167D184ea76Ea2Fd092a35BDc
7728,15627883,57262,14825675382,56286,976,202,890864,0xA0b86991c6218b36c1d19D4a2e9Eb0cE3606eB48,0x340d693ED55d7bA167D184ea76Ea2Fd092a35BDc
7729,15627883,48506,14118947813,47530,976,202,890865,0xdAC17F958D2ee523a2206206994597C13D831ec7,0x340d693ED55d7bA167D184ea76Ea2Fd092a35BDc
7730,15627883,21000,14649113735,21000,0,2,890866,0x1C37426b96C4B83CDfFa9CF2E2D3eF08d701164a,0x340d693ED55d7bA167D184ea76Ea2Fd092a35BDc
7731,15627883,21000,11580826141,21000,0,2,890867,0xec2E537e65d6C2D817Ca04aCB7D49F0D585E7604,0x340d693ED55d7bA167D184ea76Ea2Fd092a35BDc
7732,15627883,21000,8607482742,21000,0,2,890868,0x1C37426b96C4B83CDfFa9CF2E2D3eF08d701164a,0x340d693ED55d7bA167D184ea76Ea2Fd092a35BDc
7733,15627883,21000,10781952690,21000,0,2,890869,0x06F9C480BC0A20df72e7591Bceb378C33cE21D57,0x340d693ED55d7bA167D184ea76Ea2Fd092a35BDc
7734,15627883,21000,10089213809,21000,0,2,890870,0x8AceB5EEcfD1CfD4f03bf0ce60d357539574bd71,0x340d693ED55d7bA167D184ea76Ea2Fd092a35BDc
7735,15627883,21000,13945810067,21000,0,2,890871,0x22e218E590D74001f60Db4C2bEC6327FE8448AE0,0x340d693ED55d7bA167D184ea76Ea2Fd092a35BDc
7736,15627883,48494,13945810067,47530,964,202,890872,0xdAC17F958D2ee523a2206206994597C13D831ec7,0x340d693ED55d7bA167D184ea76Ea2Fd092a35BDc
7737,15627883,21000,13940997170,21000,0,2,890873,0x1e3278ecaF42CbF534b277Cb47e0A2bf6051648C,0x340d693ED55d7bA167D184ea76Ea2Fd092a35BDc
7738,15627883,21000,12835338213,21000,0,2,890874,0xC7c8228088723Fd7710F789Bd2D233df939D1E10,0x340d693ED55d7bA167D184ea76Ea2Fd092a35BDc
7739,15627883,21000,14264826612,21000,0,2,890875,0x6404F2CAB61adCf18B06f6863CEE99a1F0Eb6524,0x340d693ED55d7bA167D184ea76Ea2Fd092a35BDc
7740,15627883,40395,14264826612,39359,1036,202,890876,0x0D8775F648430679A709E98d2b0Cb6250d2887EF,0x340d693ED55d7bA167D184ea76Ea2Fd092a35BDc
7741,15627883,21000,13126626766,21000,0,2,890877,0x8e7124D0157a917E1ED4446370180A74a2D57b4a,0x340d693ED55d7bA167D184ea76Ea2Fd092a35BDc
7742,15627883,57262,14896324943,56286,976,202,890878,0xA0b86991c6218b36c1d19D4a2e9Eb0cE3606eB48,0x340d693ED55d7bA167D184ea76Ea2Fd092a35BDc
7743,15627883,57262,14896324943,56286,976,202,890879,0xA0b86991c6218b36c1d19D4a2e9Eb0cE3606eB48,0x340d693ED55d7bA167D184ea76Ea2Fd092a35BDc
7744,15627883,57262,13808387736,56286,976,202,890880,0xA0b86991c6218b36c1d19D4a2e9Eb0cE3606eB48,0x340d693ED55d7bA167D184ea76Ea2Fd092a35BDc
7745,15627883,21000,13808387736,21000,0,2,890881,0xd3917289eAb72072212F9ac5b9269C201EC2ADb2,0x340d693ED55d7bA167D184ea76Ea2Fd092a35BDc
7746,15627883,57274,13541086117,56286,988,202,890882,0xA0b86991c6218b36c1d19D4a2e9Eb0cE3606eB48,0x340d693ED55d7bA167D184ea76Ea2Fd092a35BDc
7747,15627883,48506,14443025959,47530,976,202,890883,0xdAC17F958D2ee523a2206206994597C13D831ec7,0x340d693ED55d7bA167D184ea76Ea2Fd092a35BDc
7748,15627883,21000,14443025959,21000,0,2,890884,0xE0564ce2cC0C3b7669A22cFBC95cFd0A1DF2697a,0x340d693ED55d7bA167D184ea76Ea2Fd092a35BDc
7749,15627883,57262,11157801655,56286,976,202,890885,0xA0b86991c6218b36c1d19D4a2e9Eb0cE3606eB48,0x340d693ED55d7bA167D184ea76Ea2Fd092a35BDc
7750,15627883,57250,9597616905,56286,964,202,890886,0xA0b86991c6218b36c1d19D4a2e9Eb0cE3606eB48,0x340d693ED55d7bA167D184ea76Ea2Fd092a35BDc
7751,15627883,51688,11182992725,50724,964,202,890887,0xdAC17F958D2ee523a2206206994597C13D831ec7,0x340d693ED55d7bA167D184ea76Ea2Fd092a35BDc
7752,15627883,48506,13929161489,47530,976,202,890888,0xdAC17F958D2ee523a2206206994597C13D831ec7,0x340d693ED55d7bA167D184ea76Ea2Fd092a35BDc
7753,15627883,51712,13822411949,50724,988,202,890889,0xdAC17F958D2ee523a2206206994597C13D831ec7,0x340d693ED55d7bA167D184ea76Ea2Fd092a35BDc
7754,15627883,21000,10252092696,21000,0,2,890890,0x315A07e3b1C222A0Ff3c690d83F3a16aA181dC7e,0x340d693ED55d7bA167D184ea76Ea2Fd092a35BDc
7755,15627883,57274,10315242084,56286,988,202,890891,0xA0b86991c6218b36c1d19D4a2e9Eb0cE3606eB48,0x340d693ED55d7bA167D184ea76Ea2Fd092a35BDc
7756,15627883,57274,13658685466,56286,988,202,890892,0xA0b86991c6218b36c1d19D4a2e9Eb0cE3606eB48,0x340d693ED55d7bA167D184ea76Ea2Fd092a35BDc
7757,15627883,51712,13343503209,50724,988,202,890893,0xdAC17F958D2ee523a2206206994597C13D831ec7,0x340d693ED55d7bA167D184ea76Ea2Fd092a35BDc
7758,15627883,48506,10790591439,47530,976,202,890894,0xdAC17F958D2ee523a2206206994597C13D831ec7,0x340d693ED55d7bA167D184ea76Ea2Fd092a35BDc
7759,15627883,44985,10535956728,43961,1024,202,890895,0x7D1AfA7B718fb893dB30A3aBc0Cfc608AaCfeBB0,0x340d693ED55d7bA167D184ea76Ea2Fd092a35BDc
7760,15627883,21000,8612783621,21000,0,2,890896,0x715B0b5D0749CC5680aE40482b16cbd298C1b3B9,0x340d693ED55d7bA167D184ea76Ea2Fd092a35BDc
7761,15627883,21000,8043993885,21000,0,2,890897,0x550862F6a513cEAdA5cc516e69219411Ac2dF119,0x340d693ED55d7bA167D184ea76Ea2Fd092a35BDc
7762,15627883,21000,9097310965,21000,0,2,890898,0x550862F6a513cEAdA5cc516e69219411Ac2dF119,0x340d693ED55d7bA167D184ea76Ea2Fd092a35BDc
7763,15627883,57262,14190689543,56286,976,202,890899,0xA0b86991c6218b36c1d19D4a2e9Eb0cE3606eB48,0x340d693ED55d7bA167D184ea76Ea2Fd092a35BDc
7764,15627883,41211,13301046845,40175,1036,202,890900,0x6B175474E89094C44Da98b954EedeAC495271d0F,0x340d693ED55d7bA167D184ea76Ea2Fd092a35BDc
7765,15627883,57262,12131345505,56286,976,202,890901,0xA0b86991c6218b36c1d19D4a2e9Eb0cE3606eB48,0x340d693ED55d7bA167D184ea76Ea2Fd092a35BDc
7766,15627883,21000,11533264155,21000,0,2,890902,0xf4280eFa9DCFFA2C36f4E8AB27C5566CBB40c86B,0x340d693ED55d7bA167D184ea76Ea2Fd092a35BDc
7767,15627883,21000,9564016778,21000,0,2,890903,0xf4280eFa9DCFFA2C36f4E8AB27C5566CBB40c86B,0x340d693ED55d7bA167D184ea76Ea2Fd092a35BDc
7768,15627883,48506,9564016778,47530,976,202,890904,0xdAC17F958D2ee523a2206206994597C13D831ec7,0x340d693ED55d7bA167D184ea76Ea2Fd092a35BDc
7769,15627883,57274,12101497577,56286,988,202,890905,0xA0b86991c6218b36c1d19D4a2e9Eb0cE3606eB48,0x340d693ED55d7bA167D184ea76Ea2Fd092a35BDc
7770,15627883,57262,12406365626,56286,976,202,890906,0xA0b86991c6218b36c1d19D4a2e9Eb0cE3606eB48,0x340d693ED55d7bA167D184ea76Ea2Fd092a35BDc
7771,15627883,48506,14862396476,47530,976,202,890907,0xdAC17F958D2ee523a2206206994597C13D831ec7,0x340d693ED55d7bA167D184ea76Ea2Fd092a35BDc
7772,15627883,48506,14743133482,47530,976,202,890908,0xdAC17F958D2ee523a2206206994597C13D831ec7,0x340d693ED55d7bA167D184ea76Ea2Fd092a35BDc
7773,15627883,21000,10802410813,21000,0,2,890909,0x14D6253C96181a37Dd682772316e77b220696701,0x340d693ED55d7bA167D184ea76Ea2Fd092a35BDc
7774,15627883,57274,8888069835,56286,988,202,890910,0xA0b86991c6218b36c1d19D4a2e9Eb0cE3606eB48,0x340d693ED55d7bA167D184ea76Ea2Fd092a35BDc
7775,15627883,51700,7213430682,50724,976,202,890911,0xdAC17F958D2ee523a2206206994597C13D831ec7,0x340d693ED55d7bA167D184ea76Ea2Fd092a35BDc
7776,15627883,1158543,6695714081,1147027,11516,1734,27895,0x0eae044f00B0aF300500F090eA00027097d03000,0x05429D641a61eB2C6093905784D2e8C9b5A193C8
7777,15627883,26000,6685714081,26000,0,2,12030,0x6c95D798B5555467Be86E6afffEe3216490d9Ad6,0xDAFEA492D9c6733ae3d56b7Ed1ADB60692c98Bc5
7778,15627884,233744,7348810112,231560,2184,650,119832,0xA69babEF1cA67A37Ffaf7a485DfFF3382056e78C,0xeCa2e2D894D19778939bD4DfC34D2a3C45E96456
7779,15627884,45038,8558812312,44974,64,10,174,0xC02aaA39b223FE8D0A0e5C4F27eAD9083C756Cc2,0x3f90b8a5C4EA3de8B84b8bb1Dcb9696bFB79952B
7780,15627884,63605,8558812312,63329,276,74,17,0xC02aaA39b223FE8D0A0e5C4F27eAD9083C756Cc2,0xC06AAbAD85ecccfa35CFe671D6DF90Ac9D46619b
7781,15627884,500000,100000000000,497976,2024,522,7508,0x7a250d5630B4cF539739dF2C5dAcb4c659F2488D,0xC5C018EDb7Ec3e4217728C1e1F608b28057Dd507
7782,15627884,700000,47348810112,698420,1580,330,1162,0x95B05Bc8f6c59847E7d2D484E8542363D422e341,0x47ec31abc6b86e49933dC7B2969EBEbE3De662cA
7783,15627884,200000,18000000000,199784,216,74,189,0xb47e3cd837dDF8e4c57F05d70Ab865de6e193BBB,0x284BcE1836454341186056F8DBd424238Fc5a537
7784,15627884,240724,17000000000,234828,5896,1738,1467,0x68b3465833fb72A70ecDF485E0e4C7bD8665Fc45,0x934752f07d187CBB757398F84ed398bc395BCA3E
7785,15627884,5049368,17000000000,5042268,7100,1098,293,0x0a39DA505DfB5E0BBc6bd84428281A8ba1bC7753,0x495E889d1A6cEB447a57dcc1C68410299392380c
7786,15627884,21000,15000000000,21000,0,2,149,0x60a8CC745db7B132398c052beE79d0dCC075B371,0xd32a8f7cB990fd4E5ACB3317501EF19c392C13af
7787,15627884,70824,13348810112,69880,944,138,243,0x9431DE2DFE10BDB30995bd3791dE03a6c9570054,0x4Fd47Ead21BA0be8F1efe7217be88ddD82ec40e2
7788,15627884,21000,12600000000,21000,0,2,2,0x500A746c9a44f68Fe6AA86a92e7B3AF4F322Ae66,0x8CD12a4C6C6996128aBaA23563daE501BF69be64
7789,15627884,36015,12348810112,35751,264,74,4067,0xC02aaA39b223FE8D0A0e5C4F27eAD9083C756Cc2,0x0d1d74535bCAbda2dA2CfF5A53C2B899901D423B
7790,15627884,90000,12020703300,89332,668,138,94,0x321C2fE4446C7c963dc41Dd58879AF648838f98D,0x65c7F0F1253a7E47Db61a75C52937103d1550775
7791,15627884,181476,11618745156,179912,1564,394,7028,0x1Fa8559e873f698292766790AeCf8080A66433F6,0xe749e9E7EAa02203c925A036226AF80e2c79403E
7792,15627884,69181,11250000000,68585,596,138,4,0xdAC17F958D2ee523a2206206994597C13D831ec7,0x769D8343e766837074475Cd157701642e845B194
7793,15627884,63000,11077739367,63000,0,2,183632,0xbb71cc02B7b5F2708Fd913889c90FBe3ECb14514,0x25eAff5B179f209Cf186B1cdCbFa463A69Df4C45
7794,15627884,21000,11000000000,21000,0,2,2326,0x30868223A3cb6Dc4B1746EE8807FAa7372457540,0xce0df2BA6c2BD425F3Ffbbea708F0B5f21ae1e6a
7795,15627884,122429,10348810112,121677,752,138,192816,0xDBd324B73f6f85bf9013B75C442021303b635Ff9,0x19f494583c7C933be7B0eE58104DDaFac1E8aDfA
7796,15627884,26000000,10000000000,25935240,64760,15882,16091,0x4F4495243837681061C4743b74B3eEdf548D56A5,0x19e34D09c2664d4F0829B1431eA73daC1B2bea93
7797,15627884,191041,10000000000,190165,876,266,1397,0xd588b586D61C826A0e87919b3D1a239206d58bf2,0xC22d03e13B888Dabb33A1575e4F6542f0e996622
7798,15627884,21000,10000000000,21000,0,2,3,0x7Fe9fE42f684d13e80EE8DDCe5Ac9544dd1eAf2C,0x3478f228eF3Cfa081c1b2C1DAA68a20f2F948a04
7799,15627884,90000,9877013500,89344,656,138,3,0xa23C1194d421F252b4e6D5edcc3205F7650a4eBE,0xb3cA9402D358A1EF83695C661316E7432b542d24
7800,15627884,90000,9877013500,89344,656,138,4,0x1aB43204a195a0fD37EdeC621482AFd3792ef90b,0x99D42548e9EcAfe4ae2430bBb1F0F582257777aA
7801,15627884,77727,9859387997,77083,644,138,10,0x6B175474E89094C44Da98b954EedeAC495271d0F,0x9aBb4Df912FCCCB25ff296b45046CB9D399b19fF
7802,15627884,94813,9859387997,94205,608,138,6,0xdAC17F958D2ee523a2206206994597C13D831ec7,0x27e74103AD1418620D8243f8D41b9Efd770c42d4
7803,15627884,172350,9848810112,171922,428,138,215,0x28c6ea3F9cF9bC1a07A828fce1e7783261691B49,0xc19B48831d11647F10Fc06AE1572FE54142a58AC
7804,15627884,92421,9848810112,91489,932,138,0,0x3071BE11F9e92A9eb28F305e1Fa033cD102714e7,0xfc7ec79c814ff15e2Ab1301EE21dEAB8a1e76eC8
7805,15627884,21000,9835249505,21000,0,2,247,0xCBD6832Ebc203e49E2B771897067fce3c58575ac,0x979207f06Ac3b3Ef08577fE818271a1B3E012689
7806,15627884,69000,9748810112,68512,488,138,133,0xD27dcbcC8778a8AB33AAc529Df36a634567Be325,0x9774E35A7895cb04456CE0ddDBF2c4594b1f95dc
7807,15627884,21000,9620027188,21000,0,2,1,0x84F746217fc44B55eefab6CB82c6cFE51d53b34C,0xBc80aDFf89d9bf10ee1D6233942E0DF42F4622b4
7808,15627884,234940,9398810112,232192,2748,842,778,0x68b3465833fb72A70ecDF485E0e4C7bD8665Fc45,0xEF3bAF2AD803A5d9B1A4B4a719b7b2E1C1E2E2B9
7809,15627884,62334,9380000000,61702,632,138,4,0x4a220E6096B25EADb88358cb44068A3248254675,0x78061c5879177b036C1640BE577f695b76D2f0f6
7810,15627884,50000,9349810112,50000,0,2,58488,0x27eAAD4F80cd0d5270859D91A57fC2F61757a4D1,0x867bfA133D64fAd734C89f886D2A169B6504Ab2b
7811,15627884,181458,9348810112,179906,1552,394,359,0x1Fa8559e873f698292766790AeCf8080A66433F6,0xf96a7Df1C5a8d06E00b1609F914388817BbE2D52
7812,15627884,90000,9348810112,90000,0,2,93928,0x668265bfCaC477eb6c9caaE54ADa1675FcD70241,0xf89d7b9c864f589bbF53a82105107622B35EaA40
7813,15627884,85000,9348810112,84512,488,138,18,0xD27dcbcC8778a8AB33AAc529Df36a634567Be325,0x9b64d3afBdA7dF2BAC46227aB06d0D9CE6d0cee2
7814,15627884,21000,9348810112,21000,0,2,323,0x6705E582716b0cFf433f1a568623B6FBA41ebB82,0xBb0Af8fB13473b81C2B6fE1503A0f70207231717
7815,15627884,39643,9348810112,39355,288,74,6,0xC02aaA39b223FE8D0A0e5C4F27eAD9083C756Cc2,0xB83976FF9Ab26d5Dfa0D8581C5b82Fd9f2E2Ce60
7816,15627884,21000,9348810112,21000,0,2,16,0xee4c5167EB3f22D741A64e76DccC9dca438db95E,0x2bE66B8F7e9b087a0210F955c2d9Ce580d8Efa7F
7817,15627884,222314,9348810112,217562,4752,1484,155,0x881D40237659C251811CEC9c364ef91dC08D300C,0x9aF050C15029483D2063c65e2b920a79E956A4d9
7818,15627884,21000,9348810112,21000,0,2,12168,0x672E2d575a28CCD4Df20BC435Ee10a5B67DdeFFf,0x36aB75710650754c32e4850D2ad050849EBb5899
7819,15627884,236016,9348810112,233244,2772,842,194,0x68b3465833fb72A70ecDF485E0e4C7bD8665Fc45,0x68E8d2E2423176bbEC676B50745541906d18E01D
7820,15627884,70000,9348810112,69404,596,138,55,0xdAC17F958D2ee523a2206206994597C13D831ec7,0xF95f9285C7Bd76A01179600e8E851B2c3Cc73A1C
7821,15627884,143301,9348810112,136689,6612,1802,314,0x00000000006c3852cbEf3e08E8dF289169EdE581,0x9e456247026Ac3a6f38B4885e6A593089732861D
7822,15627884,42000,9348810112,42000,0,2,329544,0xb04eb383c355D3a16D175cD0CA51131Be858dDb8,0x9430801EBAf509Ad49202aaBC5F5Bc6fd8A3dAf8
7823,15627884,350220,9348810112,348656,1564,394,11,0x1Fa8559e873f698292766790AeCf8080A66433F6,0x7DCb1e658F9a5BefF044C41FBc32d07ef7a10E6b
7824,15627884,250348,9348810112,245868,4480,1420,74,0x881D40237659C251811CEC9c364ef91dC08D300C,0xb5bD955db2225C432D95d1d4F2A5a5f079590766
7825,15627884,500000,9348810112,499344,656,138,40332,0x1f9840a85d5aF5bf1D1762F925BDADdC4201F984,0x4C6007e38Ce164Ed80FF8Ff94192225FcdAC68CD
7826,15627884,69132,9348810112,68644,488,138,843,0x4556561740B7B5F858967A6a4E54e506609704Bd,0x6B0a789e01eC7e7c2d02905d9DaBD3e879Ff7417
7827,15627884,21000,9348810112,21000,0,2,27,0xFBCE8663dCE0B0b1f71ab173E6CBCC0D3fC2DB4b,0xa24554e9575f9A3F168b17AFdE8D065DD879581F
7828,15627884,34315,9348810112,33135,1180,394,2611,0x1A90B3Dead0113740266b7F7Ea1136e8ED1b48C5,0x24245e6c515187aB9b103BD278dAd0d5A08EdBaA
7829,15627884,48897,9348810112,47953,944,138,112,0xdAC17F958D2ee523a2206206994597C13D831ec7,0xE8F6C97e1BaB1c6E41B42f49EBFAb0387C79b316
7830,15627884,21000,9348810112,21000,0,2,2759947,0x29240dB8F22d115Ec0427Ca7Cce8449615423de1,0x267be1C1D684F78cb4F6a176C4911b741E4Ffdc0
7831,15627884,280467,9348810112,274779,5688,1676,113,0x881D40237659C251811CEC9c364ef91dC08D300C,0xE8F6C97e1BaB1c6E41B42f49EBFAb0387C79b316
7832,15627884,60760,9348810112,59816,944,138,10,0xA0b86991c6218b36c1d19D4a2e9Eb0cE3606eB48,0x8448aC1314d61791967eb446D1aCebE0aF3463D2
7833,15627884,740000,9214595894,728716,11284,2506,22230,0x7531f77095Bed9d63cB3E9EA305111a7DCE969A2,0xc61a7e5a04A5d32ffe8e01f77Cb39253bf21D2aC
7834,15627884,21000,9111824349,21000,0,2,28,0xEF7050EDC2a1F26f4996acF8aEA6ACb11a5e1113,0x32Aa23c483904e03751d317B37adA87B0E2036d0
7835,15627884,21000,9000000000,21000,0,2,9,0x50e561e69008014E174d3ecD20291193E31850Fd,0x84C3C41deE5882DF241DBbAB819D3fa5221Ca4aa
7836,15627884,352882,8965986781,349278,3604,1162,604,0x68b3465833fb72A70ecDF485E0e4C7bD8665Fc45,0xdd1D00cEdB005e66310A260145Da4d77E110b967
7837,15627884,562059,8958810112,550239,11820,3914,298,0xDEF171Fe48CF0115B1d80b88dc8eAB59176FEe57,0x17D065070486Ca0fC8b4B382b946BE79Fb4fF10D
7838,15627884,72618,8858810212,71706,912,266,385,0xB63cac384247597756545b500253ff8E607a8020,0xf73F60321C8F4a498b58CD0A6adf091302185AD5
7839,15627884,200000,8849810112,199392,608,138,63860,0xdAC17F958D2ee523a2206206994597C13D831ec7,0x17F1a51dA68d27c94D2a51d92B27B5Bd4718b986
7840,15627884,21000,8849810112,21000,0,2,113054,0x56F2118a910C950164D652AcC635BE60b4358e2a,0x6081258689a75d253d87cE902A8de3887239Fe80
7841,15627884,1000000,8848810112,999392,608,138,4121140,0x467719aD09025FcC6cF6F8311755809d45a5E5f3,0x0D0707963952f2fBA59dD06f2b425ace40b492Fe
7842,15627884,162147,8848810112,155483,6664,1810,23,0x00000000006c3852cbEf3e08E8dF289169EdE581,0x97640D58FBC2677B1dc33f3eeb0128bdfFf9f5E9
7843,15627884,239815,8848810112,239219,596,138,29,0x0449F65a5e09F0f30Aa504B8474D1D4d0e10B8B8,0xD8Fa208be458DbA09f93EEeB270d1e6DB07Cd985
7844,15627884,77425,8848810112,76805,620,138,27,0x2b591e99afE9f32eAA6214f7B7629768c40Eeb39,0xDe265BC3cbbE62c8078F9512e906D509446350a0
7845,15627884,55920,8848810112,54976,944,138,0,0xAA3f6003d72FB579F29A91742cf3CefEa83CebBa,0xeDf8ccF2f842920A0C52F648167C6ecdF72edFAF
7846,15627884,71709,8848810112,69513,2196,458,172,0x74312363e45DCaBA76c59ec49a7Aa8A65a67EeD3,0x393f6C5Abb4FDF73cf467FA4383010D59d62dDfC
7847,15627884,21000,8848810112,21000,0,2,3610,0x22DbF32CCAE873EaBa60AbEe744ce7269b9c9ddb,0x9308c261Dc19178a8b81C07b80CaaDe0fF057f6e
7848,15627884,98535,8848810112,91255,7280,1098,117,0x2153572802f6bbE6a44A39D565e1715c60a85dD4,0x6EFa0B1bF00d4CFb31a2d883a337A9a521926C81
7849,15627884,21000,8848810112,21000,0,2,530,0xC997F554935231ca1B36d7B6c60E9474Ec5441FB,0xab76E25ec072A160072C8Bca781Ee7BDF9aE35c7
7850,15627884,260194,8848810112,256954,3240,1034,144,0x68b3465833fb72A70ecDF485E0e4C7bD8665Fc45,0x818e05F1e9Bc6bDEC285D20374e60A05F9E5301b
7851,15627884,21000,8848810112,21000,0,2,171,0xB6cEDCE5c9FB9f2D60ccEca034BC12eaA09A47d0,0xcE64da4caf4c7D5A65c74Fbacb16E170d300285d
7852,15627884,258928,8848810112,258596,332,138,16,0x09f717f77B5e7f2D2F37604fEC3D0e3D53eB9808,0x807Ee19a94429c81D483544a9bb4A1Afd5bc36b9
7853,15627884,46267,8848810112,45691,576,74,50,0x283Af0B28c62C092C9727F1Ee09c02CA627EB7F5,0x30628B81bc8439549c5AbBB27D02b828b1EA93A4
7854,15627884,98983,8848810112,98031,952,202,21,0x0322F6f11A94CFB1b5B6E95E059d8DEB2bf17D6A,0x407b5D55A95c63462d9fdC233e4924A189482637
7855,15627884,55897,8848810112,54953,944,138,37,0x6c5A9466A8a5ED51584f6B4ad652e21AB5E7ee0E,0x6ECE6261bED04238050Cd8677C8E8c7Ad884a9be
7856,15627884,292877,8848810112,290421,2456,522,26,0x283Af0B28c62C092C9727F1Ee09c02CA627EB7F5,0xDF960d01035aB6d705Bd9ac25B63a75fAA2D632d
7857,15627884,219598,8848810112,217766,1832,522,105,0x000000000000509081d6FCD3ee63e791aD1db763,0xD4142730f3e5640C129DB5E206Fd990B53aBFC30
7858,15627884,164498,8848810112,157934,6564,1802,40,0x00000000006c3852cbEf3e08E8dF289169EdE581,0x450423ddFf2125B52EC524c8ec35B46552054aBc
7859,15627884,244796,8848810112,242024,2772,842,3367,0x68b3465833fb72A70ecDF485E0e4C7bD8665Fc45,0x7Db1411Ec334C5e4DCB9433d2E477E82a0229504
7860,15627884,46091,8848810112,45603,488,138,937,0x582b874Af6A8D0eC283febE1988fb4A67c06e050,0x71352eFbb7dF61ba553E9010700cDFc467d39B1E
7861,15627884,740000,8848810112,729208,10792,2506,91584,0x33CCa8E7420114dB103d61bd39A72ff65E46352D,0xc74cE67BfC623c803D48AFc74a09A6FF6b599003
7862,15627884,157481,8848810112,155609,1872,842,528,0x7239F01C663f3c9fD7A44cB2BC8d19B67bdD1336,0xa8771fD60920f165Fb4E4CFCA2Cb1ab055f9ED53
7863,15627884,46135,8848810112,45647,488,138,52,0x1Fa8559e873f698292766790AeCf8080A66433F6,0x0454900e986d86Fc5b66C2441B6Ea65DACeA5E36
7864,15627884,61435,8848810112,53271,8164,2506,25,0x00000000006c3852cbEf3e08E8dF289169EdE581,0x3d1D2d77ad6AdC17587Cc76DE82E7E1C46BBb84E
7865,15627884,305914,8848810112,298938,6976,970,31,0x9b3B6974531d8AA15A87908FFd821A64863Ede5B,0x148357d603BfD802ea7A9Cc1f7708Abe584575Fd
7866,15627884,21000,8848810112,21000,0,2,752,0xEc591621e67e43f8E5988169b786264C0C089BCB,0x7b1437fE59e68267839844bF09Cc06f88750e893
7867,15627884,94813,8848810112,94205,608,138,4948,0xdAC17F958D2ee523a2206206994597C13D831ec7,0x238F24101876377E9178d125D0747DE7fad9C3b2
7868,15627884,71729,8848810112,69533,2196,458,2607,0x74312363e45DCaBA76c59ec49a7Aa8A65a67EeD3,0xd5FfcabF2bA93b4C30698b0398dfbf1af3163A61
7869,15627884,46091,8848810112,45603,488,138,383,0x177EF8787CEb5D4596b6f011df08C86eb84380dC,0x5Db71204C7D9a9a23359676aE159eD28D2fF4523
7870,15627884,841205,8848810112,774469,66736,23122,23,0x00000000006c3852cbEf3e08E8dF289169EdE581,0x17971C2A552dd61f3a4103E6fcD39923dD57FF39
7871,15627884,182124,8848810112,180028,2096,522,60,0xd9e1cE17f2641f24aE83637ab66a2cca9C378B9F,0xC42C084C273b46C7232f73fCdcEF099fe09c0b07
7872,15627884,240782,8848810112,234838,5944,1738,740,0x68b3465833fb72A70ecDF485E0e4C7bD8665Fc45,0xB23a91638BF4E9Ba88AcB1BeA4F81a569a1fcd4c
7873,15627884,51688,8848810112,51080,608,138,49,0x467719aD09025FcC6cF6F8311755809d45a5E5f3,0x3AC375e1f05bc2d6F11eE7dA179F2e15aEA69D64
7874,15627884,67544,8848810112,66068,1476,458,98,0x5BABc381C7E9EdCF02654a9C30d384dFE54dd4A1,0x066DC123977849dF818ed709B375E73123E45179
7875,15627884,183249,8848810112,179621,3628,1162,222,0x68b3465833fb72A70ecDF485E0e4C7bD8665Fc45,0xceB7Bc1098138e850195698F4Ff2726031CDe545
7876,15627884,21000,8848810112,21000,0,2,7,0x8324C552b00767AB081547a848Ac86998C9Da454,0x6eF314FE7C08Cb78D58Df1995dE6CdF2060435F9
7877,15627884,43184,8848810112,42040,1144,394,99,0x9beC8252AC5ea0D3040f0Df876e8F2558F9Da43e,0x7Aa96077eB5c3DE1c061ca20fa1920A8562097f7
7878,15627884,201673,8848810112,199873,1800,458,227,0x7a250d5630B4cF539739dF2C5dAcb4c659F2488D,0x839DD8E20c9ccE759B393607D00F64e954f9D566
7879,15627884,60412,8848810112,59816,596,138,2847,0xA0b86991c6218b36c1d19D4a2e9Eb0cE3606eB48,0x8B3f14F0582FbF275BE87d265C931B4dfD5F13B7
7880,15627884,326044,8848810112,323660,2384,906,18,0xC36442b4a4522E871399CD717aBDD847Ab11FE88,0x18bD1d8e0bcC62E4E7066871d9116BD47A338DF5
7881,15627884,500000,8848810112,497340,2660,714,3304,0x3db76cc3673FeF9b454562DF53188Ac3147826f8,0x5ACaf7C064F609c1ac40648F200d1160cB3b054f
7882,15627884,150389,8848810112,149985,404,138,150,0xa7D8C4bc2bbE20ff6272f52C1917b8A91B4518CA,0x89D6910f30673ad41c04C112D764D04105Ffd1c5
7883,15627884,46016,8848810112,45528,488,138,34,0x495f947276749Ce646f68AC8c248420045cb7b5e,0xB2362053e77ceb3bFE79a0EF12959E847AB7415a
7884,15627884,291905,8848810112,289473,2432,522,206,0x283Af0B28c62C092C9727F1Ee09c02CA627EB7F5,0xF29a9321e238A1df5E076b2C9992266b4BB46878
7885,15627884,129290,8848810112,128706,584,138,89,0x0E1A0c04EBe94cF43478aaBc7E25f82CEddF67aC,0xEBa323032bc3AE61Ac19DFF2928DE2A4E8aB44F7
7886,15627884,21000,8848810112,21000,0,2,1,0x9F109A85eC8f181F7a0471833050D63489c93A47,0xC94daCcF7aCcF270b138c8543046A818dBb9EA3c
7887,15627884,181476,8348810112,179912,1564,394,3419,0x1Fa8559e873f698292766790AeCf8080A66433F6,0x2a5Ac02BCb01A44C661129625355EF91D608A29b
7888,15627884,181476,8348810112,179912,1564,394,348,0x1Fa8559e873f698292766790AeCf8080A66433F6,0x897cF7f58557Be7Da2a501d158893D8B5Fe8E6A6
7889,15627884,181458,8348810112,179906,1552,394,35,0x1Fa8559e873f698292766790AeCf8080A66433F6,0xF2877832AE2ddbb90E5E337776921f00af79419e
7890,15627884,181476,8348810112,179912,1564,394,513,0x1Fa8559e873f698292766790AeCf8080A66433F6,0x84Efad6B760e39d0B8a023C5cb18C6ae7aa05F27
7891,15627884,144555,8348810112,144351,204,74,742,0x4556561740B7B5F858967A6a4E54e506609704Bd,0xB51F6d20fDa35b2F7e4188D755c6CB6833D498bA
7892,15627884,146073,8348810112,145133,940,202,215,0x60E4d786628Fea6478F785A6d7e704777c86a7c6,0xa723BCC05F4E0F739D572E7FdFf0b23AF977A8f7
7893,15627884,181476,8348810112,179912,1564,394,4162,0x1Fa8559e873f698292766790AeCf8080A66433F6,0x5cABF9593dC0d2b837a885e37428390165f086A3
7894,15627884,73975,8348810112,73063,912,266,5,0x011b0beAe3eC5953B4805b064cC78f6F892A99cC,0x7D35286C7d6864Cf6A61b4EC90F3d2FB6F8C7935
7895,15627884,122446,8348810112,120882,1564,394,374,0x1Fa8559e873f698292766790AeCf8080A66433F6,0x998B25538486e05F863D29061Cc95554DeAE3AEa
7896,15627884,181476,8348810112,179912,1564,394,361,0x1Fa8559e873f698292766790AeCf8080A66433F6,0x8801fB5Aa9dAc70F9A6dBDE31DA50821EdEE71Be
7897,15627884,181476,8348810112,179912,1564,394,6,0x1Fa8559e873f698292766790AeCf8080A66433F6,0xB970f60495B36Ac66c06f9b01e3b1520c2a2Fcd7
7898,15627884,250000,8348810112,250000,0,2,45337128,0x7BAf9df196C05b8f413A24eD77B965ca6F3caAdd,0xEA674fdDe714fd979de3EdF0F56AA9716B898ec8
7899,15627884,250000,8348810112,250000,0,2,45337129,0xB47559b1C290c60c8ABd06CFC14945c81FcaB2AD,0xEA674fdDe714fd979de3EdF0F56AA9716B898ec8
7900,15627884,250000,8348810112,250000,0,2,45337130,0xD71ce56A6A3cE0b28b6Bc9289517CAB120DC5aa1,0xEA674fdDe714fd979de3EdF0F56AA9716B898ec8
7901,15627884,250000,8348810112,250000,0,2,45337131,0x115d69615603227Ce6dC447B10057ca987382c36,0xEA674fdDe714fd979de3EdF0F56AA9716B898ec8
7902,15627884,250000,8348810112,250000,0,2,45337132,0x808612f4CcC2CF499E61B42cB20390B7A7afB9C0,0xEA674fdDe714fd979de3EdF0F56AA9716B898ec8
7903,15627884,250000,8348810112,250000,0,2,45337133,0x3Eb20A102956D4aE5293AC27808Deff4dd323534,0xEA674fdDe714fd979de3EdF0F56AA9716B898ec8
7904,15627884,250000,8348810112,250000,0,2,45337134,0x1553C63Ea8D94b78De3edDD12caf113Bc4f84499,0xEA674fdDe714fd979de3EdF0F56AA9716B898ec8
7905,15627884,250000,8348810112,250000,0,2,45337135,0x6774B34Ed33ACb9C3D5519569E79a2C9D6ab98aF,0xEA674fdDe714fd979de3EdF0F56AA9716B898ec8
7906,15627884,250000,8348810112,250000,0,2,45337136,0x469b6fA77E97B360F22d9644EFD867D9f76aa781,0xEA674fdDe714fd979de3EdF0F56AA9716B898ec8
7907,15627884,250000,8348810112,250000,0,2,45337137,0x0191eE8C4Aff8b9D717C57f0d2F8c80A210aF3F2,0xEA674fdDe714fd979de3EdF0F56AA9716B898ec8
7908,15627884,181476,8348810112,179912,1564,394,581,0x1Fa8559e873f698292766790AeCf8080A66433F6,0x78934B033aF482f359501C9fcf183C4432DbE6Ac
7909,15627884,181458,8348810112,179906,1552,394,1067,0x1Fa8559e873f698292766790AeCf8080A66433F6,0xd95985e7BfD294B0D7FEb30f41EaBCC3d6454334
7910,15627884,3305335,8348810112,3303735,1600,394,2,0x7a250d5630B4cF539739dF2C5dAcb4c659F2488D,0xEbEdB72D69A11a38F932bF6Fdd5E2F3097CD559D
7911,15627884,175110,8348810112,173546,1564,394,864,0x1Fa8559e873f698292766790AeCf8080A66433F6,0x4EbE5b991E708003362fF4A0425fC48edc9709D4
7912,15627884,4000000,8348810112,3996852,3148,970,1622,0x246a0A45cb00E1068095Bf6450f1b062e66c8781,0x141E9CE84cCC523a398C1a668Ca4Bc91c6Df98F5
7913,15627884,360576,8348810112,358680,1896,458,15,0x7a250d5630B4cF539739dF2C5dAcb4c659F2488D,0x0cB5B5C356FcE965b26683E0B3854a6f098108aC
7914,15627884,21000,8348810112,21000,0,2,24278,0x45f3A446fa24006314488D66da064B967B471fFd,0xeA3d9B4743e20CE41777149A16e4eC97185d1487
7915,15627884,181458,8348810112,179906,1552,394,2078,0x1Fa8559e873f698292766790AeCf8080A66433F6,0xF34367da98d58Fb4981f97daB901f9512C7aCfcf
7916,15627884,181476,8348810112,179912,1564,394,75,0x1Fa8559e873f698292766790AeCf8080A66433F6,0x356bA80b538f83556dD49c8506fc16d6DB0F24A6
7917,15627884,181476,8348810112,179912,1564,394,487,0x1Fa8559e873f698292766790AeCf8080A66433F6,0xf0139b911A5A3d113DDB5F71418F8572EaCdE5eA
7918,15627884,143796,8348810112,143592,204,74,458,0x7F9306FC1978938d5C1C57Bf6044dc67E07eeB8a,0xeCcfC341614d93885B6E73E8ae8F63432D9FDB38
7919,15627884,21000,8305963087,21000,0,2,0,0xBb3fd383d1C5540E52EF0A7bcb9433375793aEAF,0x4fB46Af158d2d0d99A952F42Ce6a161E3Fdc3CC4
7920,15627884,400414,8000000000,396242,4172,1290,845,0xC36442b4a4522E871399CD717aBDD847Ab11FE88,0xEc890FCa5C79a443f53849bc658947a99B653A4c
7921,15627884,222222,8000000000,220658,1564,394,150,0x1Fa8559e873f698292766790AeCf8080A66433F6,0xB2EF468dD726AcEb993e4d618637686B1d4dACA2
7922,15627884,547083,7618745156,546879,204,74,1511,0x9a627ea5F1B8a5955A5Fd015de6A28b0e4320271,0x50D16a5B9DCfBae27367733388B6e82BC18240Dc
7923,15627884,21000,7618745156,21000,0,2,80,0x4103c267Fba03A1Df4fe84Bc28092d629Fa3f422,0x66775e93493162c5Ff023477a3d4899be12F194b
7924,15627884,191077,7618745156,190177,900,266,89,0xd588b586D61C826A0e87919b3D1a239206d58bf2,0x710E29C9c3bD8904Eb3d993b05E1bE418Bc715aa
7925,15627884,217636,7601246464,217004,632,138,1,0x5A98FcBEA516Cf06857215779Fd812CA3beF1B32,0xc7cba090E88d2DD8B6F00eF075c339ed12797bED
7926,15627884,272515,7601246464,268887,3628,1162,51,0x68b3465833fb72A70ecDF485E0e4C7bD8665Fc45,0x5fE50e298Ab5e216a5F473424EdE56Ae48790a0B
7927,15627884,50997,7601246464,50793,204,74,219,0x3CB6325f22E48a346E2Fa3C383BC89Cb41b82480,0x77cAe6d443546d79F3AC79Fe454A4C00A135a35c
7928,15627884,68852,7601246464,68528,324,74,3,0xB4a81261b16b92af0B9F7C4a83f1E885132D81e4,0xE7824aB41a68b79207Ff5ddCd11Aa7908A3aF963
7929,15627884,150756,7591380338,150692,64,10,2,0x65c2e54a4c75ff6da7b6B32369c1677250075fb2,0x895c08E90AA7FBc59341660B45930162c44dC4b2
7930,15627884,30000,7348810112,30000,0,2,1755,0x388C818CA8B9251b393131C08a736A67ccB19297,0x199D5ED7F45F4eE35960cF22EAde2076e95B253F
7931,15627885,800000,20491855619,799056,944,138,1623,0x892ED660Ba89BEAb93E35dF7fFa909048c3bB115,0x141E9CE84cCC523a398C1a668Ca4Bc91c6Df98F5
7932,15627885,50596,14340000000,49988,608,138,1,0xdAC17F958D2ee523a2206206994597C13D831ec7,0xbd9597f74eB052Fa934C877f8C5e42dB1e40fd00
7933,15627885,82271,12020703300,81675,596,138,0,0x467719aD09025FcC6cF6F8311755809d45a5E5f3,0x7F5F9C1c1627ac37E50dB34f4Ed6a484fd1B861c
7934,15627885,350000,10995947049,350000,0,2,6925061,0xd28Ff6DD7d851371162489EC9B031B8DC0949F74,0x46340b20830761efd32832A74d7169B29FEB9758
7935,15627885,350000,10995947049,350000,0,2,6925062,0x5123fB0593F9dCdBeB609B827bBF908B6A362153,0x46340b20830761efd32832A74d7169B29FEB9758
7936,15627885,181476,10491855619,179912,1564,394,287,0x1Fa8559e873f698292766790AeCf8080A66433F6,0xf817c0Bdf525940E572014E79eaC92fcE8C8706d
7937,15627885,31582,10491855619,31582,0,2,2,0xFDBf91A7F2d757A9815326af5E1e60319571984c,0x9A4140FFB57D5272ea009c37a18D2A88B54e6063
7938,15627885,305935,9991855619,298935,7000,970,305,0x9b3B6974531d8AA15A87908FFd821A64863Ede5B,0x6aD006e86F2D23152f89E3581E02aA5fC9589c6A
7939,15627885,87354,9877013500,86686,668,138,826,0x22987407FD1fC5A971e3FDA3B3e74C88666cDa91,0xBe83E7Db6C6fb4F5DB4F22294FAF3868Ca443F2B
7940,15627885,82271,9877013500,81663,608,138,827,0x467719aD09025FcC6cF6F8311755809d45a5E5f3,0xBe83E7Db6C6fb4F5DB4F22294FAF3868Ca443F2B
7941,15627885,50000,9860151518,50000,0,2,1210292,0x9742b10e5D5B24f6c11476Bf24380D4Cdc6aE0Ed,0x912fD21d7a69678227fE6d08C64222Db41477bA0
7942,15627885,181476,9618745156,179912,1564,394,7029,0x1Fa8559e873f698292766790AeCf8080A66433F6,0xe749e9E7EAa02203c925A036226AF80e2c79403E
7943,15627885,181476,9618745156,179912,1564,394,7030,0x1Fa8559e873f698292766790AeCf8080A66433F6,0xe749e9E7EAa02203c925A036226AF80e2c79403E
7944,15627885,70000,9491855619,69392,608,138,537,0xdAC17F958D2ee523a2206206994597C13D831ec7,0xf5491f793D47A6Ea22f5e0B9AD3990CF66c4b40B
7945,15627885,21000,9491855619,21000,0,2,6031,0xAd4f7eB835B02E371Ef6CC5152C71Cf8b62928B5,0x65768f7e9448595181271a0Af9A2351D383ace1a
7946,15627885,207128,9491855619,207128,0,2,4468959,0x17A946d90C34882444E669AF60d83D7A94c7f520,0x21a31Ee1afC51d94C2eFcCAa2092aD1028285549
7947,15627885,207128,9491855619,206520,608,138,4708711,0xdAC17F958D2ee523a2206206994597C13D831ec7,0x28C6c06298d514Db089934071355E5743bf21d60
7948,15627885,207128,9491855619,206472,656,138,4232345,0x6B175474E89094C44Da98b954EedeAC495271d0F,0xDFd5293D8e347dFe59E90eFd55b2956a1343963d
7949,15627885,207128,9491855619,207128,0,2,3199178,0xbac95cbeCe17e509a5018D6A0F59b159Fd741fAB,0x9696f59E4d72E237BE84fFD425DCaD154Bf96976
7950,15627885,207128,9491855619,207128,0,2,1679532,0xd9b2392b8A72ED60421AE29aA254937c88eeBFc6,0x4976A4A02f38326660D17bf34b431dC6e2eb2327
7951,15627885,162136,9491855619,160496,1640,402,14138,0x1111111254fb6c44bAC0beD2854e76F90643097d,0xD54e4f8A55247487dd7C8c59f14EE5c0c2889477
7952,15627885,21000,9491855619,21000,0,2,51,0x48F7E694112687716cDeade90b83f6890ef1EBBD,0x0708830FC5270b37f2814ca6D7878acE6C4a7579
7953,15627885,210208,9491855619,207460,2748,842,808,0x68b3465833fb72A70ecDF485E0e4C7bD8665Fc45,0x756c7FA1c53b29a56af0A2318C52892a8c671cFc
7954,15627885,42000,9491855619,42000,0,2,329545,0xfE84BB9Fc8003027B6B719C199feF3C89Bb84592,0x9430801EBAf509Ad49202aaBC5F5Bc6fd8A3dAf8
7955,15627885,21000,9491855619,21000,0,2,324,0xa3F5B86b24359F4CCfB3710C56e7880eb166bc18,0xBb0Af8fB13473b81C2B6fE1503A0f70207231717
7956,15627885,21000,9491855619,21000,0,2,253,0xd0d34Fc132cFf5087925004575aF6a17b513956C,0xB3f6657C46AD806B4f5095c8d6A0566a8B156F7D
7957,15627885,21000,9491855619,21000,0,2,3,0xf89d7b9c864f589bbF53a82105107622B35EaA40,0x5F03f753021b039aB8980E6bF6C04a5bbe2Db247
7958,15627885,39603,9491855619,39351,252,74,1181,0xC02aaA39b223FE8D0A0e5C4F27eAD9083C756Cc2,0x63ba8A22cF15BFB1331Ad4eE59fb9169411a5666
7959,15627885,200000,9000000000,199392,608,138,4,0xdAC17F958D2ee523a2206206994597C13D831ec7,0xEfa0Bc310159D6741e93e383e69e2178fd7526f6
7960,15627885,50000,9000000000,50000,0,2,449980,0xa12e1462d0ceD572f396F58B6E2D03894cD7C8a4,0x077D360f11D220E4d5D831430c81C26c9be7C4A4
7961,15627885,50000,8998126677,50000,0,2,464125,0x6fC138aB996cb01Ec4504b0A5cbC4c4f48E4AED4,0x3B794929566e3Ba0f25e4263e1987828b5c87161
7962,15627885,21000,8992855619,21000,0,2,113055,0xC74d2a1bb179a10FC52DdB1d97b611D7eC324116,0x6081258689a75d253d87cE902A8de3887239Fe80
7963,15627885,46157,8991855619,45669,488,138,1,0xEb4e856F69158052aC0AaF7Dc26f63DCb1ee067F,0x819490Ea90de7CD7030aA61724c9b35C7c1bfFd0
7964,15627885,81706,8991855619,79930,1776,458,110,0xFbdDaDD80fe7bda00B901FbAf73803F2238Ae655,0x17c852867106C351516D4ccC2bd5810D49B224B2
7965,15627885,205669,8991855619,194117,11552,3594,923,0x74312363e45DCaBA76c59ec49a7Aa8A65a67EeD3,0xc0592a97737faAE28575EB7181947DD528027CE6
7966,15627885,248900,8991855619,246140,2760,842,212,0x68b3465833fb72A70ecDF485E0e4C7bD8665Fc45,0x25991B064289F1341b0eEDCF536f3688100c3790
7967,15627885,69109,8991855619,68157,952,202,612,0x6b123105e9a4c56f1Ee2eB012Bda74664ec63515,0x543874CeA651a5Dd4CDF88B2Ed9B92aF57b8507E
7968,15627885,48830,8991855619,48346,484,202,2608,0x59728544B08AB483533076417FbBB2fD0B17CE3a,0xd5FfcabF2bA93b4C30698b0398dfbf1af3163A61
7969,15627885,21000,8991855619,21000,0,2,2,0xB9A0680AC675DA2505030dd8C65A8AD6D708aEbE,0x3495a90E0eDf4Ca21522e13B3143631E26A4Ff2f
7970,15627885,56659,8991855619,55715,944,138,121,0xAD13C2a8d418d01F3236F4d8b9d724575a4e9d24,0x1DCcF2f39cf7Afc76e74068C8d954e7F79e2b101
7971,15627885,56659,8991855619,55715,944,138,741,0x9431DE2DFE10BDB30995bd3791dE03a6c9570054,0x6B7B6eD83064FBA3cdd3cB05585f2Cad80dF6719
7972,15627885,158502,8991855619,151370,7132,1930,246,0x00000000006c3852cbEf3e08E8dF289169EdE581,0xd4b4FDa41B6c3B45e5c60DB35FE3ACC9e49CDB73
7973,15627885,21000,8991855619,21000,0,2,1140,0x85023786bFA1541Fb09ac51eFa32B0C2e00910a5,0xbA4F13f545022a4772E1F0fd2c00E25EC37cF667
7974,15627885,290791,8991855619,288335,2456,522,3814,0x283Af0B28c62C092C9727F1Ee09c02CA627EB7F5,0xe519e5EB81F92bF19EcFc7e5d9c6418CD8c2E0B9
7975,15627885,194092,8991855619,187492,6600,1802,175,0x00000000006c3852cbEf3e08E8dF289169EdE581,0x3Ad5438542915E03ED6319945e8aCEca5b00D443
7976,15627885,187959,8991855619,184367,3592,1162,115,0x68b3465833fb72A70ecDF485E0e4C7bD8665Fc45,0x170ed1Df57F67cf4BA0699f9b77D241F863EF1Bb
7977,15627885,109267,8991855619,108303,964,202,11,0x1B829B926a14634d36625e60165c0770C09D02b2,0xE90f765CFCf115d31801E13729C7197A4Ec3B1D8
7978,15627885,49175,8991855619,48687,488,138,559,0xAC126d5b28852d4392772C07e2C35CDF19571e05,0x6b1Fd5D876771b764D0131746dF48C1054e37f73
7979,15627885,49175,8991855619,48687,488,138,239,0xD27dcbcC8778a8AB33AAc529Df36a634567Be325,0x7112341136A10e86076261161899D7A8a8929f6B
7980,15627885,227614,8991855619,220950,6664,1810,82,0x00000000006c3852cbEf3e08E8dF289169EdE581,0x33A268df715445F21156E35d57f7f8D2e2cA5d2a
7981,15627885,46616,8991855619,46128,488,138,45,0xee12d8b18BAEbE40a2017D7D2E8Fb2c76D1C62A3,0x7168a6639e40Cc02365E7AdA47Cd755613bAAe8e
7982,15627885,51598,8991855619,51026,572,138,106,0x5461cBe7b1042c54ED382D1356d7C4e0b43FA281,0x8fbA5aB2384D19420CEB800C16757e41EB908e61
7983,15627885,73188,8991855619,72580,608,138,183,0xA0b86991c6218b36c1d19D4a2e9Eb0cE3606eB48,0xC2606254E1c3bD456B19650c9488F031823a8c77
7984,15627885,181476,8991855619,179912,1564,394,35,0x1Fa8559e873f698292766790AeCf8080A66433F6,0xc7D72D2Ae52517dE8B3291f6F1Dc3276547F49A3
7985,15627885,46091,8991855619,45603,488,138,68,0xE106C63E655dF0E300b78336af587F300Cff9e76,0xB639C32e88867cA4D392d1b93082150eBB800dE6
7986,15627885,150756,8991855619,150692,64,10,29,0x65c2e54a4c75ff6da7b6B32369c1677250075fb2,0x5E356DFECD37623C23077AD9E4ebf05218183400
7987,15627885,127866,8991855619,127262,604,202,61,0x084b1c3C81545d370f3634392De611CaaBFf8148,0x16869FdB8AdaD248330EBF7a1F19859Cecb491bE
7988,15627885,535062,8991855619,531922,3140,906,24,0x68b3465833fb72A70ecDF485E0e4C7bD8665Fc45,0xB715cdB77806d154D4cEf39B7374f98054Bcc298
7989,15627885,77422,8991855619,76766,656,138,89,0xBBbbCA6A901c926F240b89EacB641d8Aec7AEafD,0x7Ca5C042cc1BE602e48b24480c3aFC382727e96A
7990,15627885,181458,8991855619,179906,1552,394,1648,0x1Fa8559e873f698292766790AeCf8080A66433F6,0x1c1D70f561929941496180003ea21d23BaD53535
7991,15627885,78088,8991855619,74624,3464,906,1666,0xDB631859E06fBC6604E86F592f6B8c416425b5d5,0x6C5c05300d35CA4c7bBCC8b53227ed8Ade03695f
7992,15627885,405246,8991855619,401642,3604,1162,1418,0x68b3465833fb72A70ecDF485E0e4C7bD8665Fc45,0xAB8833021C6359C3949CC488AA0F0C9e832d3446
7993,15627885,60775,8991855619,53271,7504,2506,2609,0x00000000006c3852cbEf3e08E8dF289169EdE581,0xd5FfcabF2bA93b4C30698b0398dfbf1af3163A61
7994,15627885,60727,8991855619,53271,7456,2506,22,0x00000000006c3852cbEf3e08E8dF289169EdE581,0x262cd75Ef4f983a10d2CCCFFdE8b634CF6cd8B8c
7995,15627885,46189,8991855619,45617,572,138,1270,0x28AaF29992B43e093A7D883c7427bd1fF4a6665b,0x7c03C6FC64293c460bE652F4015aD232E695aC8e
7996,15627885,46187,8991855619,45615,572,138,1037,0x34Bc797F40Df0445c8429d485232874B15561728,0x970b52Bf8964934E721f655325cc946e4901bE6b
7997,15627885,857109,8991855619,846477,10632,3338,384,0x0000000000c2d145a2526bD8C716263bFeBe1A72,0x5Db71204C7D9a9a23359676aE159eD28D2fF4523
7998,15627885,60390,8991855619,59446,944,138,20,0x3E04863DBa602713Bb5d0edbf7DB7C3A9A2B6027,0x1E759C0af530cc66D0E0283Aa0748a79Dc9228DF
7999,15627885,21000,8991855619,21000,0,2,13,0x2Ff8F5d474a00E8093de8D327EaB51A935cbA3E6,0x322894875e5439d19e273aE180E89eE1838730fb
8000,15627885,52529,8991855619,51685,844,202,490,0x000000000000509081d6FCD3ee63e791aD1db763,0x2BE70B7789C51979E98112B32A554b93A213dbe4
8001,15627885,21000,8991855619,21000,0,2,470,0xbe1E5e1f2dc683F564fFFb8809E1Cb9f79e61da0,0x8318777F8b8A1e81243Abb5e58B3483D2138F257
8002,15627885,97756,8991855619,96528,1228,394,334,0x710515Bf543fDb6834144F9269BBf0D1d32B1702,0x0bA744604dbBD3FE3f99912b9aCd6F39528Bcd88
8003,15627885,139466,8991855619,138654,812,330,240,0xFcf4c1bdEe152542396C89b7c22ACC529A79FdE7,0xd8fd0ae6076B3D643543B7C7D386d5425bb48284
8004,15627885,470877,8991855619,457929,12948,4106,35,0x0000000000c2d145a2526bD8C716263bFeBe1A72,0xB2362053e77ceb3bFE79a0EF12959E847AB7415a
8005,15627885,34454,8991855619,34454,0,2,60,0x52ec2F3d7C5977A8E558C8D9C6000B615098E8fC,0x7E9f0b4F5b2EFB71a4e8c28fEBAb563b9317b5F9
8006,15627885,142362,8491855619,142158,204,74,94,0xC549d87E9CEA28961927436a2B7D6944f7CA86eb,0x9b1610Fb681886A9164022656df7631a99e970Df
8007,15627885,181476,8491855619,179912,1564,394,836,0x1Fa8559e873f698292766790AeCf8080A66433F6,0x93D16DA7869906D079fe9B96172A96b913F3c9B8
8008,15627885,181476,8491855619,179912,1564,394,480,0x1Fa8559e873f698292766790AeCf8080A66433F6,0xd7559218B59b774Df59679c0da26662dB6B5A0d6
8009,15627885,181476,8491855619,179912,1564,394,1107,0x1Fa8559e873f698292766790AeCf8080A66433F6,0x7Db5c1EFCEbE4ce04af24D3B9Ec2FFD528cF2493
8010,15627885,181476,8491855619,179912,1564,394,341,0x1Fa8559e873f698292766790AeCf8080A66433F6,0xDD83023763f0808067bEFB0f5fBE1f02875ecb18
8011,15627885,181476,8491855619,179912,1564,394,45,0x1Fa8559e873f698292766790AeCf8080A66433F6,0x10725d5a7eD9EdA92e5a49D6be78026d5dF01e67
8012,15627885,181476,8491855619,179912,1564,394,25,0x1Fa8559e873f698292766790AeCf8080A66433F6,0xE4cC4534D807f84fb8ebfBeb0D44D64d5B9734c1
8013,15627885,181476,8491855619,179912,1564,394,10,0x1Fa8559e873f698292766790AeCf8080A66433F6,0xAdB67872bA774430616caC315e977AB71aC0269B
8014,15627885,181476,8491855619,179912,1564,394,40,0x1Fa8559e873f698292766790AeCf8080A66433F6,0x7fa18C2E2070688e7031219d55a258cc5ae68C07
8015,15627885,21000,8491855619,21000,0,2,173,0xE77D7b909972e1862c56E51f80F40B9eC908705d,0xeDE4794bDB3FaeF8E23Cdf68B9799AA844D1c1B5
8016,15627885,181476,8491855619,179912,1564,394,31,0x1Fa8559e873f698292766790AeCf8080A66433F6,0x9023CcbbCd649dEB9ABA69CF394C599DF567E413
8017,15627885,181458,8491855619,179906,1552,394,460,0x1Fa8559e873f698292766790AeCf8080A66433F6,0x702f99334E19c045a35Ca22F2274EC49Ca002d94
8018,15627885,181476,8491855619,179912,1564,394,21,0x1Fa8559e873f698292766790AeCf8080A66433F6,0x672899752EECCaEAef5136a934b261D604f95D80
8019,15627885,181476,8491855619,179912,1564,394,255,0x1Fa8559e873f698292766790AeCf8080A66433F6,0x6A07A4A558AAB37bcf1eE7D8e9A3885018275a12
8020,15627885,59056,8491855619,58092,964,394,2359,0x645E9324f4be25be581BB62163cfa86c40b01D07,0xc5009AFEd2D6DA219538aD165998F63B553185B1
8021,15627885,175110,8382823331,173546,1564,394,584,0x1Fa8559e873f698292766790AeCf8080A66433F6,0xbe358587cCFae29891022C66A13F8a9868cd4CC7
8022,15627885,2000000,8343205131,1997928,2072,522,411,0x7a250d5630B4cF539739dF2C5dAcb4c659F2488D,0xC598DE2944734AF41EeB92dFD24Aac8803aDca0E
8023,15627885,110000,8343205130,109320,680,138,862751,0xE9976C94aba11779Afe675BC261B027815d2e17d,0xA910f92ACdAf488fa6eF02174fb86208Ad7722ba
8024,15627885,56686,8000000000,55742,944,138,97,0x00C2999c8B2AdF4ABC835cc63209533973718eB1,0x6Ae5fE6c80FED74e73A2ed9Ee0F73fAaC2ea9b7E
8025,15627885,222222,8000000000,220658,1564,394,157,0x1Fa8559e873f698292766790AeCf8080A66433F6,0xB86685FB98e4907D20d7CF4166AAB2ef842F683F
8026,15627885,21000,7963968533,21000,0,2,0,0x8EB871bbB6F754a04bCa23881A7D25A30aAD3f23,0xAA9A5d35F748A5fc2Bc89653fCe12aaf331c6eF2
8027,15627885,69163,7744291971,68555,608,138,8,0xdAC17F958D2ee523a2206206994597C13D831ec7,0xccc261146D4Cf1DcE3D9A25de215A72E8C6bc606
8028,15627885,173743,7727777444,172803,940,202,7789,0x1De7abDa2D73a01AA8DcA505bDCb773841211Daf,0x8aE57A027c63fcA8070D1Bf38622321dE8004c67
8029,15627885,323431,7727777444,162051,161380,20386,183251,0x5E4e65926BA27467555EB562121fac00D24E9dD2,0x6887246668a3b87F54DeB3b94Ba47a6f63F32985
8030,15627885,142090,7685714081,137426,4664,1290,0,0x20F780A973856B93f63670377900C1d2a50a77c4,0x51Be9Fe668840894101c24c2Af819528fDE7d491
8031,15627885,193108,7685714081,186276,6832,1810,2,0x00000000006c3852cbEf3e08E8dF289169EdE581,0x527F0f06972a5dA75Cdf05E0bd4c7fF21444aAb4
8032,15627885,46267,7685714081,45691,576,74,362,0x283Af0B28c62C092C9727F1Ee09c02CA627EB7F5,0x023645715ea40e371c01Ff0118AEee075659Bc94
8033,15627885,80000,7584731937,79056,944,138,0,0x95aD61b0a150d79219dCF64E1E6Cc01f0B64C4cE,0xE0564ce2cC0C3b7669A22cFBC95cFd0A1DF2697a
8034,15627886,90000,34000000000,90000,0,2,129916,0x0C1fD0d021565acEa62Ff2A920CFE3e72B42661A,0xd4BDDf5E3D0435D7A6214A0B949C7BB58621F37C
8035,15627886,800000,20134971775,797988,2012,522,1624,0x7a250d5630B4cF539739dF2C5dAcb4c659F2488D,0x141E9CE84cCC523a398C1a668Ca4Bc91c6Df98F5
8036,15627886,5049368,17000000000,5042268,7100,1098,294,0x0a39DA505DfB5E0BBc6bd84428281A8ba1bC7753,0x495E889d1A6cEB447a57dcc1C68410299392380c
8037,15627886,100000,14340000000,99392,608,138,132645,0xdAC17F958D2ee523a2206206994597C13D831ec7,0x63A395B574D5E23C3dbC6986Be5994Ef6743aFA8
8038,15627886,21000,14000000000,21000,0,2,4,0x500A746c9a44f68Fe6AA86a92e7B3AF4F322Ae66,0x0b69117dba47C6b8C8Ddd50D1c7896B92c1150B5
8039,15627886,1500000,12134971775,1498000,2000,522,954,0x7a250d5630B4cF539739dF2C5dAcb4c659F2488D,0x47919F5C115358caBBb989b09DEB55520dEF2702
8040,15627886,181476,12000000000,179912,1564,394,2659,0x1Fa8559e873f698292766790AeCf8080A66433F6,0x23B2dB97a311F69e1caf7e684b4ca9Ca86f1eF22
8041,15627886,218747,11041264775,217183,1564,394,424,0x1Fa8559e873f698292766790AeCf8080A66433F6,0x72fc11394DD2b8ef44Dfb4A6AF9A6c25a62231e7
8042,15627886,111588,11000000000,109636,1952,330,8,0x00000000000C2E074eC69A0dFb2997BA6C7d2e1e,0x03cc71FBe5E1620f5a3D9aC2135642260ADC82bb
8043,15627886,63000,10863901030,63000,0,2,2710057,0xD0f9DA728E7d94A0A54aaFb06c675a2E20182f34,0xC098B2a3Aa256D2140208C3de6543aAEf5cd3A94
8044,15627886,66854,10863901030,65842,1012,202,355156,0x514910771AF9Ca656af840dff83E8264EcF986CA,0x7abE0cE388281d2aCF297Cb089caef3819b13448
8045,15627886,84522,10847843263,83486,1036,202,4709934,0x016ee7373248a80BDe1fD6bAA001311d233b3CFa,0x2FAF487A4414Fe77e2327F0bf4AE2a264a776AD2
8046,15627886,90912,10847843263,89968,944,138,0,0xA0b86991c6218b36c1d19D4a2e9Eb0cE3606eB48,0x92C47ec94e57daE44Cae11a465D72990e614eE33
8047,15627886,76548,10847843263,75512,1036,202,4709935,0x320623b8E4fF03373931769A31Fc52A4E78B5d70,0x2FAF487A4414Fe77e2327F0bf4AE2a264a776AD2
8048,15627886,76533,10847843263,75509,1024,202,4709936,0x320623b8E4fF03373931769A31Fc52A4E78B5d70,0x2FAF487A4414Fe77e2327F0bf4AE2a264a776AD2
8049,15627886,329058,9634971775,324714,4344,1034,145,0x197492CCB4B1acaAAcd43432657A17832E36AB49,0x81726771832d91C9BbA13CFc75Fd3621AAE0Fa9C
8050,15627886,21000,9620027188,21000,0,2,33,0x781aB9Ef63755dE1363C38e3Bad21E3627bD11a0,0x09170a84Ee8B955B387272982502b2672bDE2323
8051,15627886,186824,9561057061,184016,2808,842,0,0x68b3465833fb72A70ecDF485E0e4C7bD8665Fc45,0x9497F7B6942ad122c525D81047ee443cF55644E2
8052,15627886,192398,9427011775,190834,1564,394,1676,0x1Fa8559e873f698292766790AeCf8080A66433F6,0x3da3C61E6A3dea5BE524eAC96fa93BC5B1b30CDa
8053,15627886,55897,9184971775,54953,944,138,779,0x0148015047923173cc1a4bC384D5CcC8b8B21a9C,0xEF3bAF2AD803A5d9B1A4B4a719b7b2E1C1E2E2B9
8054,15627886,144000,9183971775,143392,608,138,17911,0xdAC17F958D2ee523a2206206994597C13D831ec7,0x7563758243A262E96880F178aeE7817DcF47Ab0f
8055,15627886,21000,9135971775,21000,0,2,196177,0xd1DBf8C7a8027Ff1aD8FbaD92dE7D571Bd6D71F6,0xd108FD0E8c8E71552a167E7a44FF1d345D233BA6
8056,15627886,21000,9134971775,21000,0,2,71,0x0119cdf5dDD2656eddEa8789330D6a8dBEeb6597,0x2087B0C07306A8dAB1BCae7D8608c52eE72A6F6a
8057,15627886,85000,9134971775,84512,488,138,137,0xD27dcbcC8778a8AB33AAc529Df36a634567Be325,0x2C64f4873907503Ebb45B7B5c3DF0de2Ca692477
8058,15627886,140088,9134971775,138524,1564,394,875,0x1Fa8559e873f698292766790AeCf8080A66433F6,0xFFBa913bB056544B75E57312EC3EAe2528C285e1
8059,15627886,70000,9134971775,69392,608,138,5,0xdAC17F958D2ee523a2206206994597C13D831ec7,0x52DC374df365575113099783bca59126A974725c
8060,15627886,140073,9134971775,138521,1552,394,463,0x1Fa8559e873f698292766790AeCf8080A66433F6,0xaA2d0029f54eE1a193F957757e77C3101CFd57bf
8061,15627886,42000,9134971775,42000,0,2,329546,0x38edc45730783195A35dD6f2693F3aF7391648F5,0x9430801EBAf509Ad49202aaBC5F5Bc6fd8A3dAf8
8062,15627886,100000,9134971775,99024,976,202,88941,0xdAC17F958D2ee523a2206206994597C13D831ec7,0x3018018c44338B9728d02be12d632C6691E020d1
8063,15627886,140088,9134971775,138524,1564,394,369,0x1Fa8559e873f698292766790AeCf8080A66433F6,0x8E48D9685a9Bc6E744F67A4b81a5df15D5772054
8064,15627886,314766,9134971775,313626,1140,266,2739,0x7d2768dE32b0b80b7a3454c06BdAc94A69DDc7A9,0x1777281a2b6610D40FF726C3e03BbdC3b93D31aD
8065,15627886,140073,9134971775,138521,1552,394,512,0x1Fa8559e873f698292766790AeCf8080A66433F6,0x18A9aF55771fe93AfBF4be235E868D6d194Db424
8066,15627886,244458,9134971775,240002,4456,1420,304,0x881D40237659C251811CEC9c364ef91dC08D300C,0x456bf5FE65c1168f47E64E26d96f93F86a6E8093
8067,15627886,140088,9134971775,138524,1564,394,353,0x1Fa8559e873f698292766790AeCf8080A66433F6,0xB15079c639496d764F9a03Eab24B6ffB91e8f4d3
8068,15627886,140088,9134971775,138524,1564,394,362,0x1Fa8559e873f698292766790AeCf8080A66433F6,0xc045f8EadbFe7828E797Ccb691da89B385aFFa22
8069,15627886,21000,9000000000,21000,0,2,7,0xaD37fbd4Ecd9B92d366aC2f0D6825A442ac164d6,0x24d8Fa8034f9092f58e8EC84dBF24688AD3d4623
8070,15627886,90000,8752148444,90000,0,2,784416,0x2d1946c6004F8e24c7AF571a79955701b9f58435,0xcaD621da75a66c7A8f4FF86D30A2bF981Bfc8FdD
8071,15627886,90000,8752148444,90000,0,2,784417,0x078a40047411f3b3e63C89614BBF8Ce8A3DD410e,0xcaD621da75a66c7A8f4FF86D30A2bF981Bfc8FdD
8072,15627886,241515,8634971775,220011,21504,3914,0,0x64192819Ac13Ef72bF6b5AE239AC672B43a9AF08,0xd4C2c2427641967DB4Ef106d4665a6B1b90F0c56
8073,15627886,3538298,8634971775,3314286,224012,30960,41,,0x425E5c03ba731806191404359A5402A96A22745f
8074,15627886,175971,8634971775,173199,2772,842,67,0x68b3465833fb72A70ecDF485E0e4C7bD8665Fc45,0xc6dCDC797d18C3B81Bc59B18F70E4bEC6FF9D504
8075,15627886,56950,8634971775,54450,2500,586,628,0x4976fb03C32e5B8cfe2b6cCB31c09Ba78EBaBa41,0x596A2B27BfC6862C2fFB53A2b1F4BF7F1a047342
8076,15627886,51559,8634971775,51071,488,138,540,0x4BA0625052A8604E9D4feDB1728316a31E5506fd,0x949297c9675770f765d2796D99249Ee78Fb7A200
8077,15627886,166733,8634971775,160145,6588,1802,127,0x00000000006c3852cbEf3e08E8dF289169EdE581,0xb03cB3d3df64c627096A497362792Ea01A38E1F2
8078,15627886,94991,8634971775,81263,13728,4106,6,0x00000000006c3852cbEf3e08E8dF289169EdE581,0x77E1d603C69dE58aA8Da1BCe2808CB72Ee003487
8079,15627886,238555,8634971775,235807,2748,842,511,0x68b3465833fb72A70ecDF485E0e4C7bD8665Fc45,0x012369723E2C97EF01E4ae2bf1Db863cD3278cA8
8080,15627886,21000,8634971775,21000,0,2,25,0x3DE7DC708259d4cCD0D4861030255f75c172D7F5,0xDD5D450C25681b7894c30091741D4d7fEF320caE
8081,15627886,46722,8634971775,46150,572,138,1459,0xCF3bc939f9B2487092936F21cC0757b2b523B7aA,0xc5C096a642bAB3a435485F4E1864dF179670D4cA
8082,15627886,278821,8634971775,278617,204,74,474,0x55f1C36Bb7aE0d7D6caE97902E30A2306686Ec73,0x36151eF8bF252eB963235fd76245B98580D595F0
8083,15627886,21000,8634971775,21000,0,2,74,0x5E13aA079523F31e603b9D9ab9cffC569214328c,0x9B989898d9B293481E000df547d310b79d4137e7
8084,15627886,170736,8634971775,167120,3616,1162,384,0x68b3465833fb72A70ecDF485E0e4C7bD8665Fc45,0xce45DbC50E99c5e17Cb3C439CCB96fBac3fc270d
8085,15627886,288121,8634971775,285753,2368,586,1064,0x25553828F22bDD19a20e4F12F052903Cb474a335,0xDb4eDD77a7C6fd364822Da6254Ce4F4FE4b172d9
8086,15627886,98540,8634971775,98108,432,74,100,0x9beC8252AC5ea0D3040f0Df876e8F2558F9Da43e,0x7Aa96077eB5c3DE1c061ca20fa1920A8562097f7
8087,15627886,383272,8634971775,360968,22304,8010,769,0xaE9C73fd0Fd237c1c6f66FE009d24ce969e98704,0x425DE7D06D25B254dB50236a079055077D5890E6
8088,15627886,21000,8634971775,21000,0,2,2,0x5aB084Ec99f7D62a5d61c3e20777F9be73196B8e,0xbC59464C89454fD165E67d5e707cfA9c61717BB7
8089,15627886,176663,8634971775,170011,6652,1810,163,0x00000000006c3852cbEf3e08E8dF289169EdE581,0x2BaF623bdff8b5a80b39Ebada5B3a05EC7DD747c
8090,15627886,189046,8634971775,186286,2760,842,145,0x68b3465833fb72A70ecDF485E0e4C7bD8665Fc45,0xFd18F14008465616509d111240cB245cEFC91eD1
8091,15627886,56659,8634971775,55715,944,138,357,0x9431DE2DFE10BDB30995bd3791dE03a6c9570054,0xA8c9C1683274fCd4A044CED550bCfDE7d5e0624F
8092,15627886,405246,8634971775,401642,3604,1162,430,0x68b3465833fb72A70ecDF485E0e4C7bD8665Fc45,0x4F2aC0c31dC6822fde3b22656DaA47271C4026AF
8093,15627886,122414,8634971775,121574,840,266,299,0x65c25FADd9b88df5c8C101A3b99a5D614B708596,0x92526B99715AFeEd324Fb56EcAFcac8056379300
8094,15627886,46185,8634971775,45697,488,138,7,0x9b3B6974531d8AA15A87908FFd821A64863Ede5B,0x11f1F206a69692955237c7FF492f851c40655C03
8095,15627886,187602,8634971775,183986,3616,1162,284,0x68b3465833fb72A70ecDF485E0e4C7bD8665Fc45,0x671c78Ae0eB55e918Cab907AE9201Df00E20A3ea
8096,15627886,293278,8634971775,289938,3340,970,190,0x68b3465833fb72A70ecDF485E0e4C7bD8665Fc45,0x6BfE59e8fEaDDfBdBb97F7Da8c6B4550a8bD4ffd
8097,15627886,21000,8634971775,21000,0,2,25,0xF35d1e3D72f52b57ac616EfbCE60cC95e47F3188,0x1443A9DB917F1Ec2a633EA520b1EbC807F6C9f10
8098,15627886,319912,8634971775,312628,7284,1226,443,0x0f306E3f6b2d5ae820d33C284659B29847972d9A,0x9d2BeEa6625c1991C796c498B93842d9E09cb6d6
8099,15627886,29929,8634971775,29865,64,10,785,0x00000000006c3852cbEf3e08E8dF289169EdE581,0x6040a8F2C2BB3789BAfb6232114ff941B0e1bE16
8100,15627886,122512,8634971775,121264,1248,458,404,0x4e32004D8b81847A670b4a1778ACe4dCF2bBA01E,0x399cC15527d172741476bDaCfBb4199898A50c7d
8101,15627886,53646,8314580900,52702,944,138,185,0x32F19B8c25333bF68FaCe58041858f185c17CF74,0xeBB1110Cb4F95B779b2239702f39b452353295Bc
8102,15627886,181476,8134971775,179912,1564,394,62,0x1Fa8559e873f698292766790AeCf8080A66433F6,0x3ce8c9e67b59493FB0Ae24667cE9D9231b28B235
8103,15627886,181476,8134971775,179912,1564,394,47,0x1Fa8559e873f698292766790AeCf8080A66433F6,0xa08f3Db771e728366991d6ec6D1c4b23f0908f4c
8104,15627886,181476,8134971775,179912,1564,394,691,0x1Fa8559e873f698292766790AeCf8080A66433F6,0x8cd519D58E38E37955fa19d20ef6F9d3074F1A3e
8105,15627886,181476,8134971775,179912,1564,394,1627,0x1Fa8559e873f698292766790AeCf8080A66433F6,0x735Fb1B51D03B1230321693Aaf89e7D08476482e
8106,15627886,181476,8134971775,179912,1564,394,1569,0x1Fa8559e873f698292766790AeCf8080A66433F6,0x8193c15Cec9c2F32B3fc1377bE086021247C55c8
8107,15627886,181476,8134971775,179912,1564,394,352,0x1Fa8559e873f698292766790AeCf8080A66433F6,0xD13d8625FAeE6695d88c63e181c3c9BEd5883D36
8108,15627886,181476,8134971775,179912,1564,394,422,0x1Fa8559e873f698292766790AeCf8080A66433F6,0x1b59ebD2eA04FC6a54b388e4408d6E7e4DA9A456
8109,15627886,181476,8134971775,179912,1564,394,6,0x1Fa8559e873f698292766790AeCf8080A66433F6,0x780a0795E192e0c4a9CD225EEcD5F641Da0454b1
8110,15627886,660100,8000000000,657880,2220,650,11615,0x0fc584529a2AEfA997697FAfAcbA5831faC0c22d,0xF165D353abDDb7Cb00052d610254249FCc12a8C7
8111,15627886,105000,7727777444,105000,0,2,138575,0xd9f2dA512F2793C45F4295343D24f24F461E2401,0x974CaA59e49682CdA0AD2bbe82983419A2ECC400
8112,15627886,64200,7727777444,63500,700,202,3479112,0x5f65f7b609678448494De4C87521CdF6cEf1e932,0xd24400ae8BfEBb18cA49Be86258a3C749cf46853
8113,15627886,21000,7584731937,21000,0,2,65,0x974CaA59e49682CdA0AD2bbe82983419A2ECC400,0x31fc849F372b69C19E613B812CEb047591675B7B
8114,15627887,191041,10000000000,190165,876,266,1398,0xd588b586D61C826A0e87919b3D1a239206d58bf2,0xC22d03e13B888Dabb33A1575e4F6542f0e996622
8115,15627887,56524,9735556758,53568,2956,586,1259,0x52dE8D3fEbd3a06d3c627f59D56e6892B80DCf12,0x6eF5Dc6D049Db935e16318F33D919446a0668a78
8116,15627887,240744,9200000000,234812,5932,1738,846,0x68b3465833fb72A70ecDF485E0e4C7bD8665Fc45,0xEc890FCa5C79a443f53849bc658947a99B653A4c
8117,15627887,90000,9000000000,90000,0,2,449981,0x74b83D991783aDcaF0D84aA3b26A75Ec589De318,0x077D360f11D220E4d5D831430c81C26c9be7C4A4
8118,15627887,72779,9000000000,72171,608,138,13,0xA0b86991c6218b36c1d19D4a2e9Eb0cE3606eB48,0x99A104700f99FbB66b9079aAD4e60653D65ED141
8119,15627887,21000,8930330532,21000,0,2,251471,0x3fA045124da7df44c0aA3697421dc877536eEf3a,0x151B381058f91cF871E7eA1eE83c45326F61e96D
8120,15627887,140088,8929330532,138524,1564,394,344,0x1Fa8559e873f698292766790AeCf8080A66433F6,0xDdF0eCCCD19D6e562A5Fb768f671Bd88Ffdc5F5A
8121,15627887,140088,8929330532,138524,1564,394,292,0x1Fa8559e873f698292766790AeCf8080A66433F6,0xBC06f6e197823856FA0A26D6e8ED224eAF2EEB01
8122,15627887,105910,8929330532,105290,620,138,1,0xB4375E8aaCf0147aDf6B2a296c61Ad6141010c37,0x8Fbbb24Bf54C0Bf2BdD86A79a910e5d33d01F5B5
8123,15627887,140088,8929330532,138524,1564,394,301,0x1Fa8559e873f698292766790AeCf8080A66433F6,0x1d4AE3ab0b608314f0C98F2898aeD344B6b2a993
8124,15627887,140088,8929330532,138524,1564,394,225,0x1Fa8559e873f698292766790AeCf8080A66433F6,0x0f5C82d5941fe85A16c12CE2096E1D4b344B47c5
8125,15627887,140088,8929330532,138524,1564,394,213,0x1Fa8559e873f698292766790AeCf8080A66433F6,0x97509fD104789cAe90C98FAfF43dd247A02fF799
8126,15627887,181476,8929330532,179912,1564,394,984,0x1Fa8559e873f698292766790AeCf8080A66433F6,0xa04c72592849B57c6830B36C43f77faC9A7886B2
8127,15627887,140073,8929330532,138521,1552,394,210,0x1Fa8559e873f698292766790AeCf8080A66433F6,0xa3A9A105bFAE163981b09836c51d1931cB002C76
8128,15627887,140088,8929330532,138524,1564,394,202,0x1Fa8559e873f698292766790AeCf8080A66433F6,0x41077De85A5525f0868ad127aAA01987c169B7d0
8129,15627887,99226,8929330532,98630,596,138,741,0xA0b86991c6218b36c1d19D4a2e9Eb0cE3606eB48,0x438501E7D44287238dE937BA656beDDB79aeA20D
8130,15627887,140088,8929330532,138524,1564,394,195,0x1Fa8559e873f698292766790AeCf8080A66433F6,0x188E5fE39Fe95E253631e359d78eA46c701C889d
8131,15627887,181458,8929330532,179906,1552,394,77,0x1Fa8559e873f698292766790AeCf8080A66433F6,0xCa20557ab716842773b8B0C51462a32502774954
8132,15627887,49542,8929330532,49478,64,10,961,0xC02aaA39b223FE8D0A0e5C4F27eAD9083C756Cc2,0xBC3A956a05808799f3Ef9b1B1eeEEC56F8d89e21
8133,15627887,70000,8929330532,69392,608,138,538,0xdAC17F958D2ee523a2206206994597C13D831ec7,0xf5491f793D47A6Ea22f5e0B9AD3990CF66c4b40B
8134,15627887,140088,8929330532,138524,1564,394,176,0x1Fa8559e873f698292766790AeCf8080A66433F6,0xA0Ee0d27479058d399375a06cAD2a00Ac453cB39
8135,15627887,140088,8929330532,138524,1564,394,127,0x1Fa8559e873f698292766790AeCf8080A66433F6,0x83c33EA9f86bb617709Af9f6c7FB8f530DEDD414
8136,15627887,140073,8929330532,138521,1552,394,122,0x1Fa8559e873f698292766790AeCf8080A66433F6,0xA43302b2195a0674677E953cB8c8da2C4D63D9aB
8137,15627887,21000,8760000000,21000,0,2,496,0x2c29c876e0B63feC18e5ea174FFBe4f03e60c728,0x9a9b3B7342CA213562fc3B8f825c0a570480B574
8138,15627887,21000,8430330532,21000,0,2,96801,0x7C84176fa50aE1df5F7061186459BE92438805Ee,0x4c9AF439b1A6761B8E549D8d226A468a6b2803A8
8139,15627887,36015,8429330532,35751,264,74,283,0xC02aaA39b223FE8D0A0e5C4F27eAD9083C756Cc2,0x4B5aF9A639eB60Edaa3164235371BcEAB1a0F791
8140,15627887,61447,8429330532,53271,8176,2506,920,0x00000000006c3852cbEf3e08E8dF289169EdE581,0xf9aE959aFf814823cd5C62e7Ec96CE4437a37E2F
8141,15627887,55904,8429330532,54960,944,138,2151,0x011b0beAe3eC5953B4805b064cC78f6F892A99cC,0x1c1D80d30F6f96cD288d9fD3E267f253220fD7C7
8142,15627887,21000,8429330532,21000,0,2,14,0xfB029Dc997c6298b2A5f50AD8007b64ac05b9639,0x2DBabC95096d056c2859178Bfd6a2C245f7Bde56
8143,15627887,215574,8429330532,212814,2760,842,520,0x68b3465833fb72A70ecDF485E0e4C7bD8665Fc45,0xb11aE692149B8fe7e02d2c643509B89845FA3461
8144,15627887,60760,8429330532,59816,944,138,6,0xA0b86991c6218b36c1d19D4a2e9Eb0cE3606eB48,0xaa05A35aabA5CDD1230c51FE0289a01c7f73AAAa
8145,15627887,67544,8429330532,66068,1476,458,99,0x5BABc381C7E9EdCF02654a9C30d384dFE54dd4A1,0x066DC123977849dF818ed709B375E73123E45179
8146,15627887,46682,8429330532,46194,488,138,1106,0x421446f756235aE519cf474c794ff58777256586,0xaAC2260B5950A27595Cf0fbde6C188a0937593DA
8147,15627887,162345,8429330532,161669,676,202,457,0x9D0464996170c6B9e75eED71c68B99dDEDf279e8,0x9a679F16A53a7b353c4879E40Cf50082d6ebc5ab
8148,15627887,60655,8429330532,53271,7384,2506,101,0x00000000006c3852cbEf3e08E8dF289169EdE581,0xd96606522a5C8aE1f69256A041800d926297241C
8149,15627887,181476,8429330532,179912,1564,394,245,0x1Fa8559e873f698292766790AeCf8080A66433F6,0x5a2079450f5D9abdEA4996E88E6710F86838FE0b
8150,15627887,21000,8429330532,21000,0,2,606,0x6F045480aC73c072493B2ce2BA74c66054071BCF,0xff019340537C2DB8F0717F9E710977d18A46d61f
8151,15627887,210208,8429330532,207460,2748,842,205,0x68b3465833fb72A70ecDF485E0e4C7bD8665Fc45,0x8eac5a3DFa995752Ccc83902CECF14FBa2d7C00d
8152,15627887,64200,8222065433,63500,700,202,3479113,0x5f65f7b609678448494De4C87521CdF6cEf1e932,0xd24400ae8BfEBb18cA49Be86258a3C749cf46853
8153,15627887,181476,7929330532,179912,1564,394,692,0x1Fa8559e873f698292766790AeCf8080A66433F6,0x8cd519D58E38E37955fa19d20ef6F9d3074F1A3e
8154,15627887,268284,7929330532,266016,2268,650,106631,0xA69babEF1cA67A37Ffaf7a485DfFF3382056e78C,0x9AAb3F81604c683a1a0D14019FBfe15bef7aA1ee
8155,15627887,181476,7929330532,179912,1564,394,199,0x1Fa8559e873f698292766790AeCf8080A66433F6,0x68a1F25D55230A9224395Db7f50F57e7b460C93D
8156,15627887,181476,7929330532,179912,1564,394,355,0x1Fa8559e873f698292766790AeCf8080A66433F6,0x1D3D7A09cB297AA8dedCA7d5dA57413a313dcfA4
8157,15627887,175110,7929330532,173546,1564,394,132,0x1Fa8559e873f698292766790AeCf8080A66433F6,0x0e29e5479Bc1F8f34D62021511d893182b667F13
8158,15627887,181476,7929330532,179912,1564,394,66,0x1Fa8559e873f698292766790AeCf8080A66433F6,0xE730Ad59b06adB5CCfc9b6e5CAD00C542eCCEEb8
8159,15627887,469436,7727777444,468356,1080,266,3479114,0x5f65f7b609678448494De4C87521CdF6cEf1e932,0xd24400ae8BfEBb18cA49Be86258a3C749cf46853
8160,15627887,21000,7727777444,21000,0,2,4,0x974CaA59e49682CdA0AD2bbe82983419A2ECC400,0x48Cfbfcf6FC0531C3C59AE04C78Ebc02b7128b8B
8161,15627887,52267,7181766884,51635,632,138,0,0x4a220E6096B25EADb88358cb44068A3248254675,0xd9cfF1A0B9B73b741679AF9e8D08a06eB3427228
8162,15627887,223454,7171900758,220694,2760,842,10,0x68b3465833fb72A70ecDF485E0e4C7bD8665Fc45,0xC6F82C158F568A8580986Ef3CB3C47A253Af3465
8163,15627887,66744,7000000000,66680,64,10,845,0x2c1270a714F650F68f80e83850d85d003082B456,0x1dF2535cf0956AbEC21C4738534885d3849d6578
8164,15627887,18976511,6931330532,18734363,242148,35402,215,0xc0E53C70dD53b5e1A8275Aa65ec07F20038F8317,0xa5Db65D218d9A017c39c0657c0663Fee0085a5c2
8165,15627888,69163,45000000000,68555,608,138,24,0xdAC17F958D2ee523a2206206994597C13D831ec7,0x04D169e253e158CfdDF9756d030507476BCB296A
8166,15627888,73170,45000000000,72574,596,138,16,0xA0b86991c6218b36c1d19D4a2e9Eb0cE3606eB48,0xfc4D7aF9632CA5d3409289e4267869C7b0106836
8167,15627888,94813,45000000000,94205,608,138,111,0xdAC17F958D2ee523a2206206994597C13D831ec7,0x4eABEC127b7F294033E9A8FCa4C74248e0d5DA73
8168,15627888,269981,37402890623,268241,1740,458,16,0x7a250d5630B4cF539739dF2C5dAcb4c659F2488D,0x26009ff057450897BBe7eF1c3a9115c2d2C47ff4
8169,15627888,269999,37402890623,268247,1752,458,15,0x7a250d5630B4cF539739dF2C5dAcb4c659F2488D,0xfD8d921494B5fB3d26c65382552A09F8FA32BE24
8170,15627888,21000,37370893600,21000,0,2,30144,0x0e451436025B652dbD396873F25e7756d16f933e,0x463E5b673d1029989c9B059d36393c539beF9094
8171,15627888,250000,21000000000,249392,608,138,0,0xdAC17F958D2ee523a2206206994597C13D831ec7,0x039dC9849dcf14058D81Bf3a1cc0e6A3D15160F8
8172,15627888,243783,17402890623,240179,3604,1162,863,0x68b3465833fb72A70ecDF485E0e4C7bD8665Fc45,0x0a2eB196bFf5573F456D47A9fA26208a24BB5996
8173,15627888,5049560,17000000000,5042424,7136,1098,295,0x0a39DA505DfB5E0BBc6bd84428281A8ba1bC7753,0x495E889d1A6cEB447a57dcc1C68410299392380c
8174,15627888,21000,16000000000,21000,0,2,1468,0x2b09480982Ffd83e386c799eF02bf1e871eACe4d,0x934752f07d187CBB757398F84ed398bc395BCA3E
8175,15627888,81978,15257429774,81370,608,138,2188244,0x397Deb686C72384FAd502A81f4d7fDb89e1f1280,0x75e89d5979E4f6Fba9F97c104c2F0AFB3F1dcB88
8176,15627888,77356,15257429774,76736,620,138,2188245,0x467719aD09025FcC6cF6F8311755809d45a5E5f3,0x75e89d5979E4f6Fba9F97c104c2F0AFB3F1dcB88
8177,15627888,54163,13402890623,53375,788,138,9386,0xCcbA0b2bc4BAbe4cbFb6bD2f1Edc2A9e86b7845f,0xf18D90929e3EC5D3BeA4aA16b9451AD3216a7764
8178,15627888,21000,13370893600,21000,0,2,0,0x7AB6c736baf1DAc266aAb43884d82974a9ADCcCF,0xBbf926B733BC9d4ADe13f7703fe76EFb87Ad7634
8179,15627888,181458,13000000000,179906,1552,394,458,0x1Fa8559e873f698292766790AeCf8080A66433F6,0x51A6bf315A019D3BFf529559081C64E8627Dd60A
8180,15627888,94388,12936499945,93792,596,138,2,0xdAC17F958D2ee523a2206206994597C13D831ec7,0x8dfb19D66dcA65C7199681F69186E0161E981eAe
8181,15627888,36015,12402890623,35751,264,74,4068,0xC02aaA39b223FE8D0A0e5C4F27eAD9083C756Cc2,0x0d1d74535bCAbda2dA2CfF5A53C2B899901D423B
8182,15627888,181458,12402890623,179906,1552,394,278,0x1Fa8559e873f698292766790AeCf8080A66433F6,0x00545A341F302DA1f87e109a3834ed541A3356e6
8183,15627888,106830,12402890623,105582,1248,458,2020,0x4e32004D8b81847A670b4a1778ACe4dCF2bBA01E,0xe67Ac23D6C555e9348C1086Ada7e03e3f999C5D6
8184,15627888,55924,11591666166,54980,944,138,225,0xa30E3CE725Cefcbb0dDF744ba7FDd30CbA6750f0,0xe6ea784c71Ad73a0Ca03afc81dCB0F62EB8Ab8Be
8185,15627888,181476,11402890623,179912,1564,394,118,0x1Fa8559e873f698292766790AeCf8080A66433F6,0xC18F0C2623D633f37C8452a45C63b624d2AB6DbA
8186,15627888,21000,11374234997,21000,0,2,1569066,0x8F2B3A434B746c55c5dba065d58C69c4dE35b161,0xAe45a8240147E6179ec7c9f92c5A18F9a97B3fCA
8187,15627888,21000,11374234997,21000,0,2,1569067,0x4A4d0975fC1064C0eB8C67E4819863A0386724A4,0xAe45a8240147E6179ec7c9f92c5A18F9a97B3fCA
8188,15627888,21000,11374234997,21000,0,2,1569068,0x6918796Da11589dA97e68adF441c6EDe40F494ea,0xAe45a8240147E6179ec7c9f92c5A18F9a97B3fCA
8189,15627888,21000,11374234997,21000,0,2,1569069,0xb8bE8f2d7Bb8a309A3C85ca2474CA2a07018A52a,0xAe45a8240147E6179ec7c9f92c5A18F9a97B3fCA
8190,15627888,63000,11107031789,63000,0,2,183633,0x428550b0C017f3EE82474b481231938fedc7Ab5B,0x25eAff5B179f209Cf186B1cdCbFa463A69Df4C45
8191,15627888,262755,11107031789,262099,656,138,355157,0x7Fc66500c84A76Ad7e9c93437bFc5Ac33E2DDaE9,0x7abE0cE388281d2aCF297Cb089caef3819b13448
8192,15627888,63000,11107031789,63000,0,2,2710058,0xA06B1504Dce62a0F83e10D27E445Bcd58778Ddf5,0xC098B2a3Aa256D2140208C3de6543aAEf5cd3A94
8193,15627888,79396,11040000000,78788,608,138,81,0xA0b86991c6218b36c1d19D4a2e9Eb0cE3606eB48,0x4526945e475916F3ba41c78fF5A0d5ccDF1D10a8
8194,15627888,75851,10820000000,75243,608,138,22,0xdAC17F958D2ee523a2206206994597C13D831ec7,0x8De3a6B997EEf6947B4A4b1181F3BC44Cfb55Fff
8195,15627888,181476,10402890623,179912,1564,394,238,0x1Fa8559e873f698292766790AeCf8080A66433F6,0x17198Aaf14E6C0E36818b26a1107249F190d0f47
8196,15627888,102509,10267918848,101193,1316,330,4192,0xA0c68C638235ee32657e8f720a23ceC1bFc77C77,0x3b27da2147E82dF01aF28243E67a684794ce0268
8197,15627888,338779,10267918848,309655,29124,5258,2,0xA0c68C638235ee32657e8f720a23ceC1bFc77C77,0xDAcC69aCe1FBb44d51A0BB1dA359e218B9A90F5a
8198,15627888,21000,10000000000,21000,0,2,2,0x7Fe9fE42f684d13e80EE8DDCe5Ac9544dd1eAf2C,0xA0f081aD0a561c6e65d005cA846A34bE4FD3ac07
8199,15627888,21000,10000000000,21000,0,2,214,0xB00B6D69822dA235a99d2242376066507C9a97b7,0x5C69eb3eFcA25e5f646f7f359E6350A77b9BE305
8200,15627888,21000,10000000000,21000,0,2,222,0xB00B6D69822dA235a99d2242376066507C9a97b7,0xa49804725FBd8dA1bA52fd02f3C79A8CfCd70dFf
8201,15627888,21000,10000000000,21000,0,2,290,0xB00B6D69822dA235a99d2242376066507C9a97b7,0x045bF24164B9Dd5949bCD780f679FB60EffE7637
8202,15627888,21000,10000000000,21000,0,2,362,0xB00B6D69822dA235a99d2242376066507C9a97b7,0xfDc7F6Fe18482677b544F114ee57582Ae4D37A0A
8203,15627888,21000,10000000000,21000,0,2,151,0xB00B6D69822dA235a99d2242376066507C9a97b7,0x919eF9d63Dce0F1236613c594Bb932c2354840aE
8204,15627888,21000,10000000000,21000,0,2,145,0xB00B6D69822dA235a99d2242376066507C9a97b7,0xEE17C9e5BE6fB3c22787380C3f86a2f6C1977F57
8205,15627888,21000,10000000000,21000,0,2,145,0xB00B6D69822dA235a99d2242376066507C9a97b7,0xf168041fc1C22292AF049B037743BF3e97136B8E
8206,15627888,21000,10000000000,21000,0,2,173,0xB00B6D69822dA235a99d2242376066507C9a97b7,0x4Efaf884B0F9B5261618F52d11BaA7E698a3546f
8207,15627888,21000,10000000000,21000,0,2,149,0xB00B6D69822dA235a99d2242376066507C9a97b7,0x79636263EE08003350E0af73f625806B13bEf075
8208,15627888,21000,10000000000,21000,0,2,152,0xB00B6D69822dA235a99d2242376066507C9a97b7,0xea4cc6FD14dd8d53F16fa4A86AD5fb4E25c9F556
8209,15627888,21000,10000000000,21000,0,2,16,0x7Fe9fE42f684d13e80EE8DDCe5Ac9544dd1eAf2C,0xea7e049c3dB1BFEAFE8D801334ce770F8426c0E8
8210,15627888,21000,9904890623,21000,0,2,196178,0xA4B90B3b6dFc321697D9f0eFc72Ed2893122c1C4,0xd108FD0E8c8E71552a167E7a44FF1d345D233BA6
8211,15627888,21000,9904890623,21000,0,2,195479,0x83Db16d50CDbdC2E50E497861b7bd157d644e988,0xB287eaC48aB21c5FB1d3723830d60b4c797555B0
8212,15627888,21000,9904890623,21000,0,2,196179,0xA7E5950FDc9c28502A04CB33f7E913476d9B7ddE,0xd108FD0E8c8E71552a167E7a44FF1d345D233BA6
8213,15627888,305947,9902890623,298959,6988,970,117,0x9b3B6974531d8AA15A87908FFd821A64863Ede5B,0xe00fEe0F54d337FAF283a77c4fCC59604f59A473
8214,15627888,150756,9902890623,150692,64,10,3,0x65c2e54a4c75ff6da7b6B32369c1677250075fb2,0x390e55a61342C53ed555bae4D5F1a12C36384ef5
8215,15627888,62000,9902890623,60448,1552,586,35954,0xc36cF0cFcb5d905B8B513860dB0CFE63F6Cf9F5c,0x21552aeb494579c772A601F655e9B3c514FdA960
8216,15627888,53645,9900000000,52701,944,138,1971,0x2cb055cAa56bfb341422ed9Abd90632c8defaf97,0x800874e6f4f8B6028f607292Aa7B3D8a9EB83395
8217,15627888,21000,9763735136,21000,0,2,150,0xCBD6832Ebc203e49E2B771897067fce3c58575ac,0x4283AB36f50F2b4Df361d0e11c9D500AACDC2Bd4
8218,15627888,85000,9602890623,84332,668,138,614728,0x016ee7373248a80BDe1fD6bAA001311d233b3CFa,0x3C02290922a3618A4646E3BbCa65853eA45FE7C6
8219,15627888,21000,9561966130,21000,0,2,6,0x967C353c3e5a74342F5332CB912e1C1aAA06C0dE,0x65aeACcc01f58c0484Cd3C042d7B836eA1f503e7
8220,15627888,50000,9403890623,50000,0,2,58217,0x17D1D8DeF765263Ff23F916d2c00Da0FC9E43E00,0x56de1961fDA5454E6F8e6D0e3124fF648FD69400
8221,15627888,140088,9402890623,138524,1564,394,155,0x1Fa8559e873f698292766790AeCf8080A66433F6,0x13B0f6a7fA6a0a875A2670B36FF7201d74C45457
8222,15627888,140088,9402890623,138524,1564,394,150,0x1Fa8559e873f698292766790AeCf8080A66433F6,0x87F96b25C12a16656C7Ea32f2A1204De36f3D718
8223,15627888,140073,9402890623,138521,1552,394,147,0x1Fa8559e873f698292766790AeCf8080A66433F6,0xb8004546B0234246Ee061444e8A1AB3Ce7d1d227
8224,15627888,308484,9402890623,301616,6868,1546,3,0x03f34bE1BF910116595dB1b11E9d1B2cA5D59659,0x79491902D911C16d8837be98DB8aB39Cb764a41e
8225,15627888,89173,9402890623,88969,204,74,1439,0x8cFC27c666a31638AD5Cce720c5d09373517F58b,0x9daea748b52acd41E055FBb7E3985625F080b7A7
8226,15627888,140088,9402890623,138524,1564,394,138,0x1Fa8559e873f698292766790AeCf8080A66433F6,0xa0377C09F06b481b3268A0ecc3660FFf0E67777f
8227,15627888,175110,9402890623,173546,1564,394,355,0x1Fa8559e873f698292766790AeCf8080A66433F6,0xC09CD3ddf501746795cCd30483f150d20C3Dba46
8228,15627888,140088,9402890623,138524,1564,394,138,0x1Fa8559e873f698292766790AeCf8080A66433F6,0x5180a0FA284e1A1A62CC179ba06Abf0E1576eEAc
8229,15627888,140088,9402890623,138524,1564,394,131,0x1Fa8559e873f698292766790AeCf8080A66433F6,0x379EE5F220598a7B57914c8dbC4345B1A7C55804
8230,15627888,140088,9402890623,138524,1564,394,104,0x1Fa8559e873f698292766790AeCf8080A66433F6,0xe8c5d27DC4429eF00AE08f579B32126102185874
8231,15627888,304285,9402890623,296121,8164,2122,2,0xe66B31678d6C16E9ebf358268a790B763C133750,0x824B815cd409E58B48F8DA56F3E013F1e31c84FF
8232,15627888,140088,9402890623,138524,1564,394,121,0x1Fa8559e873f698292766790AeCf8080A66433F6,0x7e718e9Dcd600AA92E74A242660D907ED5aCcF5A
8233,15627888,140088,9402890623,138524,1564,394,112,0x1Fa8559e873f698292766790AeCf8080A66433F6,0x4F4A9f6284d214247304ac42245Ce04C872dbDd4
8234,15627888,191462,9402890623,184874,6588,1802,3,0x00000000006c3852cbEf3e08E8dF289169EdE581,0x451714781CcE412381e8DF3CC4BA54FEde7d046e
8235,15627888,140073,9402890623,138521,1552,394,143,0x1Fa8559e873f698292766790AeCf8080A66433F6,0x5C683a42eA1A45a6b88965f56A87b79a361D04e2
8236,15627888,140073,9402890623,138521,1552,394,76,0x1Fa8559e873f698292766790AeCf8080A66433F6,0xB5777415d5B93495978899005AF29aF857c21283
8237,15627888,42000,9402890623,42000,0,2,329547,0x5D25950ef20162410b2d8AeFbC846D7D1d46C2f1,0x9430801EBAf509Ad49202aaBC5F5Bc6fd8A3dAf8
8238,15627888,56659,9402890623,55715,944,138,406,0xAD13C2a8d418d01F3236F4d8b9d724575a4e9d24,0x9b122ab8CBE7c7E81e8C24Ab78a20b8c86A7455F
8239,15627888,140088,9402890623,138524,1564,394,76,0x1Fa8559e873f698292766790AeCf8080A66433F6,0x14c7dD218cf21D5f89684c4612429e5FF12Ad4ad
8240,15627888,140088,9402890623,138524,1564,394,71,0x1Fa8559e873f698292766790AeCf8080A66433F6,0x37d5C439e40213Ded82b10fb2AF7e8E776a33237
8241,15627888,140088,9402890623,138524,1564,394,71,0x1Fa8559e873f698292766790AeCf8080A66433F6,0x3F514D8C080e8b9B3A8a8F898dD4e503a1Dd7322
8242,15627888,140088,9402890623,138524,1564,394,70,0x1Fa8559e873f698292766790AeCf8080A66433F6,0xd7De9782431a27dFcC5959ebce4cFb4D92dd9094
8243,15627888,181476,9402890623,179912,1564,394,189,0x1Fa8559e873f698292766790AeCf8080A66433F6,0xe2554BBCf864b80a2E0A83FC6da81F82186E5F4B
8244,15627888,140088,9402890623,138524,1564,394,68,0x1Fa8559e873f698292766790AeCf8080A66433F6,0x96bc66b9b4B6744e60C4d3425ED1fC358020f350
8245,15627888,140088,9402890623,138524,1564,394,66,0x1Fa8559e873f698292766790AeCf8080A66433F6,0x126Da70F1E655077D8be54750747073d42e19911
8246,15627888,60779,9402890623,53271,7508,2514,502,0x00000000006c3852cbEf3e08E8dF289169EdE581,0xa1e250c71B2b8474622115339408eF68c36510F3
8247,15627888,181476,9402890623,179912,1564,394,876,0x1Fa8559e873f698292766790AeCf8080A66433F6,0xE090eaEABA95913443d48b24b86c43f3Ecf305BE
8248,15627888,140088,9402890623,138524,1564,394,65,0x1Fa8559e873f698292766790AeCf8080A66433F6,0x6F8AA5c4dA1A598808984B1b0B39f03dad828072
8249,15627888,181476,9402890623,179912,1564,394,0,0x1Fa8559e873f698292766790AeCf8080A66433F6,0xD844c90a6a011F25901eF9163578ab1401B8bf29
8250,15627888,140088,9402890623,138524,1564,394,64,0x1Fa8559e873f698292766790AeCf8080A66433F6,0x7212CCf39E9d5F7CA2944C679e3Ee36C8ba585Ee
8251,15627888,140073,9402890623,138521,1552,394,63,0x1Fa8559e873f698292766790AeCf8080A66433F6,0xdE090Ceb567C13faBbe7BE963E0a65fbe6269B03
8252,15627888,140073,9402890623,138521,1552,394,61,0x1Fa8559e873f698292766790AeCf8080A66433F6,0x1428aa2458175460356d850DC92b27323A9C801b
8253,15627888,60803,9402890623,53271,7532,2514,10,0x00000000006c3852cbEf3e08E8dF289169EdE581,0x32272B96B2F0EAE55BeFAEAa81e56Abe5Ab2F12B
8254,15627888,140088,9402890623,138524,1564,394,61,0x1Fa8559e873f698292766790AeCf8080A66433F6,0x478eFAc457E77317E47a4DC4A04587Ba2B5a61Cc
8255,15627888,140088,9402890623,138524,1564,394,60,0x1Fa8559e873f698292766790AeCf8080A66433F6,0x8aF25d2a1F7e7fBc92255145A08323906E1AcDE3
8256,15627888,2000000,9402890623,1990924,9076,2122,171052,0xA9D1e08C7793af67e9d92fe308d5697FB81d3E43,0x7830c87C02e56AFf27FA8Ab1241711331FA86F43
8257,15627888,21000,9402890623,21000,0,2,1783210,0xDE80345ba00f8FA98658613BbA837141E8C6a591,0x503828976D22510aad0201ac7EC88293211D23Da
8258,15627888,56659,9402890623,55715,944,138,195,0xAD13C2a8d418d01F3236F4d8b9d724575a4e9d24,0x68E8d2E2423176bbEC676B50745541906d18E01D
8259,15627888,85000,9402890623,84512,488,138,25,0xD27dcbcC8778a8AB33AAc529Df36a634567Be325,0xd92c5263c7B03b793F966D448128DFF777A690de
8260,15627888,2000000,9402890623,1994860,5140,1162,171053,0xA9D1e08C7793af67e9d92fe308d5697FB81d3E43,0x7830c87C02e56AFf27FA8Ab1241711331FA86F43
8261,15627888,140088,9402890623,138524,1564,394,59,0x1Fa8559e873f698292766790AeCf8080A66433F6,0x229B70ef688b53f83c94550F052F77aD51C420C9
8262,15627888,140088,9402890623,138524,1564,394,59,0x1Fa8559e873f698292766790AeCf8080A66433F6,0x0BdB015d4c4BC56d16Ae6dF2B92Be5a969550201
8263,15627888,740000,9402890623,729052,10948,2506,22231,0x5E3c7bdf06C35f88c6c0De739ed1c04767e330F9,0xc61a7e5a04A5d32ffe8e01f77Cb39253bf21D2aC
8264,15627888,195802,9402890623,189162,6640,1810,1175,0x00000000006c3852cbEf3e08E8dF289169EdE581,0x4119B064f664B259bDAEc80a7f582373015daCed
8265,15627888,181476,9402890623,179912,1564,394,612,0x1Fa8559e873f698292766790AeCf8080A66433F6,0x89338593b2586A08b22483C94C27E10Fa306A881
8266,15627888,56659,9402890623,55715,944,138,589,0x9431DE2DFE10BDB30995bd3791dE03a6c9570054,0x15A15Fe79A268668eEc2573F81E67Bd648B3c1B9
8267,15627888,248900,9402890623,246140,2760,842,1021,0x68b3465833fb72A70ecDF485E0e4C7bD8665Fc45,0x757fD55374512D23332F634b396a9997B9880134
8268,15627888,69904,9402890623,68960,944,138,13,0x3C4B6E6e1eA3D4863700D7F76b36B7f3D3f13E3d,0xBB83b27C991cFA96f19bb4a1D27bD3DC17a95B43
8269,15627888,207128,9402890623,206472,656,138,4232346,0x1F573D6Fb3F13d689FF844B4cE37794d79a7FF1C,0xDFd5293D8e347dFe59E90eFd55b2956a1343963d
8270,15627888,207128,9402890623,206532,596,138,4468960,0xdAC17F958D2ee523a2206206994597C13D831ec7,0x21a31Ee1afC51d94C2eFcCAa2092aD1028285549
8271,15627888,207128,9402890623,207128,0,2,3199179,0x696aa894705436a8f5E44e0681b0212fd25aa409,0x9696f59E4d72E237BE84fFD425DCaD154Bf96976
8272,15627888,207128,9402890623,207128,0,2,1679533,0xc62E4EdF37Ba573B1F00b08fFd93fc07fE02f5B1,0x4976A4A02f38326660D17bf34b431dC6e2eb2327
8273,15627888,219238,9402890623,214898,4340,1098,26,0xe66B31678d6C16E9ebf358268a790B763C133750,0xF1bae820e403DDcC2AEd84F2EfB8622d2F2C4767
8274,15627888,207128,9402890623,207128,0,2,3492286,0x60B62aFf036919bbb76006f9d1ea472462aC2317,0x56Eddb7aa87536c09CCc2793473599fD21A8b17F
8275,15627888,85000,9402890623,84512,488,138,25,0xD27dcbcC8778a8AB33AAc529Df36a634567Be325,0x6201ec8aDc61227b9A2a8Cdd9Dd9d4FB34F8A44A
8276,15627888,163662,9402890623,157578,6084,1682,867,0x00000000006c3852cbEf3e08E8dF289169EdE581,0xB8097Eb6344225D3D160202058640fd0E6f018D5
8277,15627888,55978,9402890623,55034,944,138,507,0xd4cB651749953988647eEE9b51DDB8DB5aeb3410,0x91CA602f60d8A7B2fC5610A5f0330078e10eda63
8278,15627888,207128,9402890623,207128,0,2,4468961,0x6EB7C7B8A4953F9ac495ee6d338019da1E1aa16a,0x21a31Ee1afC51d94C2eFcCAa2092aD1028285549
8279,15627888,39630,9402890623,39354,276,74,271,0xC02aaA39b223FE8D0A0e5C4F27eAD9083C756Cc2,0x77bC47264A515cEe4BA3652ff23cC83D365D1E0a
8280,15627888,344223,9402890623,339611,4612,1162,14,0xe66B31678d6C16E9ebf358268a790B763C133750,0xBB83b27C991cFA96f19bb4a1D27bD3DC17a95B43
8281,15627888,207128,9402890623,206520,608,138,3199180,0xdAC17F958D2ee523a2206206994597C13D831ec7,0x9696f59E4d72E237BE84fFD425DCaD154Bf96976
8282,15627888,181458,9402890623,179906,1552,394,249,0x1Fa8559e873f698292766790AeCf8080A66433F6,0x0333656a887aF23107BFF18E4a0d20968ef68910
8283,15627888,55897,9402890623,54953,944,138,72,0x0148015047923173cc1a4bC384D5CcC8b8B21a9C,0xD5b5E8a77b87224B1f6712Ba02c34fE163F78c62
8284,15627888,50000,9314828064,50000,0,2,503553,0x122917e191d4A0e46A35d5a5f79Ae9d3fea765A1,0x000F422887eA7d370FF31173FD3B46c8F66A5B1c
8285,15627888,21000,9071008486,21000,0,2,57,0x85843953Dea245eF1f7dF28710A37D7FCf748854,0x9512860fe3F7E53A39FF9D1070e132ea2D613D23
8286,15627888,335180,9012890623,327796,7384,2194,4997,0xDef1C0ded9bec7F1a1670819833240f027b25EfF,0xc4F89Ff0eAf61b20c4e41b5795CE458D50F6804b
8287,15627888,67000,9000000000,66392,608,138,0,0xA0b86991c6218b36c1d19D4a2e9Eb0cE3606eB48,0x24D96531B4de609De19d2e2DF3C29cfa0Ef9bc4f
8288,15627888,170000,9000000000,169380,620,138,508311,0x069f967be0CA21C7D793D8C343f71e597D9a49b3,0x39F6a6C85d39d5ABAd8A398310c52E7c374F2bA3
8289,15627888,69529,8912890623,68921,608,138,354,0xdAC17F958D2ee523a2206206994597C13D831ec7,0x75Da036aD4fFf900f1cfC88d197FBA4ab7611859
8290,15627888,46267,8902890623,45691,576,74,733,0x283Af0B28c62C092C9727F1Ee09c02CA627EB7F5,0x1425C88ce0780E5bcE5f405333C81f9336dC52eA
8291,15627888,45038,8902890623,44974,64,10,22,0xC02aaA39b223FE8D0A0e5C4F27eAD9083C756Cc2,0x9686b6A96083b7Ed7cef93319B05c96D4D0cf0d9
8292,15627888,49267,8902890623,48779,488,138,1074,0x7DF64F69544c5bf71171dc5ab69b8602C2FF1E27,0x430d00d7b63715fF5f19c825B750Aa20CE627C8b
8293,15627888,55951,8902890623,55007,944,138,3368,0xf88b9eBB1bc3b6DD28A47f6910DA97E530403a0f,0x7Db1411Ec334C5e4DCB9433d2E477E82a0229504
8294,15627888,55993,8902890623,55385,608,138,2,0x0107C4aAa31940eF88760aCb1F32424CA8d8bD80,0x6191bB89661839D399c2b45b18d276cBE2844226
8295,15627888,55904,8902890623,54960,944,138,6,0x011b0beAe3eC5953B4805b064cC78f6F892A99cC,0x7D35286C7d6864Cf6A61b4EC90F3d2FB6F8C7935
8296,15627888,21000,8902890623,21000,0,2,2,0xe11819e5d88cFEd5F981727B27f37e71a37d3e6D,0x5C0c82e42b7632ce9D92BBC3f0a0A9ab7FA1762c
8297,15627888,241752,8902890623,240128,1624,394,119,0xd9e1cE17f2641f24aE83637ab66a2cca9C378B9F,0xa367fA891A0b2dc8B7F85b9ECFa09dB9113A6CF0
8298,15627888,21000,8902890623,21000,0,2,1927,0xf3cBd630782A6E306Cca675c55F40EEA24e028e9,0xe61C54eFAa379Ca8d956e15228Ba00E99320675A
8299,15627888,21000,8902890623,21000,0,2,50,0x8B2E0eDB1077191829DBD0F048604477DE7bd83E,0x3AC375e1f05bc2d6F11eE7dA179F2e15aEA69D64
8300,15627888,81706,8902890623,79930,1776,458,111,0xFbdDaDD80fe7bda00B901FbAf73803F2238Ae655,0x17c852867106C351516D4ccC2bd5810D49B224B2
8301,15627888,546111,8902890623,541467,4644,1226,96,0xC36442b4a4522E871399CD717aBDD847Ab11FE88,0xC9F77e99E83d93ed1E7E07Cb431E56F10ad1458C
8302,15627888,21000,8902890623,21000,0,2,388,0x83eC34a0D6E37914B381825aC96e4Ab349BAa830,0xF56bcAcA6495FcC2fcC78599075415787E2C2351
8303,15627888,25099,8902890623,24499,600,266,239,0x710515Bf543fDb6834144F9269BBf0D1d32B1702,0x794DceEDd37e140553C161Fe230Ea80c76cdB622
8304,15627888,143779,8902890623,142539,1240,394,126,0x710515Bf543fDb6834144F9269BBf0D1d32B1702,0x69c9c256C3e5C038e1E9e9F89726EfC23da09971
8305,15627888,296542,8902890623,273834,22708,3082,56,0x6BFaD42cFC4EfC96f529D786D643Ff4A8B89FA52,0xC533E7B5A22908E840f0F4F3Ae698b663B26973A
8306,15627888,288054,8902890623,285730,2324,522,979,0x283Af0B28c62C092C9727F1Ee09c02CA627EB7F5,0xA5b71Bac1a71C5c2A226B61E778C2a738Ff6b297
8307,15627888,46061,8902890623,45573,488,138,95,0xEC13dE18765B0e65f99F6BFAC56A856b90e7f2aB,0xe79ba48fFC181F1A17F4B7D3d47A3AAc9533c6c6
8308,15627888,71729,8902890623,69533,2196,458,349,0x74312363e45DCaBA76c59ec49a7Aa8A65a67EeD3,0x140d9Fb266aA0C399e2E4b89545b2d80720d7e79
8309,15627888,62267,8902890623,61547,720,266,168,0x12DEb1Cb5732E40Dd55B89aBB6D5C31dF13A6e38,0x7b989E2F025cDF1b39Ca45CA01f694caE71ffed9
8310,15627888,59930,8902890623,52558,7372,2122,177,0x00000000006c3852cbEf3e08E8dF289169EdE581,0x10b3b8075558B4c8f41c76FDA2C4dcA146Ba137a
8311,15627888,21000,8902890623,21000,0,2,194,0x6946CEc9D3A0960CC3EF5Ee099Dd07FD7a729922,0x013A5DD0E59963Fc5A09C1FD6c4FcEe478366110
8312,15627888,451186,8902890623,448070,3116,906,256,0x68b3465833fb72A70ecDF485E0e4C7bD8665Fc45,0xDf6abC5a67968ECA5952AEc8005e68D98961777C
8313,15627888,795449,8902890623,790893,4556,1290,23,0xDef1C0ded9bec7F1a1670819833240f027b25EfF,0x9686b6A96083b7Ed7cef93319B05c96D4D0cf0d9
8314,15627888,79384,8902890623,78144,1240,202,25,0x5FDCCA53617f4d2b9134B29090C87D01058e27e9,0x1ebDec764c0e7EB55De4Cb6D87068710c9dC8CA8
8315,15627888,46267,8902890623,45691,576,74,26,0x283Af0B28c62C092C9727F1Ee09c02CA627EB7F5,0x510abE34817E14D26FD8DE589190Cfa676B9b42B
8316,15627888,109260,8902890623,108460,800,330,54,0x17D084106C2f1C716ce39fa015AB022757d30C9A,0xf3675bC6F2427F80025538e19963574d713E2880
8317,15627888,46267,8902890623,45691,576,74,24,0x283Af0B28c62C092C9727F1Ee09c02CA627EB7F5,0x7F2b4c1E30570B7e36d8A814D5296d7Db032AA37
8318,15627888,21000,8902890623,21000,0,2,741,0x11286A8D9AB6C307Ce0681Ad66C1b588Ad85a03a,0xB23a91638BF4E9Ba88AcB1BeA4F81a569a1fcd4c
8319,15627888,46267,8902890623,45691,576,74,29,0x283Af0B28c62C092C9727F1Ee09c02CA627EB7F5,0xDEB3882D3029018448F9E533d750337166D42101
8320,15627888,46135,8902890623,45647,488,138,1068,0x1Fa8559e873f698292766790AeCf8080A66433F6,0xd95985e7BfD294B0D7FEb30f41EaBCC3d6454334
8321,15627888,305932,8902890623,298944,6988,970,32,0x9b3B6974531d8AA15A87908FFd821A64863Ede5B,0x4e879eF3C9a62d06D33164F45D2ea7e86616D99D
8322,15627888,109280,8902890623,108328,952,202,622,0x52E66cA968010d064938A8099a172CBAaf08c125,0x58c3D7751c9E5cBE500d7BD8dADA355EB5201af6
8323,15627888,179593,8902890623,178625,968,330,30,0x5ebFD58C5eAd1025755F7490e510cCf2C0b4a444,0x19cb365A093942C19d760452C0E239F3a1e294A6
8324,15627888,46267,8902890623,45691,576,74,26,0x283Af0B28c62C092C9727F1Ee09c02CA627EB7F5,0xDc27bc1bC595d7eeE2084D502Fb975bd36539E5a
8325,15627888,239693,8902890623,233281,6412,1738,7,0x00000000006c3852cbEf3e08E8dF289169EdE581,0x68997cd3F813b860189631c52b1dDFfeaFcfa5b2
8326,15627888,21000,8902890623,21000,0,2,2,0x095c964E3067Ee522fAbFed748c5eCab6599dD3C,0x88e58c129769021B4cc3AA86021d867fc4d396eF
8327,15627888,264327,8902890623,262503,1824,458,0,0x7a250d5630B4cF539739dF2C5dAcb4c659F2488D,0xC6Fc3f59b26e057D965730B7d3758e646568c6A8
8328,15627888,195802,8902890623,189162,6640,1810,1376,0x00000000006c3852cbEf3e08E8dF289169EdE581,0xA2B0E6cF670740e0c0DF7bfcAf6B79684988a6F3
8329,15627888,99244,8902890623,98636,608,138,837,0xA0b86991c6218b36c1d19D4a2e9Eb0cE3606eB48,0x7eF7398f74E07B8d5c9f9FFD82b95480b3E6A5d6
8330,15627888,109775,8902890623,109003,772,202,66,0xcDA72070E455bb31C7690a170224Ce43623d0B6f,0x9fB5B74d61be3524AFC21c0d6c18BcD8ef6c05f6
8331,15627888,56679,8902890623,55735,944,138,167,0x6B5DDe2c94EcC10C93e8A44288bEFAD2a89bd657,0xa4e5ee3142C8F17797018A729A2007f00a89A27D
8332,15627888,384219,8902890623,380615,3604,1162,293,0x68b3465833fb72A70ecDF485E0e4C7bD8665Fc45,0xd8d415806d20a7D1d28758C6BD73285ef2657888
8333,15627888,90000,8902890623,90000,0,2,9199,0x2078a939bEfC324Ee524b1B469C60e25d3be5E76,0xA86309988947559b6E72Ef716C5058F479386C0F
8334,15627888,21000,8902890623,21000,0,2,13,0xDd4298c1bbdBDFf6D550329d07736718cf8b94dF,0xd28Ff6DD7d851371162489EC9B031B8DC0949F74
8335,15627888,238449,8902890623,238105,344,138,17,0x09f717f77B5e7f2D2F37604fEC3D0e3D53eB9808,0x807Ee19a94429c81D483544a9bb4A1Afd5bc36b9
8336,15627888,46267,8902890623,45691,576,74,26,0x283Af0B28c62C092C9727F1Ee09c02CA627EB7F5,0x95781e4a0982Fb7e05785d16bDd8b7f7a45C4B72
8337,15627888,55904,8902890623,54960,944,138,671,0x011b0beAe3eC5953B4805b064cC78f6F892A99cC,0x0144D10B6b9d90fEF7d139e9693eac9F55e344Ed
8338,15627888,46157,8902890623,45669,488,138,355,0x67421C8622F8E38Fe9868b4636b8dC855347d570,0x811B23e4Ab2B4BeAE94Db8a7Ff143c417Af3CD9c
8339,15627888,21000,8902890623,21000,0,2,118,0x8c8363EE1D5AE7E3931D8EfD302ea1bB39Ef0488,0x78fEd80ac6Dee33C1eE92fe4D91DaBB775CC1048
8340,15627888,21000,8902890623,21000,0,2,2,0xc4f6865d0ce53c780B1Ba4fb7C83DD106ec49cE3,0x6585Ef58B6e6C5217794Be782c521C489CD76f24
8341,15627888,46088,8902890623,45600,488,138,298,0x5D004ddB5D92938dAF8448b9eac1CaA593cd26Ca,0x6F91754BaF0D53F259745355D11553d2B7609DeE
8342,15627888,90000,8902890623,90000,0,2,9200,0x10879a9D926E8b7cFbBD3b51102b06029b0340EB,0xA86309988947559b6E72Ef716C5058F479386C0F
8343,15627888,243575,8902890623,241683,1892,522,4,0x000000000000509081d6FCD3ee63e791aD1db763,0x23a4Ae366288456A888C601e195e906C631d89c9
8344,15627888,46255,8902890623,45691,564,74,24,0x283Af0B28c62C092C9727F1Ee09c02CA627EB7F5,0x39e90B221fA6520bc1d0120e11BB7DfcAFf95Fd7
8345,15627888,21000,8902890623,21000,0,2,389,0x0D062Dc6C569a7C5F4f8B1F9260dc44c3a26e7E8,0x83cB506ED2C58F604767ed13Ab74E8dD3CE39402
8346,15627888,77217,8902890623,76597,620,138,99,0x8A2279d4A90B6fe1C4B30fa660cC9f926797bAA2,0x1c632152D528D0aa32624E0b2a410B4d97F7D0a2
8347,15627888,46267,8902890623,45691,576,74,24,0x283Af0B28c62C092C9727F1Ee09c02CA627EB7F5,0x30357c162AD9EDF99092dB6281Be36e0E452d82e
8348,15627888,375914,8902890623,375674,240,74,45,0x3aeB3a8F0851249682A6a836525CDEeE5aA2A153,0xcE4586e371f9AB738eAF6D491ACda7AA9D1DdD70
8349,15627888,46267,8902890623,45691,576,74,24,0x283Af0B28c62C092C9727F1Ee09c02CA627EB7F5,0xDdEB7799A65f0F56f6C7C5F7d6247D7F54A29fc9
8350,15627888,21000,8902890623,21000,0,2,4,0xa09b743f7E844592e1e1F5d219ff6563BaDfc996,0xFd3dD85A9EA0650f2C590109dB2d17951E6D4da5
8351,15627888,243789,8902890623,236961,6828,1802,95,0x00000000006c3852cbEf3e08E8dF289169EdE581,0xAeA47f48EaDBa5dF8D9AeAE45138B7AB98ee9Fe7
8352,15627888,146781,8902890623,140117,6664,1810,47,0x00000000006c3852cbEf3e08E8dF289169EdE581,0x8485C883024d0E61D8B90Eec2D5b76D538361388
8353,15627888,21000,8902890623,21000,0,2,6,0xA1A252e4e9B8dfaE6b58C6C88a04791dc6B9E558,0x27aB5CFD5e98f6742Ca37d225d869fe5855f905A
8354,15627888,1338183,8902890623,1317939,20244,8330,434,0x34c3f58058E2ad098ef437Ee5Ea1ff1fE2fe4214,0x1B9D8D8C068330d3958Dee92353d0610f87E3BC7
8355,15627888,51571,8902890623,50951,620,138,206,0x467719aD09025FcC6cF6F8311755809d45a5E5f3,0x919d80ECa63448C51f4ECC001A546A26E8Bb20c7
8356,15627888,31548,8902890623,31516,32,6,1193,0x39af7F3790Eaf739C6aD27b541169252A3D152DC,0x39af7F3790Eaf739C6aD27b541169252A3D152DC
8357,15627888,56689,8902890623,56201,488,138,185,0x28B708Ee88e608f3307A7d41b930312fC9C9e632,0x125cb902d81c4912cF12FA2FDd520AE5119cB944
8358,15627888,46267,8902890623,45691,576,74,213,0x283Af0B28c62C092C9727F1Ee09c02CA627EB7F5,0x1f854Ee78e4d4f5AACeC5004CBaDE1b0525321Ab
8359,15627888,21000,8902890623,21000,0,2,3037,0x53AA4b81B3F5028658161c4522b9DFFdA83e821c,0xf2E9db3c5D06015833Df31eD3C37172a2B34EE7F
8360,15627888,148592,8902890623,142004,6588,1802,56,0x00000000006c3852cbEf3e08E8dF289169EdE581,0x00428adc6751d0b2e4463b6A3822a030a6B82225
8361,15627888,78520,8902890623,77888,632,138,7,0x12b6893cE26Ea6341919FE289212ef77e51688c8,0x1D14EA23e298551924d0b86A178081b55d332DCd
8362,15627888,74392,8902890623,72440,1952,330,142,0x00000000000C2E074eC69A0dFb2997BA6C7d2e1e,0xa50ec7710b47E688d8Eb802A0baDa6Df9F08c38D
8363,15627888,177236,8902890623,175548,1688,330,9,0xb5d2A992442988D0E4bFd1447eba4b8dC1D1A362,0x7eA5C91565a1104bc3227248a7c5E34dAa848a6E
8364,15627888,21000,8902890623,21000,0,2,169,0x2282AFa205661a440C6B53c5b3065dCBA297f9ae,0x33dCa2a698E4188ED43B054F1F33a75f6618Abc4
8365,15627888,1823927,8902890623,1692471,131456,42762,484,0xaE9C73fd0Fd237c1c6f66FE009d24ce969e98704,0xA34D6cE0e9801562E55C90A3D0C7a1f8B68287Ff
8366,15627888,98762,8760000000,97810,952,202,1,0xefaDc46BB78B01195a1E12C82A584Caf5403585C,0xA4788a906CB428e371E28443AAc5bEfC314e5B71
8367,15627888,268332,8503890623,266064,2268,650,91229,0xA69babEF1cA67A37Ffaf7a485DfFF3382056e78C,0x4603180BBB8221157880AfaA84638E0fc467738D
8368,15627888,270156,8402890623,266348,3808,970,111461,0xa57Bd00134B2850B2a1c55860c9e9ea100fDd6CF,0x065e3DbaFCb2C26A978720f9eB4Bce6aD9D644a1
8369,15627888,181476,8402890623,179912,1564,394,1061,0x1Fa8559e873f698292766790AeCf8080A66433F6,0xc329b47FF6074AA0c999c90b0AE821eC7804f24D
8370,15627888,181476,8402890623,179912,1564,394,1341,0x1Fa8559e873f698292766790AeCf8080A66433F6,0x74A4ee5715bc2c6BB088c16Ec3b8bAD6280527d7
8371,15627888,181476,8402890623,179912,1564,394,55,0x1Fa8559e873f698292766790AeCf8080A66433F6,0xcBb3B8588A0b4aB12a20Db7aC63B962065935558
8372,15627888,181476,8402890623,179912,1564,394,157,0x1Fa8559e873f698292766790AeCf8080A66433F6,0x72bde9f4886645DeADB743Ed46E66f62d39e3523
8373,15627888,181476,8402890623,179912,1564,394,2287,0x1Fa8559e873f698292766790AeCf8080A66433F6,0xED04d3792C439b8Af827B3e46EE626827De53Db5
8374,15627888,181476,8402890623,179912,1564,394,105,0x1Fa8559e873f698292766790AeCf8080A66433F6,0x2269456a4F8a4493D58577dE7c86Cd4107328E6c
8375,15627888,231910,8402890623,229126,2784,842,65,0x68b3465833fb72A70ecDF485E0e4C7bD8665Fc45,0x4f52F2777277426Cd4d769D758E7dc44DEa2715F
8376,15627888,181440,8402890623,179900,1540,394,115,0x1Fa8559e873f698292766790AeCf8080A66433F6,0x42DF70a05112E50033Bcd7ffCBD4AbD2D597C9D9
8377,15627888,175110,8402890623,173546,1564,394,96,0x1Fa8559e873f698292766790AeCf8080A66433F6,0x7deb0836e4D0B267d1C49Ef2e87d438d1888c523
8378,15627888,69400,8402890623,68824,576,74,896,0x283Af0B28c62C092C9727F1Ee09c02CA627EB7F5,0x42E2f1c250d46e3d13102a2e1da6298bB8116F87
8379,15627888,181476,8402890623,179912,1564,394,1945,0x1Fa8559e873f698292766790AeCf8080A66433F6,0x62E724226009DE1EDb66b8b8be841781aeb256de
8380,15627888,181476,8402890623,179912,1564,394,406,0x1Fa8559e873f698292766790AeCf8080A66433F6,0x6C96Eb3A4afeb6d2F9a3173Fdc983376baFd1e34
8381,15627888,181458,8402890623,179906,1552,394,280,0x1Fa8559e873f698292766790AeCf8080A66433F6,0x72636Fa84883A0DBE1CBCc4ab000a4c40D7520C0
8382,15627888,178398,8402890623,178194,204,74,2360,0x645E9324f4be25be581BB62163cfa86c40b01D07,0xc5009AFEd2D6DA219538aD165998F63B553185B1
8383,15627888,181476,8402890623,179912,1564,394,319,0x1Fa8559e873f698292766790AeCf8080A66433F6,0x75Fd540272760d97cfD858b2C811140812Ae67E6
8384,15627888,181476,8402890623,179912,1564,394,899,0x1Fa8559e873f698292766790AeCf8080A66433F6,0xa9c28Eb83763D33eBEb279109f1b3913774fB01C
8385,15627888,181476,8402890623,179912,1564,394,502,0x1Fa8559e873f698292766790AeCf8080A66433F6,0x842EeeDC1DF82493636ea94345E933b40ED5FA63
8386,15627888,21000,8402890623,21000,0,2,35,0x9c9eA22B7DdC9A75c74A0fc22764163c164bef1E,0xE6eEeCc0E6df1ba46c6f5e00B74A920448d54A6a
8387,15627888,136120,8402890623,130148,5972,1674,12,0x00000000006c3852cbEf3e08E8dF289169EdE581,0x88EC22a9285AFC2381147aEAc07178021510be3D
8388,15627888,132361,8402890623,125921,6440,1674,11,0x00000000006c3852cbEf3e08E8dF289169EdE581,0xEC4a8bEfb811900607bF28E7958032E5fba71EA0
8389,15627888,181458,8402890623,179906,1552,394,723,0x1Fa8559e873f698292766790AeCf8080A66433F6,0xe5e9FfE707Ee071998340972AF6fb178f5C64bA6
8390,15627888,181476,8402890623,179912,1564,394,128,0x1Fa8559e873f698292766790AeCf8080A66433F6,0x369b313684770B3d3C3A7F43467F221701922884
8391,15627888,181476,8402890623,179912,1564,394,89,0x1Fa8559e873f698292766790AeCf8080A66433F6,0xC9AfD812b5AB91ed3FbE1e1088CCbE9125aae3a1
8392,15627888,55778,8348810112,54834,944,138,54,0xae78736Cd615f374D3085123A210448E74Fc6393,0xbEfce49591f31fb5C0383785f09B6fC67CB97f83
8393,15627888,21000,8348810112,21000,0,2,971,0x1C48aa57CE0aecE12Cb4c07939a44C21b34a9c9B,0x81D0A1c874c8f9A54C736B67d0c316751B8e6d91
8394,15627888,46337,8348810112,45849,488,138,95,0xB95aBD5fa9E71f1981505c3D9A7800c369b0718c,0x072B6AaC774fFe93371f8085D4a082EA8d92db3B
8395,15627888,65000,8155014746,64404,596,138,646171,0xdAC17F958D2ee523a2206206994597C13D831ec7,0x29D5527CaA78f1946a409FA6aCaf14A0a4A0274b
8396,15627888,240758,8134971775,234814,5944,1738,2,0x68b3465833fb72A70ecDF485E0e4C7bD8665Fc45,0xE66FfaE0AB6bfb46237f985FbbB52D5595fF1e12
8397,15627888,2000000,8107982960,1997940,2060,522,324,0x7a250d5630B4cF539739dF2C5dAcb4c659F2488D,0x158318657de819928C935ae3436Ae2a796bcd681
8398,15627888,65000,8084424162,64392,608,138,646172,0xdAC17F958D2ee523a2206206994597C13D831ec7,0x29D5527CaA78f1946a409FA6aCaf14A0a4A0274b
8399,15627888,36027,8000000000,35751,276,74,1134,0xC02aaA39b223FE8D0A0e5C4F27eAD9083C756Cc2,0xecDA2c559aDE78ff0A3B1e5cF0ECd0d23143827b
8400,15627888,21000,7727777444,21000,0,2,28,0x974CaA59e49682CdA0AD2bbe82983419A2ECC400,0x069674D9392230aa29A5B61F02E5E214a2105Cc3
8401,15627888,224794,7727777444,222970,1824,458,2198,0xEfF92A263d31888d860bD50809A8D171709b7b1c,0x1A63CD1aaF13e424DFA370D8D4dD326b5Fb4014a
8402,15627888,46280,7655326975,45420,860,138,176,0xC02aaA39b223FE8D0A0e5C4F27eAD9083C756Cc2,0x4eBf7489301FC3298B372164046AD3f7B0A0cC69
8403,15627888,324184,7638812448,300304,23880,5258,23857,0x5427FEFA711Eff984124bFBB1AB6fbf5E3DA1820,0xbfa2F68bf9Ad60Dc3cFB1cEF04730Eb7FA251424
8404,15627888,90000,7638812448,90000,0,2,154372,0xC156eA670BA14901283C329283a110185a0bAd6E,0xCBD6832Ebc203e49E2B771897067fce3c58575ac
8405,15627888,21000,7402890623,21000,0,2,255,0xE94f1fa4F27D9d288FFeA234bB62E1fBC086CA0c,0x25D88437dF70730122b73Ef35462435d187C466f
8406,15627889,216585,57993520072,214537,2048,522,1052,0x7a250d5630B4cF539739dF2C5dAcb4c659F2488D,0xA1CC352bC94caDdFddaA4D095762F37B2b9bc57A
8407,15627889,142716,13021388751,141140,1576,394,15995,0xaC6C28EA3cb8A7aE7536D6e101F1b9b1dc726d67,0x8A6a17F1A3DA0F407A67BF8E076Ed7F678D85f29
8408,15627889,70957,11697661238,70325,632,138,4709937,0xD46bA6D942050d489DBd938a2C909A5d5039A161,0x2FAF487A4414Fe77e2327F0bf4AE2a264a776AD2
8409,15627889,77846,11000000000,76894,952,202,70,0x2D0D57D004F82e9f4471CaA8b9f8B1965a814154,0x3bd75973B3A6Bd6eB69632898182B0677216b064
8410,15627889,122429,10993520072,121677,752,138,192817,0xDBd324B73f6f85bf9013B75C442021303b635Ff9,0x19f494583c7C933be7B0eE58104DDaFac1E8aDfA
8411,15627889,21000,10993520072,21000,0,2,0,0x0c8B1477dDb62De899E8E5CCab80b81bAf3950D8,0x9E295f465136F48b518126cC6ef714d82E43F67B
8412,15627889,21000,10993520072,21000,0,2,5611,0xfDA7c14C6fD4aF8EFA3822B642e6c94E22E8ff7D,0x2Cc3941D7E7a3Fa5d55D75b25748e497e4F83C46
8413,15627889,500000,10993520072,497824,2176,586,60929,0x585C3d4Da9b533C7e3dF8AC7356C882859298cEe,0xd5cf0Cb9a8DF9B46f077f561d8b76c34A69bD82F
8414,15627889,150756,10493520072,150692,64,10,2,0x65c2e54a4c75ff6da7b6B32369c1677250075fb2,0xA5256793A152226A10fEBD38Fc2B267e5feca5fA
8415,15627889,21000,10043520072,21000,0,2,12,0x92dA9fBb421Da8f65AB61dA0E8Bb972845fb7c5D,0xf163d3b60b1E152F5794837B3d69927224Bf17F4
8416,15627889,191041,10000000000,190165,876,266,1399,0xd588b586D61C826A0e87919b3D1a239206d58bf2,0xC22d03e13B888Dabb33A1575e4F6542f0e996622
8417,15627889,140088,9993520072,138524,1564,394,59,0x1Fa8559e873f698292766790AeCf8080A66433F6,0xb6508c3A818DCea325844E4DA6dF5Be0b17B81aB
8418,15627889,300000,9993520072,299392,608,138,62462,0xdAC17F958D2ee523a2206206994597C13D831ec7,0xD65E0Cbd31977B2E0e23c8330C8B5f020818Fc91
8419,15627889,140088,9993520072,138524,1564,394,56,0x1Fa8559e873f698292766790AeCf8080A66433F6,0x1C48027E811f2977a2c9dEf50b986f09506a987F
8420,15627889,140088,9993520072,138524,1564,394,54,0x1Fa8559e873f698292766790AeCf8080A66433F6,0x50Ecc56F2B4298E55590ae751e18f6AE3f733236
8421,15627889,140088,9993520072,138524,1564,394,51,0x1Fa8559e873f698292766790AeCf8080A66433F6,0x040934acD906e9fFdA7911ed648466c578570AEC
8422,15627889,140088,9993520072,138524,1564,394,48,0x1Fa8559e873f698292766790AeCf8080A66433F6,0x6A6Db29756ae584415B33EB34Cccdf12458159E8
8423,15627889,140088,9993520072,138524,1564,394,51,0x1Fa8559e873f698292766790AeCf8080A66433F6,0x5A1c27092FCEAd0712aD25dcF1757B86fAd6c820
8424,15627889,140088,9993520072,138524,1564,394,48,0x1Fa8559e873f698292766790AeCf8080A66433F6,0x80EaF02E33e813c86617d6Da1c27387323A48bD1
8425,15627889,140088,9993520072,138524,1564,394,47,0x1Fa8559e873f698292766790AeCf8080A66433F6,0x48079A80A7a3c9F93Bf85c0136b110d3dB15b7D1
8426,15627889,140088,9993520072,138524,1564,394,47,0x1Fa8559e873f698292766790AeCf8080A66433F6,0x2DCC61d43115680305aC9f289043978F6E23486b
8427,15627889,181476,9993520072,179912,1564,394,297,0x1Fa8559e873f698292766790AeCf8080A66433F6,0x661279325BcAbbA343E9368377BB20e53C79667B
8428,15627889,140088,9993520072,138524,1564,394,48,0x1Fa8559e873f698292766790AeCf8080A66433F6,0x997EDf3094041b81f1C6A0e91610b73A7EAD9b61
8429,15627889,46458,9993520072,45514,944,138,487,0x6B175474E89094C44Da98b954EedeAC495271d0F,0x2EceCf5a33d038694133BbF3A22AEAFBc96d4B04
8430,15627889,140073,9993520072,138521,1552,394,51,0x1Fa8559e873f698292766790AeCf8080A66433F6,0xc1F19aa36a3b749aEDE4Ae3aA7108AC172F8BF67
8431,15627889,140073,9993520072,138521,1552,394,47,0x1Fa8559e873f698292766790AeCf8080A66433F6,0x8AbEEEbb381b0465Ff3851385eC95aa1F7B69F73
8432,15627889,42000,9993520072,42000,0,2,329548,0xA836835bE58Bc645e7340393B6007392066DBdA2,0x9430801EBAf509Ad49202aaBC5F5Bc6fd8A3dAf8
8433,15627889,140088,9993520072,138524,1564,394,47,0x1Fa8559e873f698292766790AeCf8080A66433F6,0xAD54F9414D1875Fcc37Bf53dD54b9aBb7F226890
8434,15627889,140088,9993520072,138524,1564,394,47,0x1Fa8559e873f698292766790AeCf8080A66433F6,0x2511Ccb7f202CbC7c1aF1629E123107f172674F2
8435,15627889,140088,9993520072,138524,1564,394,46,0x1Fa8559e873f698292766790AeCf8080A66433F6,0x723DA307E13736BfEF1249C0bfF64cF82e12Ef05
8436,15627889,140088,9993520072,138524,1564,394,46,0x1Fa8559e873f698292766790AeCf8080A66433F6,0x3003186Cc51392483A3751EDD082dfF55a42C339
8437,15627889,140088,9993520072,138524,1564,394,45,0x1Fa8559e873f698292766790AeCf8080A66433F6,0xc2630B9f43cD7c67b16c5a8711C31B69d0679C9E
8438,15627889,140088,9993520072,138524,1564,394,48,0x1Fa8559e873f698292766790AeCf8080A66433F6,0xD46661BB2b4Fac1955433aDfB70A918A60D547C9
8439,15627889,140088,9993520072,138524,1564,394,47,0x1Fa8559e873f698292766790AeCf8080A66433F6,0x983631326474E47Fbb2C3E761d789D6B580eF3B6
8440,15627889,181476,9993520072,179912,1564,394,115,0x1Fa8559e873f698292766790AeCf8080A66433F6,0xc4271f3e82C986f13dcfA26795bEf52c384E3937
8441,15627889,140088,9993520072,138524,1564,394,50,0x1Fa8559e873f698292766790AeCf8080A66433F6,0x381764a53ADE742E5AB52b4FC5aEFFC72A31E5E1
8442,15627889,43537,9993520072,43345,192,74,1,0xd965e73b92b582638AB169f5B93609D4Ca5FBA13,0x3AAE1C87e79f5B62F2A35f168B7e8CE773225f11
8443,15627889,140073,9993520072,138521,1552,394,50,0x1Fa8559e873f698292766790AeCf8080A66433F6,0x01964Ce9AB3962cB9F3b227dea134Ba460fEEf99
8444,15627889,140088,9993520072,138524,1564,394,46,0x1Fa8559e873f698292766790AeCf8080A66433F6,0xA8Abf7adb928d56156bbFDb74DeC495EB5BB8220
8445,15627889,140088,9993520072,138524,1564,394,40,0x1Fa8559e873f698292766790AeCf8080A66433F6,0xe17953E204FB1a8B11f485B4bf3d4152Abd911fd
8446,15627889,85000,9993520072,84512,488,138,42,0xD27dcbcC8778a8AB33AAc529Df36a634567Be325,0x607d41C00Dd7A52A05D04955f583e120720eAd47
8447,15627889,85000,9993520072,84512,488,138,49,0xD27dcbcC8778a8AB33AAc529Df36a634567Be325,0x108357438fC002f8C89ddFab91a08f2eD0f2fC68
8448,15627889,274909,9993520072,270629,4280,1098,7,0xe66B31678d6C16E9ebf358268a790B763C133750,0x75B19D758eA70373DbfC67eF957884A84dEd5a51
8449,15627889,21000,9993520072,21000,0,2,9,0xBA88D544CA1387e77BB3586cE66637Fe94741452,0xADE3eb19EE238558ce16Bc76C0aDf26157497Be1
8450,15627889,140088,9993520072,138524,1564,394,41,0x1Fa8559e873f698292766790AeCf8080A66433F6,0xe483e2C1C79523EB88D63136676216311e3DEbb7
8451,15627889,140088,9993520072,138524,1564,394,40,0x1Fa8559e873f698292766790AeCf8080A66433F6,0x7C0440534Df078444F41CE56Df1BE26973104FB6
8452,15627889,44477,9993520072,42717,1760,522,540,0x1A90B3Dead0113740266b7F7Ea1136e8ED1b48C5,0xab18Dd4e8090dE887E50776d66A9924a648d5759
8453,15627889,140088,9993520072,138524,1564,394,38,0x1Fa8559e873f698292766790AeCf8080A66433F6,0xe06D6305EfAf0D3f378DC54461184d6deA9660e9
8454,15627889,140088,9993520072,138524,1564,394,38,0x1Fa8559e873f698292766790AeCf8080A66433F6,0x4378c5584257bCEDADC375660a11A053033068Be
8455,15627889,1000000,9930456182,992168,7832,2250,5,0xf18aCC02628009231d7BAAF9a7a24C0860Dda6cb,0xc5b27a5f60bCb24c4030adCE4B98fc24D75A749B
8456,15627889,21000,9752093381,21000,0,2,699,0xCBD6832Ebc203e49E2B771897067fce3c58575ac,0x2c29c876e0B63feC18e5ea174FFBe4f03e60c728
8457,15627889,21000,9543520072,21000,0,2,387,0xda32C9E44c143585856610de6F8395544fae61Ff,0xe23f741A565F4FD31DA3490b7Ef05351F6d250Bc
8458,15627889,21000,9494520072,21000,0,2,8347,0x4938df248CFd0F259c561Fa5c1d95Af32275DD8e,0x770E66bf008C0204a8231F4ea5C3Af12e5f580e4
8459,15627889,241566,9493520072,236662,4904,714,397,0x000000000000509081d6FCD3ee63e791aD1db763,0x6825E18426cb275E2de1cce47fB2ceE1571eFd72
8460,15627889,76148,9493520072,74780,1368,266,118,0x000000000000509081d6FCD3ee63e791aD1db763,0x866B719D3b7D79838492426b6C35fA14eb94f955
8461,15627889,49175,9493520072,48687,488,138,1052,0x7f738Ad7072187909384B2ffBaEEdC3C1DA1b686,0x2106d51212C82B481fa397d4C56b2eF98082d4F6
8462,15627889,61351,9493520072,53271,8080,2506,258,0x00000000006c3852cbEf3e08E8dF289169EdE581,0x27ec03bc3D8E020AdA91ACfd777d431083e63811
8463,15627889,331056,9493520072,328248,2808,650,1,0x3e445e3280C5747a188DB8d0aB7762838A50E4ff,0xeDf8ccF2f842920A0C52F648167C6ecdF72edFAF
8464,15627889,21000,9493520072,21000,0,2,246,0xF59e0c77bEc4463f1DbD8C117c4A97A0813047d7,0x5a2079450f5D9abdEA4996E88E6710F86838FE0b
8465,15627889,46551,9493520072,46063,488,138,1210,0x24d0cbD0D5D7b50212251c5dc7cb810E7aF71F6a,0xE9225f057A16F600C4eE2b6C169E93534381D0d0
8466,15627889,64677,9493520072,64105,572,138,523,0x0d02755a5700414B26FF040e1dE35D337DF56218,0xcf5e233BcB1f1B3536E0879Be2D3294049d7bfC7
8467,15627889,278821,9493520072,278617,204,74,475,0x55f1C36Bb7aE0d7D6caE97902E30A2306686Ec73,0x36151eF8bF252eB963235fd76245B98580D595F0
8468,15627889,21000,9493520072,21000,0,2,51,0x08E8C92B3637eA496e9C7205303118C137584a68,0x6fC138aB996cb01Ec4504b0A5cbC4c4f48E4AED4
8469,15627889,21000,9493520072,21000,0,2,471,0x11723a8dC2501F9eB4E79f5b74C24514a02A890d,0x8318777F8b8A1e81243Abb5e58B3483D2138F257
8470,15627889,100569,9493520072,100517,52,10,141,0x1F78bF06b1b14aaF29833Efa371fC090e11D1420,0xFF2C00c056Af3bF2dad57400C8249DEf4744AF7A
8471,15627889,21000,9493520072,21000,0,2,10,0xA80A38c11a5319e44752a879EBA889880F75d42F,0x2D2dDb169Cbc8eeB867A642cc45fF40Ec110d659
8472,15627889,21000,9493520072,21000,0,2,5,0x095c964E3067Ee522fAbFed748c5eCab6599dD3C,0xa933d55DC5b673803Ea1BA7375Ad0ec149d4825e
8473,15627889,70000,9493520072,69056,944,138,0,0xdAC17F958D2ee523a2206206994597C13D831ec7,0x30DCe637FeEDe6dB6Dd10aBef708eb012b7eEbBB
8474,15627889,288174,9493520072,285838,2336,522,16,0x283Af0B28c62C092C9727F1Ee09c02CA627EB7F5,0x49E6f9753F3eDdc19310195f46482c29FC354693
8475,15627889,46109,9493520072,45621,488,138,1237,0xF7b8aabC98D169020b9EE716FC55541cF3e8B55B,0x6F73736012cE8dAF37BC06CC78c78c4B3F4313C0
8476,15627889,60719,9493520072,53271,7448,2514,9,0x00000000006c3852cbEf3e08E8dF289169EdE581,0xEEb72aBBA44B1eB80F20C50eC370d3073DccF88E
8477,15627889,21000,9493520072,21000,0,2,18,0xD49C4eab9b614bF8AE0c21D9e9b751ad3Cae900a,0xb7C3Fa9AfB6231dF9eCb13dBFbcb0f82089fa6f0
8478,15627889,46135,9493520072,45647,488,138,20,0x1Fa8559e873f698292766790AeCf8080A66433F6,0xBbC3e60FeF8E921caF626c0FbF2d8De5C3A0c181
8479,15627889,133718,9493520072,128838,4880,1290,0,0x20F780A973856B93f63670377900C1d2a50a77c4,0x25Ac7D60726D113d64Ee4bE453A304cE4Ab57e4e
8480,15627889,223590,9493520072,220842,2748,842,181,0x68b3465833fb72A70ecDF485E0e4C7bD8665Fc45,0x66ace6CAa9Ec944735F73ed592a5E1ed22293F3a
8481,15627889,118268,9493520072,116012,2256,650,342,0xC45f3c76FeeEa53aAE5AFA9b51F166E025145400,0x3f9f89bBCC6302f2076c06FCdD18e4C824fBf941
8482,15627889,92151,9493520072,92087,64,10,69,0x4Dbd4fc535Ac27206064B68FfCf827b0A60BAB3f,0xCe6cd04f6f668685cF6cfe5C522F568a2AB100D6
8483,15627889,396843,9493520072,393239,3604,1162,38,0x68b3465833fb72A70ecDF485E0e4C7bD8665Fc45,0x6ECE6261bED04238050Cd8677C8E8c7Ad884a9be
8484,15627889,43040,9493520072,42444,596,138,2848,0xA0b86991c6218b36c1d19D4a2e9Eb0cE3606eB48,0x8B3f14F0582FbF275BE87d265C931B4dfD5F13B7
8485,15627889,67722,9493520072,65810,1912,394,7,0x23Ddd3e3692d1861Ed57EDE224608875809e127f,0xaa05A35aabA5CDD1230c51FE0289a01c7f73AAAa
8486,15627889,21000,9493520072,21000,0,2,142,0x000090EA76D0A1a79beaF9571b6fdA5F32c58888,0x888874E5ab7b4F0955Fc07f3400016Ab2e948888
8487,15627889,117533,9493520072,117341,192,74,3,0xfc33E8b6E160A81DdB442B07355D01DF711EFEee,0xaB451e5075C39f55744bA31D6F6c8DdBF480f1B0
8488,15627889,46267,9493520072,45691,576,74,565,0x283Af0B28c62C092C9727F1Ee09c02CA627EB7F5,0x9a6798BBB486AD11583f2f46f7dE0D6bB960c6EA
8489,15627889,56679,9493520072,55735,944,138,814,0x48818D6fd06cb03Eb36A95281742190afB3d3aA7,0xCfA7929D910B8D778e143766b4013De29BAD01b8
8490,15627889,552334,9493520072,541710,10624,3274,48,0xc30141B657f4216252dc59Af2e7CdB9D8792e1B0,0x3c74D5D6E0F55d75cc850c9AeE0Dda99Fbfd5415
8491,15627889,198075,9493520072,195291,2784,842,2642,0x68b3465833fb72A70ecDF485E0e4C7bD8665Fc45,0xC409134827440024347e27b2826dFd3D42A2967b
8492,15627889,116179,9493520072,115763,416,138,87,0x0b21144dbf11feb286d24cD42A7c3B0f90c32aC8,0x7EdE7d2de92305601617DfDA66c16e7dcF0fCD8A
8493,15627889,122512,9493520072,121264,1248,458,14,0x4e32004D8b81847A670b4a1778ACe4dCF2bBA01E,0x030ce9d143332f6D9c287414f08e22c145c43c58
8494,15627889,21000,9493520072,21000,0,2,447,0x63a560E2929DD0D6f72d342700959AE41B34D004,0x710AbAA993F7EEE4b80CD2Bc80eED5B4ae99165F
8495,15627889,500000,9493520072,497228,2772,650,1893237,0xD1669Ac6044269b59Fa12c5822439F609Ca54F41,0xD2C82F2e5FA236E114A81173e375a73664610998
8496,15627889,21000,9493520072,21000,0,2,126,0xb32688b5aD85dDE9A22d18E1e9eDdE7132267336,0x359021a0CD045Ce7eb2a5f44e69DF45214d921E1
8497,15627889,60751,9493520072,53271,7480,2506,8324,0x00000000006c3852cbEf3e08E8dF289169EdE581,0x8951F25aDcC7C3256dd9b521ED726fB587A46d52
8498,15627889,21000,9493520072,21000,0,2,3081,0x8ee043cabfd9375041A61e4Ad6253b4C70caC7b1,0x3D7262FD87aAe02A3CD659a27Fa3e41111Edd419
8499,15627889,46135,9493520072,45647,488,138,1108,0x1Fa8559e873f698292766790AeCf8080A66433F6,0x7Db5c1EFCEbE4ce04af24D3B9Ec2FFD528cF2493
8500,15627889,206824,9493520072,200284,6540,1802,259,0x00000000006c3852cbEf3e08E8dF289169EdE581,0x3A6D4c682E5f23c5782a5a8444Bc6f716e91b528
8501,15627889,181351,9493520072,178075,3276,1034,2511,0x68b3465833fb72A70ecDF485E0e4C7bD8665Fc45,0xbF2069baaC22473C3b7455cB335dDa4a2E523E5c
8502,15627889,289632,9493520072,287260,2372,522,213,0x283Af0B28c62C092C9727F1Ee09c02CA627EB7F5,0xb4a53b85a873A5fFa6fBe995E39107C9C1bCd935
8503,15627889,6329185,9493520072,5667405,661780,227986,1450,0x00000000006c3852cbEf3e08E8dF289169EdE581,0xB0bDD53b627d7e61cFC5C13EF110e47e210fAc6f
8504,15627889,56755,9493520072,55811,944,138,3,0xb5588C411ba0bb7D38865fdC51D082d004e519F7,0xC679F875351eFfdd3d35E6d18A52c1F45663841c
8505,15627889,72866,9493520072,71006,1860,458,112,0xFbdDaDD80fe7bda00B901FbAf73803F2238Ae655,0x17c852867106C351516D4ccC2bd5810D49B224B2
8506,15627889,181458,8993520072,179906,1552,394,386,0x1Fa8559e873f698292766790AeCf8080A66433F6,0xB59cEDeDA6E3f52e13De00E8D68704ca36ffc590
8507,15627889,181476,8993520072,179912,1564,394,1214,0x1Fa8559e873f698292766790AeCf8080A66433F6,0x12FebA52718411C91f0df6f77b84fc21bdeA31Db
8508,15627889,222528,8993520072,219744,2784,842,83,0x68b3465833fb72A70ecDF485E0e4C7bD8665Fc45,0x8F8d47F74C5E3144ab242e82Fa621D9A383C2df7
8509,15627889,250000,8993520072,250000,0,2,45337138,0x04a5A058CE41434B793742D24AbEEa6E4182EE31,0xEA674fdDe714fd979de3EdF0F56AA9716B898ec8
8510,15627889,250000,8993520072,250000,0,2,45337139,0x4D8f4fF0d9A3B051A6262DBFF2937338a48dD3DE,0xEA674fdDe714fd979de3EdF0F56AA9716B898ec8
8511,15627889,250000,8993520072,250000,0,2,45337140,0x66B80C0fD99fd834D48BA91D1AeBE54C65C7Bc56,0xEA674fdDe714fd979de3EdF0F56AA9716B898ec8
8512,15627889,250000,8993520072,250000,0,2,45337141,0xaB1FCa37eB2B42f0e764317d96655DBd580E220b,0xEA674fdDe714fd979de3EdF0F56AA9716B898ec8
8513,15627889,250000,8993520072,250000,0,2,45337142,0x0691f11e1B4005E0b7B2562d1F30cBF287f6f37B,0xEA674fdDe714fd979de3EdF0F56AA9716B898ec8
8514,15627889,250000,8993520072,250000,0,2,45337143,0xFC94293312d678Df0E3b728ef8d21e6397CcF015,0xEA674fdDe714fd979de3EdF0F56AA9716B898ec8
8515,15627889,250000,8993520072,250000,0,2,45337144,0x3942Bb438df14225E37ef183671777685eb8f583,0xEA674fdDe714fd979de3EdF0F56AA9716B898ec8
8516,15627889,250000,8993520072,250000,0,2,45337145,0x213A7b8B7739BF47185fA74AD431E49B837f981E,0xEA674fdDe714fd979de3EdF0F56AA9716B898ec8
8517,15627889,250000,8993520072,250000,0,2,45337146,0xdc515BdFF7Cf6Ac01c663d1A0Db4a939EcCEdf83,0xEA674fdDe714fd979de3EdF0F56AA9716B898ec8
8518,15627889,250000,8993520072,250000,0,2,45337147,0x2AA02F114076323FE1a1855DEf8b0BB11634BFad,0xEA674fdDe714fd979de3EdF0F56AA9716B898ec8
8519,15627889,181476,8993520072,179912,1564,394,24,0x1Fa8559e873f698292766790AeCf8080A66433F6,0x9453aaC0e8bBE62135e6e417Eb7abA51E08Cd10E
8520,15627889,181476,8993520072,179912,1564,394,1215,0x1Fa8559e873f698292766790AeCf8080A66433F6,0x12FebA52718411C91f0df6f77b84fc21bdeA31Db
8521,15627889,181458,8993520072,179906,1552,394,2002,0x1Fa8559e873f698292766790AeCf8080A66433F6,0x945ddC5135015685E49624F2D57Ea22d766883b1
8522,15627889,181476,8993520072,179912,1564,394,151,0x1Fa8559e873f698292766790AeCf8080A66433F6,0x983116fab27a029409D23AB62fC93e37e4FaC8F2
8523,15627889,181476,8993520072,179912,1564,394,480,0x1Fa8559e873f698292766790AeCf8080A66433F6,0x78221567eb9C560Fe129D9B39C1DC84A2274Fd5A
8524,15627889,175092,8993520072,173540,1552,394,677,0x1Fa8559e873f698292766790AeCf8080A66433F6,0x45A2235b9027eaB23FfcF759c893763F0019cBff
8525,15627889,181476,8993520072,179912,1564,394,2413,0x1Fa8559e873f698292766790AeCf8080A66433F6,0xfCF5B7d05bae6a12b02Dfb297EF8EB97EDDC8f52
8526,15627889,181458,8993520072,179906,1552,394,20,0x1Fa8559e873f698292766790AeCf8080A66433F6,0x4b8D63964c326Fef0Ba29327257F2c25E8937422
8527,15627889,21000,8567632990,21000,0,2,19,0xaD3038dD65D3E16eb197C684c4B7EfA67991be04,0x92Fe24369e36f090789705746e1824aa1d86B95f
8528,15627889,145922,8491855619,145350,572,138,371,0x7d2768dE32b0b80b7a3454c06BdAc94A69DDc7A9,0x907206D1Fb31AeB9E36Fdc98CE09F5B088bE56bF
8529,15627889,1887590,8229441897,309210,1578380,198282,7138,0x1c479675ad559DC151F6Ec7ed3FbF8ceE79582B6,0xa4b1E63Cb4901E327597bc35d36FE8a23e4C253f
8530,15627889,90000,8229441897,90000,0,2,154373,0xc182AfA3B02639e712af1c49B2c6bEd36898A3E7,0xCBD6832Ebc203e49E2B771897067fce3c58575ac
8531,15627889,318573,8229441897,159457,159116,20064,183252,0x5E4e65926BA27467555EB562121fac00D24E9dD2,0x6887246668a3b87F54DeB3b94Ba47a6f63F32985
8532,15627889,90000,8229441897,90000,0,2,154374,0x642503c04453F0aDdD2D2D95Ea83ad548F62CE0D,0xCBD6832Ebc203e49E2B771897067fce3c58575ac
8533,15627889,181476,8000000000,179912,1564,394,473,0x1Fa8559e873f698292766790AeCf8080A66433F6,0x61BCfE915b9B5ea4F7fc86189F95Dc5ffb817067
8534,15627889,84354,8000000000,84150,204,74,97,0x9b9D659D4f2cF68b6616Cc0a65683f1951Eb725C,0xaBEBF6c4BeD54C352a4ce4fC9162B3374ca6880b
8535,15627889,84354,8000000000,84150,204,74,96,0x9b9D659D4f2cF68b6616Cc0a65683f1951Eb725C,0xcA96CC95e5F714f9dDCe9531d2b5a1873a9C5B3B
8536,15627889,84354,8000000000,84150,204,74,99,0x9b9D659D4f2cF68b6616Cc0a65683f1951Eb725C,0xB4f1826F944E6B891371eCa2319a1bdE842624BE
8537,15627889,84354,8000000000,84150,204,74,101,0x9b9D659D4f2cF68b6616Cc0a65683f1951Eb725C,0x5b4068C24E00d522042924cBeC5952Fe146DF556
8538,15627889,84354,8000000000,84150,204,74,92,0x9b9D659D4f2cF68b6616Cc0a65683f1951Eb725C,0xCba4Ff22F56C909d3FD606bb57b6C75aA48F1B30
8539,15627889,84354,8000000000,84150,204,74,97,0x9b9D659D4f2cF68b6616Cc0a65683f1951Eb725C,0x02F7d1e2Acb99330eD542d18fcbA665940681279
8540,15627890,2000003,8292068188,1999255,748,130,66088,0x00000000003b3cc22aF3aE1EAc0440BcEe416B40,0xa6Ae57b1dA8238Cd149bC718c40578E4620b752c
8541,15627890,237244,8562003232,234388,2856,842,62,0x68b3465833fb72A70ecDF485E0e4C7bD8665Fc45,0x3f82cf523083b1d82e6407F88764fA4BE95b84C1
8542,15627890,476763,72781082343,475675,1088,168,66089,0x00000000003b3cc22aF3aE1EAc0440BcEe416B40,0xa6Ae57b1dA8238Cd149bC718c40578E4620b752c
8543,15627890,240904,8292068188,237084,3820,970,106632,0xa57Bd00134B2850B2a1c55860c9e9ea100fDd6CF,0x9AAb3F81604c683a1a0D14019FBfe15bef7aA1ee
8544,15627890,74777,10063638851,72941,1836,458,9966,0xFA103c21ea2DF71DFb92B0652F8B1D795e51cdEf,0x0D78FCF0a3E51124b2531A80950023f5Ba2E8FAc
8545,15627890,454638,8485028100,451842,2796,446,49931,0xED77777586D73C58EB4D6BEBDF9c85C2d5F56C2d,0x4425C20D8e84c48AEbEB116cF7b9838D4833f78D
8546,15627890,312543,58292068188,310495,2048,522,1053,0x7a250d5630B4cF539739dF2C5dAcb4c659F2488D,0xA1CC352bC94caDdFddaA4D095762F37B2b9bc57A
8547,15627890,5049432,17000000000,5042320,7112,1098,296,0x0a39DA505DfB5E0BBc6bd84428281A8ba1bC7753,0x495E889d1A6cEB447a57dcc1C68410299392380c
8548,15627890,101852,17000000000,101244,608,138,13,0xdAC17F958D2ee523a2206206994597C13D831ec7,0x9389Dca521546C3F8C8B52a3B325336c87e0154F
8549,15627890,101852,17000000000,101232,620,138,20,0xdAC17F958D2ee523a2206206994597C13D831ec7,0xB989D342749d54AC15ECc8a906291D714ED515b6
8550,15627890,684801,14302068188,682765,2036,522,350,0x7a250d5630B4cF539739dF2C5dAcb4c659F2488D,0x788296BAb7c874416c34BB5d7Bc0eb2170c97334
8551,15627890,650937,14292068188,647333,3604,1162,565,0x68b3465833fb72A70ecDF485E0e4C7bD8665Fc45,0x4207b21744413D37831833184559D46c49063656
8552,15627890,714915,13292068188,712843,2072,522,154,0x7a250d5630B4cF539739dF2C5dAcb4c659F2488D,0x5c7bfC47a62beB16f11c3881D437c59B0d08b84C
8553,15627890,93850,11996209354,93242,608,138,355158,0xdAC17F958D2ee523a2206206994597C13D831ec7,0x7abE0cE388281d2aCF297Cb089caef3819b13448
8554,15627890,82819,11996209354,82175,644,138,355159,0x7D1AfA7B718fb893dB30A3aBc0Cfc608AaCfeBB0,0x7abE0cE388281d2aCF297Cb089caef3819b13448
8555,15627890,350000,11003345334,350000,0,2,6925063,0xbFB31aE52470Ab3Db11B4029C585ed67250303A8,0x46340b20830761efd32832A74d7169B29FEB9758
8556,15627890,350000,11003345334,349380,620,138,6925064,0xA0b73E1Ff0B80914AB6fe0444E65848C4C34450b,0x46340b20830761efd32832A74d7169B29FEB9758
8557,15627890,111588,11000000000,109636,1952,330,9,0x00000000000C2E074eC69A0dFb2997BA6C7d2e1e,0x03cc71FBe5E1620f5a3D9aC2135642260ADC82bb
8558,15627890,104926,10792068188,104722,204,74,248,0x3F20958d3F58aa4f3c14c9350976721A0ACAC440,0x690959f13ab51c3c844f4F63408b7F3c1D3FaC21
8559,15627890,90000,10362737656,90000,0,2,784418,0x95e8AcBB6dF803E41B0E01F76d4985CE7d11480e,0xcaD621da75a66c7A8f4FF86D30A2bF981Bfc8FdD
8560,15627890,140073,10292068188,138521,1552,394,35,0x1Fa8559e873f698292766790AeCf8080A66433F6,0x64cEc638db1169ccDec09f373Db1444d6dB6E828
8561,15627890,21000,10292068188,21000,0,2,32,0x14515Ea5e45D552C65843F3aA5d7277b9832461d,0xEAd34ae54B70F62Ec511Cf5712dF4B5c1c012815
8562,15627890,140088,10292068188,138524,1564,394,36,0x1Fa8559e873f698292766790AeCf8080A66433F6,0xC0207f184537543A07e3C83aba0f79b80B26A8D6
8563,15627890,500000,10292068188,498272,1728,458,542322,0xa24787320ede4CC19D800bf87B41Ab9539c4dA9D,0xAe2D4617c862309A3d75A0fFB358c7a5009c673F
8564,15627890,247945,10292068188,242881,5064,1292,191,0x881D40237659C251811CEC9c364ef91dC08D300C,0x2E8Cc0C30E447c5679886E0D2B97aDA74664127D
8565,15627890,181476,10292068188,179912,1564,394,1591,0x1Fa8559e873f698292766790AeCf8080A66433F6,0xc7b438Bf83ad6f69BD8409bE5faF5C2dbde624e3
8566,15627890,181476,10292068188,179912,1564,394,1741,0x1Fa8559e873f698292766790AeCf8080A66433F6,0x83Bff380D2c59F88F3132542fb23B40AfCf361d7
8567,15627890,147050,10292068188,144158,2892,458,1137,0x000000000000509081d6FCD3ee63e791aD1db763,0xE0C9B6BeD7ecA8F9bCAaeC1763f73606967283c8
8568,15627890,261248,10292068188,256252,4996,1420,488,0x881D40237659C251811CEC9c364ef91dC08D300C,0x2EceCf5a33d038694133BbF3A22AEAFBc96d4B04
8569,15627890,105910,10292068188,105290,620,138,2,0xB4375E8aaCf0147aDf6B2a296c61Ad6141010c37,0x8Fbbb24Bf54C0Bf2BdD86A79a910e5d33d01F5B5
8570,15627890,90000,10292068188,89380,620,138,2,0xdAC17F958D2ee523a2206206994597C13D831ec7,0xC4dA28888949268A08Ea4441D65D7E49ea8F22cd
8571,15627890,42000,10292068188,42000,0,2,329549,0xEE29C39254ab2861f8e2dFA3531dC516EE88933d,0x9430801EBAf509Ad49202aaBC5F5Bc6fd8A3dAf8
8572,15627890,207128,10292068188,206520,608,138,1312157,0xA0b86991c6218b36c1d19D4a2e9Eb0cE3606eB48,0xf60c2Ea62EDBfE808163751DD0d8693DCb30019c
8573,15627890,287684,10292068188,285324,2360,522,608,0x283Af0B28c62C092C9727F1Ee09c02CA627EB7F5,0x476c8712bf3A84f5a04db2D6a81d374f3F1AAD99
8574,15627890,399748,10292068188,387908,11840,3666,638,0xDef1C0ded9bec7F1a1670819833240f027b25EfF,0x514E494c86F9249CfDc0e072f71f71a97cf33e65
8575,15627890,50000,10292068188,49056,944,138,0,0xdAC17F958D2ee523a2206206994597C13D831ec7,0xa2d53BC214Be4F91b088dfc06B00cBcA313bec77
8576,15627890,21000,10290000000,21000,0,2,0,0x6dfc34609a05bC22319fA4Cce1d1E2929548c0D7,0xb34c9dEC8E2F0d3320407664653Cf4c92935A978
8577,15627890,21000,10290000000,21000,0,2,0,0x6dfc34609a05bC22319fA4Cce1d1E2929548c0D7,0x43e6d6213FB0ee37E83564d384157EA5868A929c
8578,15627890,177500,9942068188,173872,3628,1162,7,0x68b3465833fb72A70ecDF485E0e4C7bD8665Fc45,0x7D35286C7d6864Cf6A61b4EC90F3d2FB6F8C7935
8579,15627890,21000,9880000000,21000,0,2,150,0x292f04a44506c2fd49Bac032E1ca148C35A478c8,0x5346BC9A21B1BB0Fe6EE152f5Af022cab65CE837
8580,15627890,46707,9792068188,46219,488,138,707,0xbef7Dcc0335Ec876e2DC530b883F34c8807d61fc,0x9b6cd0Ff5789748aA352a9257C13Be99126f3fB2
8581,15627890,94795,9792068188,94199,596,138,9,0xdAC17F958D2ee523a2206206994597C13D831ec7,0x27eFBdA32C394A41178f062c7EB7c438788e68f2
8582,15627890,181476,9792068188,179912,1564,394,113,0x1Fa8559e873f698292766790AeCf8080A66433F6,0x9857FE62D6dAcd4984E18a4c842CaCcA2DCB3B54
8583,15627890,132725,9792068188,132509,216,74,444,0x0Cd73c18C085dEB287257ED2307eC713e9Af3460,0x9d2BeEa6625c1991C796c498B93842d9E09cb6d6
8584,15627890,21000,9792068188,21000,0,2,8,0x9C43bCd6775ecb5c1B2b850bC7F32b722C033b03,0x6eF314FE7C08Cb78D58Df1995dE6CdF2060435F9
8585,15627890,69951,9792068188,68223,1728,458,87,0x495f947276749Ce646f68AC8c248420045cb7b5e,0xe1C05f90F8dB55F81aFf56A3e394C6bFB1E8A48b
8586,15627890,1000000,9792068188,999380,620,138,4121141,0x467719aD09025FcC6cF6F8311755809d45a5E5f3,0x0D0707963952f2fBA59dD06f2b425ace40b492Fe
8587,15627890,62420,9792068188,61468,952,202,185,0x1Fa8559e873f698292766790AeCf8080A66433F6,0x97778A9765Afd22628492d3CEd63F315a90b08FA
8588,15627890,77181,9792068188,72841,4340,1290,444,0xFAf23F7626142F94327B5D53E76c0d055fb56177,0xC59f09cb676Fb3cA1b12BF88970B98583F99427C
8589,15627890,62420,9792068188,61468,952,202,1318,0x1Fa8559e873f698292766790AeCf8080A66433F6,0x4642D9D9A434134CB005222eA1422e1820508d7B
8590,15627890,62420,9792068188,61468,952,202,130,0x1Fa8559e873f698292766790AeCf8080A66433F6,0xbA8aF0EfD302912F3C0b86F1515ff6c0e8DC1c5e
8591,15627890,62420,9792068188,61468,952,202,130,0x1Fa8559e873f698292766790AeCf8080A66433F6,0x18f52F45A11F8209dcEe5516853D586e2Fd17AB9
8592,15627890,67544,9792068188,66068,1476,458,100,0x5BABc381C7E9EdCF02654a9C30d384dFE54dd4A1,0x066DC123977849dF818ed709B375E73123E45179
8593,15627890,21000,9792068188,21000,0,2,1234,0x791B61E3198bcFBf83530073F89B896DA85C56CA,0xe8f16d37b37F2D0aC1Cbc2aa77ACad060E8E6127
8594,15627890,62420,9792068188,61468,952,202,121,0x1Fa8559e873f698292766790AeCf8080A66433F6,0xbD85b2C2eaFDBe27027C47B9ce3433dC05Bdd2A8
8595,15627890,21000,9792068188,21000,0,2,88,0x0B40c58E28e0bbbcA0feB3d51F64887d4D8C27E7,0x9fec0B651a5624687001BCc24e86958a2750ba0a
8596,15627890,62420,9792068188,61468,952,202,117,0x1Fa8559e873f698292766790AeCf8080A66433F6,0x0A3A97128b69A2bb1cF7213C146807B416d7184B
8597,15627890,62420,9792068188,61468,952,202,72,0x1Fa8559e873f698292766790AeCf8080A66433F6,0xC75c47EFE37bB48Eb5e470f28806DB7921E26Cc8
8598,15627890,21000,9792068188,21000,0,2,1696,0x13c7EE16Ebd8a2f34dF4D24af490Cb35c2E726f8,0x888142764db044b978b21c66b5F1301F002FFE84
8599,15627890,298210,9792068188,295426,2784,842,172,0x68b3465833fb72A70ecDF485E0e4C7bD8665Fc45,0xdF5b47c2da00c1666c365f20521D08E860167539
8600,15627890,62420,9792068188,61468,952,202,86,0x1Fa8559e873f698292766790AeCf8080A66433F6,0x56E88FFdBd822DB2E85F97C70835Ca6Df2928a53
8601,15627890,21000,9792068188,21000,0,2,363,0x50686DC306E5B30Ff4330B494B35161C9169BbCF,0xf71811d06774EF52d0c6f47B1D59236D87A9e7eB
8602,15627890,89173,9792068188,88969,204,74,43,0x8cFC27c666a31638AD5Cce720c5d09373517F58b,0xBfFEa57972fc6BD0498992CE29FFb8c14B904327
8603,15627890,62420,9792068188,61468,952,202,83,0x1Fa8559e873f698292766790AeCf8080A66433F6,0x9A77e4300bc214F8172Eb6A1e45DE8f7f837130f
8604,15627890,56785,9792068188,56225,560,138,15,0xD95Be0e49472927AdAd417e5E62e2f087b8E210c,0x682Cad157D79d73Eb1D93d036B438d6F05084736
8605,15627890,265686,9792068188,262558,3128,906,168,0x68b3465833fb72A70ecDF485E0e4C7bD8665Fc45,0xa4e5ee3142C8F17797018A729A2007f00a89A27D
8606,15627890,62420,9792068188,61468,952,202,57,0x1Fa8559e873f698292766790AeCf8080A66433F6,0xeC11A96D31f4A94D944db9E5a184de02033f3B5b
8607,15627890,62420,9792068188,61468,952,202,35,0x1Fa8559e873f698292766790AeCf8080A66433F6,0x5025aa046E1b92bA78A53E4b2D88DFCA273d71bb
8608,15627890,62420,9792068188,61468,952,202,64,0x1Fa8559e873f698292766790AeCf8080A66433F6,0xf35de8A66c78e260e7CAFaEf199Eddd1523168f1
8609,15627890,244796,9792068188,242024,2772,842,3392,0x68b3465833fb72A70ecDF485E0e4C7bD8665Fc45,0x3D61d3da40a372CA317832717d7E6205cEDb439b
8610,15627890,56713,9792068188,55769,944,138,2444,0x83C141Ee88c502cB9654DE93598e9F16555082A8,0xb58E6c465544920F3F403D56E68d67DC14298E7e
8611,15627890,56659,9792068188,55715,944,138,630,0xba60672a655fB952404f8F8942112Ed4C3233fEd,0x944A75Fdeec101544978A8A37EFF27d075F1242b
8612,15627890,62406,9792068188,61466,940,202,103,0x1Fa8559e873f698292766790AeCf8080A66433F6,0x51AdF810b64CAeF8863C4E193AD2f22c285F9700
8613,15627890,149645,9792068188,143045,6600,1802,128,0x00000000006c3852cbEf3e08E8dF289169EdE581,0xb03cB3d3df64c627096A497362792Ea01A38E1F2
8614,15627890,223107,9792068188,220359,2748,842,859,0x68b3465833fb72A70ecDF485E0e4C7bD8665Fc45,0x5E56B1E1e323454578319a7455cB3888Aa58d34E
8615,15627890,62420,9792068188,61468,952,202,43,0x1Fa8559e873f698292766790AeCf8080A66433F6,0x1D9cb883c3b9083fa4Ad71828824cC56e2d5a69d
8616,15627890,99786,9792068188,97906,1880,330,310,0x000000000000509081d6FCD3ee63e791aD1db763,0x8F1ce698746D93B06152066ED8DBE359245AbA65
8617,15627890,877758,9792068188,877114,644,138,21,0x7c0bF1108935e7105E218BBB4f670E5942c5e237,0x1E759C0af530cc66D0E0283Aa0748a79Dc9228DF
8618,15627890,55941,9792068188,54997,944,138,37,0x9aE380F0272E2162340a5bB646c354271c0F5cFC,0x3816e1adA945f0a4495036D8F7E852A82495F4f4
8619,15627890,71709,9792068188,69513,2196,458,435,0x74312363e45DCaBA76c59ec49a7Aa8A65a67EeD3,0xA68462CC81379c95A35E023fdDDae6c6739E9267
8620,15627890,62420,9792068188,61468,952,202,38,0x1Fa8559e873f698292766790AeCf8080A66433F6,0x91974Ba06274AEE0D38d2ba92a29AE395980E442
8621,15627890,62420,9792068188,61468,952,202,39,0x1Fa8559e873f698292766790AeCf8080A66433F6,0x49046cFDfBb7db6F0153Ae35244C84C812559B6A
8622,15627890,62420,9792068188,61468,952,202,38,0x1Fa8559e873f698292766790AeCf8080A66433F6,0x16F767e7E86F74C0A51e78CD90ed0244fd96FD07
8623,15627890,78520,9792068188,77888,632,138,16,0x12b6893cE26Ea6341919FE289212ef77e51688c8,0x458516d45A06C6703058A10c19404EF4c1809145
8624,15627890,62420,9792068188,61468,952,202,38,0x1Fa8559e873f698292766790AeCf8080A66433F6,0xc89777565E8E2E47148428351C25F3341d6D95ac
8625,15627890,158983,9792068188,156199,2784,842,166,0x68b3465833fb72A70ecDF485E0e4C7bD8665Fc45,0x913e1f1bd40202bfa82447Be99E03Bc1E2DB43d3
8626,15627890,21000,9792068188,21000,0,2,53,0xfBccbDf92f1033D260ea8B9E74F44Cf04ae233f4,0xD06a1dba2aFD6DfE08815241bbC4c86807580D06
8627,15627890,62420,9792068188,61468,952,202,35,0x1Fa8559e873f698292766790AeCf8080A66433F6,0x41158b5b055Ca84Fc592EB245a38bECd2A7641fB
8628,15627890,62420,9792068188,61468,952,202,39,0x1Fa8559e873f698292766790AeCf8080A66433F6,0x5A6D34D9bb93208cB81557cd68F8Ffc27A8Dcd56
8629,15627890,188106,9792068188,184478,3628,1162,284,0x68b3465833fb72A70ecDF485E0e4C7bD8665Fc45,0xf74e644D030D378Ce753FC45A5d4b0aF06E5d0E5
8630,15627890,62420,9792068188,61468,952,202,37,0x1Fa8559e873f698292766790AeCf8080A66433F6,0x37845bc99d6C52EBb7b2CB4d82b5ea48EF8E912A
8631,15627890,142905,9792068188,136241,6664,1810,188,0x00000000006c3852cbEf3e08E8dF289169EdE581,0x0e662b85D7Fd9F677758bC2fC11f668CDf05f33f
8632,15627890,62420,9792068188,61468,952,202,27,0x1Fa8559e873f698292766790AeCf8080A66433F6,0x95374F65F3D140673Bf4A116e5C87C966D5126dA
8633,15627890,333007,9792068188,327331,5676,1802,705,0xC36442b4a4522E871399CD717aBDD847Ab11FE88,0x7355cA5613e3c943F6df3652E7fc4e4A8b800976
8634,15627890,21000,9792068188,21000,0,2,1959,0xF845d0f22aF9453DB855dF6D135a41c6A0Bf6195,0x0A73E98d1B7790a902D501F976155B6A8964274b
8635,15627890,1261679,9792068188,1152215,109464,37970,366,0x00000000006c3852cbEf3e08E8dF289169EdE581,0x26DC5D39Bd7A8bc2d792dcAAAC55FE6DCef25593
8636,15627890,144505,9792068188,137953,6552,1802,112,0x00000000006c3852cbEf3e08E8dF289169EdE581,0x31586F11D563E897A16CFAC38F0bbb61DdEEe051
8637,15627890,46193,9792068188,45705,488,138,241,0x6E188BcBFc30A461C83Edc70601cb088F560B730,0xB14fC342cE8DfE6C5a95B15806A8C94db2077ac4
8638,15627890,27624,9792068188,21000,6624,1034,2146,0x5444c71CDD5Ed85B6D51A297175Bf71914E7944d,0x4096859eF63422F1d9010dF09a586525EDEA2AF1
8639,15627890,21000,9792068188,21000,0,2,74,0x79A3fa90208Fd404116f471Ec3c9A3548C630B60,0x448DF7c119606947f3708d80693877997d55958C
8640,15627890,21000,9735973204,21000,0,2,14,0xCBD6832Ebc203e49E2B771897067fce3c58575ac,0xB94EDEA74B53877e0e9eeEA6E3D226b08faa1450
8641,15627890,21000,9620027188,21000,0,2,48,0x9A1f30b2f302E6262e05187d9920dF3EdB9d33B8,0xC085d713011f901f468E6365F37ae3F592755398
8642,15627890,100000,9600000000,99024,976,202,705888,0xdAC17F958D2ee523a2206206994597C13D831ec7,0x6dfc34609a05bC22319fA4Cce1d1E2929548c0D7
8643,15627890,181476,9292068188,179912,1564,394,2438,0x1Fa8559e873f698292766790AeCf8080A66433F6,0xCd3AB1B57C4d6c28860a85FD59f39563F310A664
8644,15627890,112884,9292068188,112820,64,10,81,0xb55e1442EDA37d31249f97b3fCA6DEF588346FeF,0x98acE532AF75e0321CCC34A3F1c56192e5896512
8645,15627890,181476,9292068188,179912,1564,394,1407,0x1Fa8559e873f698292766790AeCf8080A66433F6,0x67Da9c8F1Be7984898b4285717dE2aADe896e583
8646,15627890,181476,9292068188,179912,1564,394,1955,0x1Fa8559e873f698292766790AeCf8080A66433F6,0xD545aD1D535E88C017f4F27B7cDb9aA46c9308d5
8647,15627890,117533,9292068188,117341,192,74,7,0xfc33E8b6E160A81DdB442B07355D01DF711EFEee,0x6fDDfA63C80e222F8237D03D80D8B44Fe882f508
8648,15627890,181476,9292068188,179912,1564,394,65,0x1Fa8559e873f698292766790AeCf8080A66433F6,0xdE0c98c5c12386A2057D8450120D4F84593197e6
8649,15627890,181476,9292068188,179912,1564,394,274,0x1Fa8559e873f698292766790AeCf8080A66433F6,0x134b4Ccb9D178F893687948337AAC079cC5F55ec
8650,15627890,181458,9292068188,179906,1552,394,12,0x1Fa8559e873f698292766790AeCf8080A66433F6,0xD253196770d8981C20a1fc7300Bf3435e9EB0484
8651,15627890,181476,9292068188,179912,1564,394,80,0x1Fa8559e873f698292766790AeCf8080A66433F6,0xA2498Fa74E122E3cD334EB24B9af73382CcF3557
8652,15627890,181476,9292068188,179912,1564,394,414,0x1Fa8559e873f698292766790AeCf8080A66433F6,0x0DE9a66f0F9b714c5b987BDCb37A5E2EF1bDA67A
8653,15627890,21000,9292068188,21000,0,2,9,0x9808B6d5F683311f884E66B2e1e44488fd3e3DB6,0xEe2439BF2434bB3849B3c86357CD493BaECdd39d
8654,15627890,175110,9292068188,173546,1564,394,487,0x1Fa8559e873f698292766790AeCf8080A66433F6,0xF7f5090cf84771bE616d738fefC5092F33f87B74
8655,15627890,181476,9292068188,179912,1564,394,883,0x1Fa8559e873f698292766790AeCf8080A66433F6,0xD5C6dDd042bAB642ff556B632841232E0D290ba8
8656,15627890,21000,9292068188,21000,0,2,6,0x06C9E7aC0a73A418c5f004B6d948C8569103A130,0x758f86C6F8B9a5bda9BE7786e72E75bC907Aa382
8657,15627890,181476,9292068188,179912,1564,394,1089,0x1Fa8559e873f698292766790AeCf8080A66433F6,0x1d52c0E4888c01c5B26eFB2E68a137732A9495A2
8658,15627890,21000,9292068188,21000,0,2,58,0x121426c00F2eC9fC099e0288Efb79bD065428479,0x040bd87Bc49D77202DcBe80583ef592bfa5bDC46
8659,15627890,181476,9292068188,179912,1564,394,1548,0x1Fa8559e873f698292766790AeCf8080A66433F6,0xfFf9B4549714351868f05185f6664071a98D11A3
8660,15627890,120000,9292068188,119392,608,138,1157,0xdAC17F958D2ee523a2206206994597C13D831ec7,0x1255F66836d7d9abEb7dfFaDE3d303c5C74f0822
8661,15627890,21000,9292068188,21000,0,2,2,0x9B40c539eF01a8Cb4534A78fb57cE566be3704f1,0x186Bb6e7549569D2507822fC535e4d05d0CC9f66
8662,15627890,21000,9170000000,21000,0,2,35,0x292f04a44506c2fd49Bac032E1ca148C35A478c8,0x42525B10C8472a5446021A2222465180A21aBACa
8663,15627890,65000,8993520072,64392,608,138,646173,0xdAC17F958D2ee523a2206206994597C13D831ec7,0x29D5527CaA78f1946a409FA6aCaf14A0a4A0274b
8664,15627890,21000,8784634316,21000,0,2,0,0x6e96bBB46bf813C88260Dcf3269E7F17B0C63a08,0x31C8072488136D04CCbe92BeCC8a38B181b63A50
8665,15627890,21000,8784634316,21000,0,2,0,0x6e96bBB46bf813C88260Dcf3269E7F17B0C63a08,0xf168c3e632d53DfF9d83a690e61492D8637A4fb6
8666,15627890,46267,8562003232,45691,576,74,178,0x283Af0B28c62C092C9727F1Ee09c02CA627EB7F5,0x465169037Da9f80F3bA4bf6d3e6DA74e5c1BE182
8667,15627890,171306,8527990013,153450,17856,2378,3338,0xdE7355C971A5B733fe2133753Abd7e5441d441Ec,0x5558c63d5bf229450995adc160c023C9F4d4bE80
8668,15627890,90000,8527990013,90000,0,2,154375,0x0da190D6a9d6C616329955414cFB44b2A3e4ad6C,0xCBD6832Ebc203e49E2B771897067fce3c58575ac
8669,15627890,45038,8402890623,44974,64,10,171,0xC02aaA39b223FE8D0A0e5C4F27eAD9083C756Cc2,0xe7184D38e439C2065F3b458f2a7ee18ee6E979C4
8670,15627890,30000,8292068188,30000,0,2,3674,0x388C818CA8B9251b393131C08a736A67ccB19297,0xF2f5C73fa04406b1995e397B55c24aB1f3eA726C
8671,15627891,209422,10164297506,205962,3460,1354,2447,0x83C8F28c26bF6aaca652Df1DbBE0e1b56F8baBa2,0xE0c839498929221c7e76616919171E035AaaBB30
8672,15627891,140088,10164297506,138524,1564,394,33,0x1Fa8559e873f698292766790AeCf8080A66433F6,0xF9d4bAe2Bcc69F42562f4FDE67735e81b83121d8
8673,15627891,140059,10164297506,138519,1540,394,42,0x1Fa8559e873f698292766790AeCf8080A66433F6,0x47f55532f23F62fA535CA740df3aEdF1A4777D40
8674,15627891,140088,10164297506,138524,1564,394,20,0x1Fa8559e873f698292766790AeCf8080A66433F6,0x1d13b25B8F69f7d62bD3B24234576968baE670c0
8675,15627891,140088,10164297506,138524,1564,394,36,0x1Fa8559e873f698292766790AeCf8080A66433F6,0xc65EF93D01b70c6211de41b33D1c92bC44372b1E
8676,15627891,140088,10164297506,138524,1564,394,33,0x1Fa8559e873f698292766790AeCf8080A66433F6,0x1e585fe427C75d5020612A87234ab3d19273DEaa
8677,15627891,140088,10164297506,138524,1564,394,19,0x1Fa8559e873f698292766790AeCf8080A66433F6,0x0f0c977CFf6e47728641eDDFbCCEe80c95CaAb6d
8678,15627891,140088,10164297506,138524,1564,394,31,0x1Fa8559e873f698292766790AeCf8080A66433F6,0x616139aA4403A4297F1d1C48f2ced824BEA8e44C
8679,15627891,140073,10164297506,138521,1552,394,28,0x1Fa8559e873f698292766790AeCf8080A66433F6,0xA89F127af3D14B0C4895Bb78546bfF81FC40D9AF
8680,15627891,140088,10164297506,138524,1564,394,20,0x1Fa8559e873f698292766790AeCf8080A66433F6,0x432010c0770DC349d3EA4f89c569EB29CC1AdA83
8681,15627891,140088,10164297506,138524,1564,394,747,0x1Fa8559e873f698292766790AeCf8080A66433F6,0x39fEc995C2b9776B2aa22a49f61D45aF3f1a2570
8682,15627891,140088,10164297506,138524,1564,394,30,0x1Fa8559e873f698292766790AeCf8080A66433F6,0x402AC2bAa89406E2411aC21cDBEF6968ffedAA8b
8683,15627891,140088,10164297506,138524,1564,394,33,0x1Fa8559e873f698292766790AeCf8080A66433F6,0x3d674a79B2E681bebf4b66F47aadB0F7ccD6846e
8684,15627891,140088,10164297506,138524,1564,394,20,0x1Fa8559e873f698292766790AeCf8080A66433F6,0xcf4C14da5b46113417CdE2e278241249D344acF6
8685,15627891,140088,10164297506,138524,1564,394,35,0x1Fa8559e873f698292766790AeCf8080A66433F6,0xbf34307b0D8eaC1C85C49E518C89657e7C9c76c6
8686,15627891,140073,10164297506,138521,1552,394,35,0x1Fa8559e873f698292766790AeCf8080A66433F6,0xc2Eb55aB0B92039cDEF6Df8DA4B2515E9d1C6646
8687,15627891,140088,10164297506,138524,1564,394,20,0x1Fa8559e873f698292766790AeCf8080A66433F6,0xF84BdB4f060bCe8F5Ff475Fd600bAB7F4C60F6E6
8688,15627891,193773,10164297506,186961,6812,1746,2340,0x00000000006c3852cbEf3e08E8dF289169EdE581,0xc44C70fBFEf750862fbCf73F5197a28bCAA11253
8689,15627891,140073,10164297506,138521,1552,394,34,0x1Fa8559e873f698292766790AeCf8080A66433F6,0xe631ff49Bf7c1F123b6ae4cE374832cf9c731900
8690,15627891,140088,10164297506,138524,1564,394,19,0x1Fa8559e873f698292766790AeCf8080A66433F6,0x9994c88fE774167CbeCf5BCA2ac9e9dBb746848f
8691,15627891,140088,10164297506,138524,1564,394,21,0x1Fa8559e873f698292766790AeCf8080A66433F6,0x6A3b85CE69E912F6a6ea7b9fa0C9aBb3deb959eA
8692,15627891,140088,10164297506,138524,1564,394,19,0x1Fa8559e873f698292766790AeCf8080A66433F6,0xcE02c38A103e6Ba26f3Ae4a3E4498fC00e955Ae8
8693,15627891,140088,10164297506,138524,1564,394,37,0x1Fa8559e873f698292766790AeCf8080A66433F6,0xdC2fF1D00F9526967bA3148e09f764df2181e957
8694,15627891,140088,10164297506,138524,1564,394,21,0x1Fa8559e873f698292766790AeCf8080A66433F6,0x9EF4E545586131e6b64004a7c1fdE2a479523ff3
8695,15627891,140088,10164297506,138524,1564,394,19,0x1Fa8559e873f698292766790AeCf8080A66433F6,0x749e51f2a3E814594AF0BD3940d7258819688F5B
8696,15627891,140088,10164297506,138524,1564,394,46,0x1Fa8559e873f698292766790AeCf8080A66433F6,0x7B6926E0867F0b5aa80C396c611BC0F028f54716
8697,15627891,140088,10164297506,138524,1564,394,30,0x1Fa8559e873f698292766790AeCf8080A66433F6,0xdA69BFA7FB0952EC2621B908328B10ed04B75cb8
8698,15627891,140088,10164297506,138524,1564,394,36,0x1Fa8559e873f698292766790AeCf8080A66433F6,0x2cedae67bbF3643c3C313b11b8Ddbdd2D21773C2
8699,15627891,140088,10164297506,138524,1564,394,18,0x1Fa8559e873f698292766790AeCf8080A66433F6,0xc0a70737609c4C71Aa69f9C2bfED33E7d898FFDA
8700,15627891,140088,10164297506,138524,1564,394,20,0x1Fa8559e873f698292766790AeCf8080A66433F6,0x9d4caf23d30c575c32477855cA9D2F6c0dE81118
8701,15627891,140088,10164297506,138524,1564,394,34,0x1Fa8559e873f698292766790AeCf8080A66433F6,0x2a87A5540B85C20B27e2B4F5D6431572Ac67cE6c
8702,15627891,140088,10164297506,138524,1564,394,20,0x1Fa8559e873f698292766790AeCf8080A66433F6,0x7b5C5B2fA41db988C8cd8D53D269bf93d9dDb434
8703,15627891,140088,10164297506,138524,1564,394,34,0x1Fa8559e873f698292766790AeCf8080A66433F6,0xA8e0CE11d8a3D450e7668F3eFCb4446a3D328941
8704,15627891,140088,10164297506,138524,1564,394,20,0x1Fa8559e873f698292766790AeCf8080A66433F6,0x806d5EC16C5B17abA68b9F6912552308ba7526bC
8705,15627891,140088,10164297506,138524,1564,394,36,0x1Fa8559e873f698292766790AeCf8080A66433F6,0x93c99e20F45E80fE50dD4FA24F8D7a7b459960c5
8706,15627891,140073,10164297506,138521,1552,394,21,0x1Fa8559e873f698292766790AeCf8080A66433F6,0x5A21B8bF36bDCFcB93968b0Dcf17d8046a4D6937
8707,15627891,140088,10164297506,138524,1564,394,20,0x1Fa8559e873f698292766790AeCf8080A66433F6,0x8fa05Bd913a249c61cACA569BCeDcF901bAF7292
8708,15627891,140088,10164297506,138524,1564,394,46,0x1Fa8559e873f698292766790AeCf8080A66433F6,0x1F125c5024FA0b3378F577051Cb7FB8E8069bb35
8709,15627891,140088,10164297506,138524,1564,394,19,0x1Fa8559e873f698292766790AeCf8080A66433F6,0x3Ca3B3A8799c8c35eb7FeD43F95f20C1b883Df08
8710,15627891,140088,10164297506,138524,1564,394,20,0x1Fa8559e873f698292766790AeCf8080A66433F6,0x81E31a18a35d919445c0214a07b81AD53cf0Eeae
8711,15627891,181476,10164297506,179912,1564,394,624,0x1Fa8559e873f698292766790AeCf8080A66433F6,0x563f0CE76218D6207a7bf4fF3ddCc749A4A36cFE
8712,15627891,21000,9664297506,21000,0,2,9,0x8dda9a8931288D7baA59559D2529ED2225Eb8d36,0xa96ad89a1c44Ff55d2c3669a5B3fC283d6d11BB2
8713,15627891,69163,9664297506,68555,608,138,154,0xdAC17F958D2ee523a2206206994597C13D831ec7,0x2486C9FC111b30Db51390dE9568E9001caC45169
8714,15627891,78538,9664297506,77894,644,138,3,0x12b6893cE26Ea6341919FE289212ef77e51688c8,0x5bcb2050eA9A300DbBd56093eaF696D3Bc617089
8715,15627891,73170,9664297506,72574,596,138,32,0xA0b86991c6218b36c1d19D4a2e9Eb0cE3606eB48,0x2961617a37F0405F70BFc33D93c4418c088EDfa3
8716,15627891,21000,9664297506,21000,0,2,269,0x6BEaA0599214E6384CA51b668C083E87b45d912A,0x74845057b93742daB1e2cB72776eAE0da01Be921
8717,15627891,79555,9164297506,75687,3868,1162,7,0x4976fb03C32e5B8cfe2b6cCB31c09Ba78EBaBa41,0x456F7A537DB9D10A2EFE1888015023F7AC7565C0
8718,15627891,181476,9164297506,179912,1564,394,268,0x1Fa8559e873f698292766790AeCf8080A66433F6,0x504BbE90442553fA62D3cE1d9605406a5e4CB749
8719,15627891,46269,9052386087,45697,572,138,33,0x9b3B6974531d8AA15A87908FFd821A64863Ede5B,0x4e879eF3C9a62d06D33164F45D2ea7e86616D99D
8720,15627891,46269,9052386087,45697,572,138,32,0x9b3B6974531d8AA15A87908FFd821A64863Ede5B,0x148357d603BfD802ea7A9Cc1f7708Abe584575Fd
8721,15627891,600000,8229441897,599416,584,138,138576,0xdAC17F958D2ee523a2206206994597C13D831ec7,0x974CaA59e49682CdA0AD2bbe82983419A2ECC400
8722,15627892,600000,60000000000,597940,2060,522,2003,0x7a250d5630B4cF539739dF2C5dAcb4c659F2488D,0xe7c5DE03987777a18FF279A5e8d8A91Dd91db688
8723,15627892,420000,30000000000,419344,656,138,2198554,0x32353A6C91143bfd6C7d363B546e62a9A2489A20,0x6cC5F688a315f3dC28A7781717a9A798a59fDA7b
8724,15627892,500000,27513471074,497824,2176,586,60930,0x585C3d4Da9b533C7e3dF8AC7356C882859298cEe,0xd5cf0Cb9a8DF9B46f077f561d8b76c34A69bD82F
8725,15627892,5049560,17000000000,5042424,7136,1098,297,0x0a39DA505DfB5E0BBc6bd84428281A8ba1bC7753,0x495E889d1A6cEB447a57dcc1C68410299392380c
8726,15627892,21000,15400000000,21000,0,2,1,0x500A746c9a44f68Fe6AA86a92e7B3AF4F322Ae66,0xE9906beD5296e054D5df1bC08DaDeb36E9f994D9
8727,15627892,21000,14000000000,21000,0,2,1,0x500A746c9a44f68Fe6AA86a92e7B3AF4F322Ae66,0x4eBE9428Cf2Cb428c3dfE573dda6466CAdD78B33
8728,15627892,21000,14000000000,21000,0,2,2,0x500A746c9a44f68Fe6AA86a92e7B3AF4F322Ae66,0xd0160e189f30Ff994a5b1ccCB907f5B3995fE19C
8729,15627892,153837,12513471074,152809,1028,330,4069,0x6D7c44773C52D396F43c2D511B81aa168E9a7a42,0x0d1d74535bCAbda2dA2CfF5A53C2B899901D423B
8730,15627892,181476,12000000000,179912,1564,394,408,0x1Fa8559e873f698292766790AeCf8080A66433F6,0x84224a153fc8289617574F23e37A4DCC380cA8d9
8731,15627892,63000,11217612240,63000,0,2,2710059,0x706147a0116C414AA4c175eA6FCC0A3642B4f5f0,0xC098B2a3Aa256D2140208C3de6543aAEf5cd3A94
8732,15627892,63000,11217612240,63000,0,2,2710060,0xD06F1c44dc1aa389620DB9431C74f09e96F042c8,0xC098B2a3Aa256D2140208C3de6543aAEf5cd3A94
8733,15627892,181476,10513471074,179912,1564,394,200,0x1Fa8559e873f698292766790AeCf8080A66433F6,0x2551357b7c1e4b6D6B710da6b481cB8502B66ee2
8734,15627892,100000,10513471074,99056,944,138,26,0x9431DE2DFE10BDB30995bd3791dE03a6c9570054,0xccbB3A4ace14272c181f69588a86754b08854fd5
8735,15627892,650000,10513471074,648072,1928,522,27,0x7a250d5630B4cF539739dF2C5dAcb4c659F2488D,0xccbB3A4ace14272c181f69588a86754b08854fd5
8736,15627892,21000,10202918177,21000,0,2,3,0x252c6e14e37cF0B9FA49f97E996D0D2569DC3d57,0x0574CCE79d5cC2EA17d53E2Da5e7726eED8c4f80
8737,15627892,79702,10013471074,79498,204,74,204,0x373fFDf2a50003fb7E10282cF50e03921828e1a7,0xA7E5950FDc9c28502A04CB33f7E913476d9B7ddE
8738,15627892,100000,10000000000,100000,0,2,270671,0x88574D2D323C6d8b494e0C2e9376D674bD53Ba99,0x23f4569002a5A07f0Ecf688142eEB6bcD883eeF8
8739,15627892,21000,10000000000,21000,0,2,0,0xC88F7666330b4b511358b7742dC2a3234710e7B1,0xcd92086d21c3951979628325E11F341cb56234cF
8740,15627892,21000,9620027188,21000,0,2,141,0xAA3C8f230D54ED194CF9f5FeCc1DD7B515FA6C9e,0xB9188aea41bcbB9d850953837332DdDE4b41536D
8741,15627892,70000,9620027188,69392,608,138,3,0xdAC17F958D2ee523a2206206994597C13D831ec7,0x5674383117A10d870cb29a2a05203e05C1ee3DE3
8742,15627892,199701,9593471074,198257,1444,394,2,0x3b3ae790Df4F312e745D270119c6052904FB6790,0x538a29b825Ccfa936aD83d629c4F51c8253227ca
8743,15627892,100000,9584140542,99392,608,138,368502,0xdAC17F958D2ee523a2206206994597C13D831ec7,0xeC30d02f10353f8EFC9601371f56e808751f396F
8744,15627892,80000,9584140542,79404,596,138,1050389,0x9355372396e3F6daF13359B7b607a3374cc638e0,0xf16E9B0D03470827A95CDfd0Cb8a8A3b46969B91
8745,15627892,80000,9584140542,79404,596,138,1050390,0x9355372396e3F6daF13359B7b607a3374cc638e0,0xf16E9B0D03470827A95CDfd0Cb8a8A3b46969B91
8746,15627892,700000,9584140541,698160,1840,466,9278,0x81153f0889Ab398C4acb42CB58B565A5392bba95,0x0D0B3F21d7c90d0b957Aa6aCBc993621311208E4
8747,15627892,185472,9546330575,183496,1976,522,11,0x53e0e51b5Ed9202110D7Ecd637A4581db8b9879F,0x8448aC1314d61791967eb446D1aCebE0aF3463D2
8748,15627892,46609,9513471074,45665,944,138,18,0xa47c8bf37f92aBed4A126BDA807A7b7498661acD,0xd5ABb7f978ABB356E75A6d5266a8DB45677b378B
8749,15627892,207128,9513471074,207128,0,2,1679534,0x533F22A4FBed1d5f6c91B4F702c3F438E17a029A,0x4976A4A02f38326660D17bf34b431dC6e2eb2327
8750,15627892,207128,9513471074,206520,608,138,3199181,0xdAC17F958D2ee523a2206206994597C13D831ec7,0x9696f59E4d72E237BE84fFD425DCaD154Bf96976
8751,15627892,207128,9513471074,206472,656,138,4232347,0x3845badAde8e6dFF049820680d1F14bD3903a5d0,0xDFd5293D8e347dFe59E90eFd55b2956a1343963d
8752,15627892,207128,9513471074,207128,0,2,3492287,0xa444DA422D8382A19761Dc10b15A11EDc6D5cAF3,0x56Eddb7aa87536c09CCc2793473599fD21A8b17F
8753,15627892,288660,9513471074,282784,5876,1548,19,0x881D40237659C251811CEC9c364ef91dC08D300C,0xd5ABb7f978ABB356E75A6d5266a8DB45677b378B
8754,15627892,207128,9513471074,206472,656,138,4468962,0xdBdb4d16EdA451D0503b854CF79D55697F90c8DF,0x21a31Ee1afC51d94C2eFcCAa2092aD1028285549
8755,15627892,207128,9513471074,207128,0,2,4708712,0x90FbF5B4774e0F073B20534C52B17fD173F69348,0x28C6c06298d514Db089934071355E5743bf21d60
8756,15627892,207128,9513471074,207128,0,2,3199182,0x98c78B9C63b5d9470322cA3C12aF3a084e22A8b6,0x9696f59E4d72E237BE84fFD425DCaD154Bf96976
8757,15627892,42000,9513471074,42000,0,2,329550,0x28dEbA7D1fF14F8B165DD29b0c04f4F04aCcd269,0x9430801EBAf509Ad49202aaBC5F5Bc6fd8A3dAf8
8758,15627892,207128,9513471074,207128,0,2,4232348,0xca2A1A6D84dE2c1b3F44A42F42558302F0AEA831,0xDFd5293D8e347dFe59E90eFd55b2956a1343963d
8759,15627892,207128,9513471074,207128,0,2,1679535,0xFB650c41B3C3F0A4E1EC63b30bA3FDA4A2CBFf1D,0x4976A4A02f38326660D17bf34b431dC6e2eb2327
8760,15627892,207128,9513471074,207128,0,2,4468963,0x7497D64c9CCc21B8Ff6c4dEaC7e9fe9c8059BA3f,0x21a31Ee1afC51d94C2eFcCAa2092aD1028285549
8761,15627892,207128,9513471074,206532,596,138,3492288,0xdAC17F958D2ee523a2206206994597C13D831ec7,0x56Eddb7aa87536c09CCc2793473599fD21A8b17F
8762,15627892,229328,9513471074,224540,4788,1292,12,0x881D40237659C251811CEC9c364ef91dC08D300C,0x668265bfCaC477eb6c9caaE54ADa1675FcD70241
8763,15627892,308974,9513471074,304846,4128,1034,77,0xe66B31678d6C16E9ebf358268a790B763C133750,0x7Ff5970FE4b328D6341782E68dfA24c51Fe88979
8764,15627892,546554,9513471074,542902,3652,1162,2438,0x68b3465833fb72A70ecDF485E0e4C7bD8665Fc45,0xFc5D935d49139Fa8B29046E8BFD43504A713eE6f
8765,15627892,70000,9513471074,69392,608,138,8,0xdAC17F958D2ee523a2206206994597C13D831ec7,0x459ac734D330b2D21A6131Bb5Ba6ae8DcD355843
8766,15627892,149967,9513471074,143327,6640,1810,201,0x00000000006c3852cbEf3e08E8dF289169EdE581,0xF9E229b3323Bd3f87d80fd578b93d91fE0cFf0Ca
8767,15627892,21000,9513471074,21000,0,2,32,0xEC4D6d860d74c505540631908ae9bfF37c55FD3C,0xA938B0036C1fD270DfCceb57043C00218A309Cc0
8768,15627892,181476,9513471074,179912,1564,394,0,0x1Fa8559e873f698292766790AeCf8080A66433F6,0x7F70f99295Ff31442a4F8FAEb7333145722fA3F9
8769,15627892,21000,9513471074,21000,0,2,492,0x161f2928C4d448C2a3be2fE0e8FAA332eF5Cd6A2,0x69BeeCDBbfE2b6e39906Ac77577060eD69831C52
8770,15627892,69915,9513471074,68971,944,138,84,0xcf0C122c6b73ff809C693DB761e7BaeBe62b6a2E,0x335EC52D33A5F59Fc3047060fAA2BF730cC4b26D
8771,15627892,711000,9513471074,706720,4280,1098,85,0xe66B31678d6C16E9ebf358268a790B763C133750,0x335EC52D33A5F59Fc3047060fAA2BF730cC4b26D
8772,15627892,60760,9513471074,59816,944,138,21,0xA0b86991c6218b36c1d19D4a2e9Eb0cE3606eB48,0x10947Ad8EfFf33df3F3d3b1deC61787121E10272
8773,15627892,255374,9513471074,250298,5076,1292,22,0x881D40237659C251811CEC9c364ef91dC08D300C,0x10947Ad8EfFf33df3F3d3b1deC61787121E10272
8774,15627892,600000,9111542959,598740,1260,458,59278,0xE544cF993C7d477C7ef8E91D28aCA250D135aa03,0x69f36eA1ebf4Ec9E53e3aaBF11CAF62b034ff3eE
8775,15627892,46618,9023471074,45674,944,138,1079,0x9aE380F0272E2162340a5bB646c354271c0F5cFC,0xc926Ea5c9897cCBB7932BDfCC5AFF8e903804559
8776,15627892,21000,9013471074,21000,0,2,418,0xa6e9AFcb696fd1Ad4878384a2059dc290DEa2C98,0xD12EF7C6A70659BB97f5669cafe22a1eF575112A
8777,15627892,75819,9013471074,67087,8732,1290,649,0x9495A029Ce34983C0bF0c45EE8214021E95dA26A,0xdcbFEDf28e1a1C28b80Fea6a6bd50ce826D3E773
8778,15627892,61571,9013471074,53271,8300,2514,26,0x00000000006c3852cbEf3e08E8dF289169EdE581,0x3d1D2d77ad6AdC17587Cc76DE82E7E1C46BBb84E
8779,15627892,47273,9013471074,46345,928,202,1,0xF7b8aabC98D169020b9EE716FC55541cF3e8B55B,0xa57239a45a7F7552B6dDe9bc352144A61400FA8b
8780,15627892,131134,9013471074,125114,6020,1674,381,0x00000000006c3852cbEf3e08E8dF289169EdE581,0x642Ec21d7F130289fc1b237a93793a56f4196f90
8781,15627892,56755,9013471074,55811,944,138,2,0xb5588C411ba0bb7D38865fdC51D082d004e519F7,0xFac48d5EC2fbF4dDE98341923FD14778F85456F1
8782,15627892,69064,9013471074,68112,952,202,532,0x346378C67d0F71343F80299ed8C0407aC2Df05eB,0xB8F3AC467A137c4dA77F7841084825C122993746
8783,15627892,291570,9013471074,288206,3364,970,150,0x68b3465833fb72A70ecDF485E0e4C7bD8665Fc45,0xe51d591ca021ce6406B006CA1D40377Ca5992A64
8784,15627892,175110,9013471074,173546,1564,394,1363,0x1Fa8559e873f698292766790AeCf8080A66433F6,0x259E4BD1F1f803Db79ee71aB19Ad49E43C0E1B0B
8785,15627892,198747,9013471074,198483,264,74,22,0x8B4476806002B3a59e1dCC08caf42F8Ea8497335,0x00078176806bB881832c31Ab2530Ac88Ac913871
8786,15627892,344949,9013471074,340729,4220,1290,211,0x68b3465833fb72A70ecDF485E0e4C7bD8665Fc45,0x32D7b662a852f281895D45CCeDeE769715B85d5e
8787,15627892,21000,9013471074,21000,0,2,31,0xfcC75B653671f7B022F0c266b1Ccb9eC730747Af,0x0c186E8fB16905a39F78542ed36415388c29A355
8788,15627892,58676,9013471074,57732,944,138,294,0xdAC17F958D2ee523a2206206994597C13D831ec7,0xd8d415806d20a7D1d28758C6BD73285ef2657888
8789,15627892,535471,9013471074,531831,3640,1162,87,0x68b3465833fb72A70ecDF485E0e4C7bD8665Fc45,0x00804aD8aa538E852f5Bb4A49f8957a783ac132f
8790,15627892,331869,9013471074,329853,2016,842,1788,0x17D084106C2f1C716ce39fa015AB022757d30C9A,0x49fbb9f90e78Dd1c0569816e1eEeaf2C28414ed7
8791,15627892,117899,9013471074,112319,5580,842,1893,0x69d4584080EdC5d058D5C51Ac61ec0c14E417E70,0xE5cF73F96F57d56d6E44BD82D8AF95727A2FAb04
8792,15627892,243783,9013471074,240179,3604,1162,815,0x68b3465833fb72A70ecDF485E0e4C7bD8665Fc45,0xCfA7929D910B8D778e143766b4013De29BAD01b8
8793,15627892,248900,9013471074,246140,2760,842,570,0x68b3465833fb72A70ecDF485E0e4C7bD8665Fc45,0x20563eA21269A67f298346932c8EDf8a2c8f16A3
8794,15627892,286419,9013471074,283079,3340,970,1,0x68b3465833fb72A70ecDF485E0e4C7bD8665Fc45,0xd35A3dc146d9238B12E9868280448B1019BA0522
8795,15627892,53769,9013471074,52825,944,138,1,0x190B0999C8ac061e559bDab83d478a73Eb6c9AA0,0xDa7AB0C15b74327EF904919bD075aC503C4fF905
8796,15627892,21000,9013471074,21000,0,2,362,0x8f48C1ff8d3Fe32F035DD2e52FF8Fabc620a76C6,0x69334e638297E37999ef876aDE880C1209DDFC2b
8797,15627892,46103,9013471074,45615,488,138,30,0x34Bc797F40Df0445c8429d485232874B15561728,0x99B80F7d6Fbe9cABfC2Ad28683b7B73f405c016c
8798,15627892,21000,9013471074,21000,0,2,216,0x961ACea233b64d5266AaBC544E7a093aeA434aA2,0xA31fF401a865fE14020d2846D8346740e4b83D7E
8799,15627892,181476,9013471074,179912,1564,394,82,0x1Fa8559e873f698292766790AeCf8080A66433F6,0x80dD986ab7C46E399af0ae80fa1539Af72B89A24
8800,15627892,179761,9013471074,176217,3544,1162,4,0x68b3465833fb72A70ecDF485E0e4C7bD8665Fc45,0xC679F875351eFfdd3d35E6d18A52c1F45663841c
8801,15627892,179593,9013471074,178625,968,330,258,0x5ebFD58C5eAd1025755F7490e510cCf2C0b4a444,0x234c9Dc1fF5cAf605Cc702Efa51A4a6Be5A66649
8802,15627892,122512,9013471074,121264,1248,458,15,0x4e32004D8b81847A670b4a1778ACe4dCF2bBA01E,0x030ce9d143332f6D9c287414f08e22c145c43c58
8803,15627892,46135,9013471074,45647,488,138,865,0x1Fa8559e873f698292766790AeCf8080A66433F6,0x4EbE5b991E708003362fF4A0425fC48edc9709D4
8804,15627892,52529,9013471074,51685,844,202,399,0x000000000000509081d6FCD3ee63e791aD1db763,0x4C16c40AeBb9c7d3d755AF80b15E843b5A058E00
8805,15627892,248886,9013471074,246138,2748,842,609,0x68b3465833fb72A70ecDF485E0e4C7bD8665Fc45,0x0254b349c49D1c3375453140Be3674C028C81251
8806,15627892,146050,9013471074,145098,952,202,4,0x4Ba9E93337235a5A3E85aBb77a7Ef2898cfF0608,0xc4c2119bF86eFb3dba573e85a1D4C31A76F6728B
8807,15627892,192747,8693080199,191583,1164,338,141,0x1111111254fb6c44bAC0beD2854e76F90643097d,0x0B86b1bccBb0222c8d877EfAD8fB06c4116AFA08
8808,15627892,21000,8534638414,21000,0,2,0,0x9C19B0497997Fe9E75862688a295168070456951,0x3703128fC2Dbe818ee4c98AA45EaA87d226134D8
8809,15627892,600000,8527990013,599404,596,138,138577,0xdAC17F958D2ee523a2206206994597C13D831ec7,0x974CaA59e49682CdA0AD2bbe82983419A2ECC400
8810,15627892,64200,8527990013,63488,712,202,3479115,0x5f65f7b609678448494De4C87521CdF6cEf1e932,0xd24400ae8BfEBb18cA49Be86258a3C749cf46853
8811,15627892,21000,8527990013,21000,0,2,285,0xce9F0b4d71894BEE1DF5FC22650F12D2da8383cd,0xa8d350C7D864e4402bF00C693acD1C18569875fd
8812,15627892,46135,8527990013,45647,488,138,117,0x1Fa8559e873f698292766790AeCf8080A66433F6,0xcc4585Ca5D7D39A5bB0356eD46bd772b6C1aba5e
8813,15627892,600000,8527990013,599404,596,138,138578,0xdAC17F958D2ee523a2206206994597C13D831ec7,0x974CaA59e49682CdA0AD2bbe82983419A2ECC400
8814,15627892,181476,8513471074,179912,1564,394,222,0x1Fa8559e873f698292766790AeCf8080A66433F6,0x1eE9572Ac7d3ba68Fa98c2537BB099675Acc107c
8815,15627892,181458,8513471074,179906,1552,394,18,0x1Fa8559e873f698292766790AeCf8080A66433F6,0xee21b01B7e22CB9AaEBDd0167A4c7C7c1BE63c0f
8816,15627892,181476,8513471074,179912,1564,394,229,0x1Fa8559e873f698292766790AeCf8080A66433F6,0x4a23Ec4e820405e1bebB6E7D33109A99a29f787f
8817,15627892,181476,8513471074,179912,1564,394,492,0x1Fa8559e873f698292766790AeCf8080A66433F6,0x05bF72a25e8A11895648f78c093cf2F38C2FEaE4
8818,15627892,181476,8513471074,179912,1564,394,689,0x1Fa8559e873f698292766790AeCf8080A66433F6,0xF40E6Ae609aFb91b82B9864D20fD337E9e7D3C2A
8819,15627892,181476,8513471074,179912,1564,394,211,0x1Fa8559e873f698292766790AeCf8080A66433F6,0xb17d16E71AbE10b644b339086d34aF6C8E8B2D77
8820,15627892,181476,8513471074,179912,1564,394,103,0x1Fa8559e873f698292766790AeCf8080A66433F6,0x57DB78397F509F0F6597Cd3274669BB4Fc779ae0
8821,15627892,59056,8513471074,58092,964,394,2361,0x645E9324f4be25be581BB62163cfa86c40b01D07,0xc5009AFEd2D6DA219538aD165998F63B553185B1
8822,15627892,181458,8513471074,179906,1552,394,557,0x1Fa8559e873f698292766790AeCf8080A66433F6,0x1C48aa57CE0aecE12Cb4c07939a44C21b34a9c9B
8823,15627892,181476,8513471074,179912,1564,394,1093,0x1Fa8559e873f698292766790AeCf8080A66433F6,0xAD47E9d28103D74E94AC5A36eCdbDCc573B5A393
8824,15627892,21000,8513471074,21000,0,2,113056,0xa320931b7c91b708D43e2F109776C6b596bd3F84,0x6081258689a75d253d87cE902A8de3887239Fe80
8825,15627892,191149,8513471074,190201,948,266,214,0xd588b586D61C826A0e87919b3D1a239206d58bf2,0xde499CC69295e266DcA857ab4DF0Bc6A22a99142
8826,15627892,181458,8513471074,179906,1552,394,319,0x1Fa8559e873f698292766790AeCf8080A66433F6,0x8107c36a244C3391E0233ABCEc84BE1DA0407f8C
8827,15627892,181476,8513471074,179912,1564,394,478,0x1Fa8559e873f698292766790AeCf8080A66433F6,0xc62CFf9dDD8301A7C44A5054398d982bddc84E1E
8828,15627892,216000,8513471074,215332,668,138,0,0x1A3496C18d558bd9C6C8f609E1B129f67AB08163,0x89De7FB7e3968AA6633637da4658500CfECE4011
8829,15627892,181476,8513471074,179912,1564,394,217,0x1Fa8559e873f698292766790AeCf8080A66433F6,0x8D5c44FEbF50Ed92c68A16EbEBf567809003c765
8830,15627892,46684,8402890623,46124,560,138,1,0x3E343f43B6429956f84726636C336fbcfa90DA27,0x776eF9896CA7984EE3f713219FA4dD92c160bCe1
8831,15627892,46267,8402890623,45691,576,74,1365,0x283Af0B28c62C092C9727F1Ee09c02CA627EB7F5,0x1f08CbFCa1f63a23bB6255a76e1DDeEb8D24d0Fa
8832,15627892,228504,8108939657,218348,10156,3154,242,0x1111111254fb6c44bAC0beD2854e76F90643097d,0x9C4Ab6f74930F83Ef235955065467bb5B83e072f
8833,15627892,222222,8000000000,220658,1564,394,122,0x1Fa8559e873f698292766790AeCf8080A66433F6,0xf19F3316aBcCA5e6A7aA47132116d88136edEBd7
8834,15627892,84354,8000000000,84150,204,74,92,0x9b9D659D4f2cF68b6616Cc0a65683f1951Eb725C,0x0EfD9DF3389156B7Ed545ab2A569193e22c3d55f
8835,15627892,21000,8000000000,21000,0,2,0,0x05C2a20bDEe067B2bc09550faa07081286e617eb,0x529a90C2bF4acCe7a67dF997f46Bb8898A900233
8836,15627892,69310,8000000000,68642,668,138,99,0x1337DEF16F9B486fAEd0293eb623Dc8395dFE46a,0x5bA8c6D365fa5D0d21a831753F38C74b4ba7D89B
8837,15627892,106383,7929330532,105443,940,202,1119,0xBA12F0041DD2543749EC7f00c996A9D488Aa5a21,0x34ebF4d5a424051B120902779481B88b2EdAf54C
8838,15627892,329058,7929330532,324714,4344,1034,130,0x197492CCB4B1acaAAcd43432657A17832E36AB49,0x74310de209ED86B03371b42CaCB18a091960607e
8839,15627892,21000,7765907426,21000,0,2,68,0xac14B5B29448f474C1a8dF3F712b82c3efed7e42,0xA1ed9c875F1De001FAc7963e1716Bc31F522fc78
8840,15627892,200000,7749392899,199392,608,138,1007,0xdAC17F958D2ee523a2206206994597C13D831ec7,0x89762Ba24616D79170CF72EEd483f89aA65249Bd
8841,15627892,60760,7638812448,59816,944,138,3,0xA0b86991c6218b36c1d19D4a2e9Eb0cE3606eB48,0x08FAB9B2d5d34bEA9f50F20dE8b7D3085d9E0282
8842,15627892,21000,7638812448,21000,0,2,9,0x2Fe20FBCd2e7Adacf16522AA6aD1858B6A674Cae,0xf27aa87C718f271eD3D7E03b1F28Bf60bDdD72B0
8843,15627893,46135,57305664243,45647,488,138,250,0x1Fa8559e873f698292766790AeCf8080A66433F6,0x0333656a887aF23107BFF18E4a0d20968ef68910
8844,15627893,21000,15400000000,21000,0,2,1,0x500A746c9a44f68Fe6AA86a92e7B3AF4F322Ae66,0x07fb55D69875818b6DC163200C019b012380C7F0
8845,15627893,800000,15151366737,795060,4940,714,24948,0x767AF52d988D1241A346851a1B39cCd11357376E,0xD1b72A8Ae97f51D7bd4Af257A124175688924001
8846,15627893,200000,16010000000,199392,608,138,24949,0xdAC17F958D2ee523a2206206994597C13D831ec7,0xD1b72A8Ae97f51D7bd4Af257A124175688924001
8847,15627893,21000,14000000000,21000,0,2,1,0x500A746c9a44f68Fe6AA86a92e7B3AF4F322Ae66,0x28beE8DDA04dBDd2E714014524260aB9791C5191
8848,15627893,64408,13779861905,63812,596,138,16,0xdAC17F958D2ee523a2206206994597C13D831ec7,0xc2c1b907f34D5408c96dCc7636778b9dFb0c7e5e
8849,15627893,65556,13779861905,64948,608,138,0,0xdAC17F958D2ee523a2206206994597C13D831ec7,0x6f0998AaE527775b5a39455932eDa3645741D76b
8850,15627893,255000,13695499124,253396,1604,402,876,0x1111111254fb6c44bAC0beD2854e76F90643097d,0x4Bb06172C9287c7B8a2d54B9caD4a0236Cf4B0f9
8851,15627893,223107,13305664243,220359,2748,842,165,0x68b3465833fb72A70ecDF485E0e4C7bD8665Fc45,0x0bAc86B90BdB587edB4aa4033B56341F9C12A643
8852,15627893,300014,11305664243,298474,1540,394,224458,0x98C3d3183C4b8A650614ad179A1a98be0a8d6B8E,0x91aaE0aAfd9D2d730111b395c6871f248d7Bd728
8853,15627893,95611,11009805409,94955,656,138,4709938,0x68eb95Dc9934E19B86687A10DF8e364423240E94,0x2FAF487A4414Fe77e2327F0bf4AE2a264a776AD2
8854,15627893,28000,11000000000,27996,4,4,119,0x000000000000000000000000000000000000dEaD,0x4487a9eD1AeF5Fb6e66c6c39d310C212f66AA3e0
8855,15627893,21000,10510000000,21000,0,2,30,0x6dfc34609a05bC22319fA4Cce1d1E2929548c0D7,0x8D438Fc9C0C4c0f01F32943810b6955bb39B9AE0
8856,15627893,21000,10510000000,21000,0,2,16,0x6dfc34609a05bC22319fA4Cce1d1E2929548c0D7,0xde966336241D42fBFAEC26548f6A037eed079FAB
8857,15627893,181458,10305664243,179906,1552,394,108,0x1Fa8559e873f698292766790AeCf8080A66433F6,0x1e3d0CEa63E4b4cbebaF1BA9C2Cf42FAfe85bb53
8858,15627893,181476,10305664243,179912,1564,394,510,0x1Fa8559e873f698292766790AeCf8080A66433F6,0xe90c19C5294F71417bF3eb6A8712f0cf1045dD61
8859,15627893,69000,9705664243,68512,488,138,310,0xD27dcbcC8778a8AB33AAc529Df36a634567Be325,0x11ebefFf42839B1B37A9F68aCAfe9edF6eE4351A
8860,15627893,120000,9308664243,119392,608,138,31731,0xdAC17F958D2ee523a2206206994597C13D831ec7,0x0b5c4a7FcDA49e0a8661419Bb55B86161a86db2a
8861,15627893,110000,9305664243,109404,596,138,5153,0xdAC17F958D2ee523a2206206994597C13D831ec7,0xd1b7cCa582578bFF37faab547a4D50FF6342c6D0
8862,15627893,207128,9305664243,207128,0,2,1312158,0x62DC6b9a48a00a2c78183F60975cD7486E39Db0D,0xf60c2Ea62EDBfE808163751DD0d8693DCb30019c
8863,15627893,233750,9305664243,229198,4552,1420,19,0x881D40237659C251811CEC9c364ef91dC08D300C,0x31D7B3dc405e40263F99694FdAAF850DCC33337c
8864,15627893,21000,9305664243,21000,0,2,2759948,0x3f1F84eBD7F1d33Bb74762CA173024aE7eD9a7e2,0x267be1C1D684F78cb4F6a176C4911b741E4Ffdc0
8865,15627893,21000,9305664243,21000,0,2,2759949,0x11cddCBcCB1FC52B3EE6c850c83A9080FB7bb36F,0x267be1C1D684F78cb4F6a176C4911b741E4Ffdc0
8866,15627893,73039,9305664243,72095,944,138,3,0xdDF7Fd345D54ff4B40079579d4C4670415DbfD0A,0xeC869174D22e857CA94d699F3DF042AAdd1EeB07
8867,15627893,161658,9305664243,154490,7168,1930,296,0x00000000006c3852cbEf3e08E8dF289169EdE581,0x93a27b213b82844492e50C409850B46328D41E47
8868,15627893,303492,9305664243,298820,4672,1162,4,0xe66B31678d6C16E9ebf358268a790B763C133750,0xeC869174D22e857CA94d699F3DF042AAdd1EeB07
8869,15627893,181476,9305664243,179912,1564,394,170,0x1Fa8559e873f698292766790AeCf8080A66433F6,0xf0c5307E56Ec1E8C51487Bc507b6DdEC3A734291
8870,15627893,247026,9305664243,241698,5328,1484,23,0x881D40237659C251811CEC9c364ef91dC08D300C,0xd20Ec361F85c8a0c2263d51fD4786FE65a016B49
8871,15627893,48618,9305664243,47674,944,138,94,0x05f4a42e251f2d52b8ed15E9FEdAacFcEF1FAD27,0x096D07fa54BaBFC1c2e4f019D6cb684cE78D00f2
8872,15627893,226770,9305664243,209146,17624,4434,100,0x00000000006c3852cbEf3e08E8dF289169EdE581,0xf201c24524Ee5131E00355695c35D5A650CbF19F
8873,15627893,392687,9305664243,372371,20316,6284,95,0x881D40237659C251811CEC9c364ef91dC08D300C,0x096D07fa54BaBFC1c2e4f019D6cb684cE78D00f2
8874,15627893,21000,9305664243,21000,0,2,605,0xc9a39338396F2F69d5f9AB06835a9CAF57F64474,0xdd1D00cEdB005e66310A260145Da4d77E110b967
8875,15627893,41814,9305664243,41182,632,138,20,0x4a220E6096B25EADb88358cb44068A3248254675,0xC1Cf310a78B480a9c013721833D5Bda95e8dfA62
8876,15627893,181476,9305664243,179912,1564,394,473,0x1Fa8559e873f698292766790AeCf8080A66433F6,0x970DeC26bA135ac56e498d44A3eE1431A01A5A46
8877,15627893,181476,9000000000,179912,1564,394,459,0x1Fa8559e873f698292766790AeCf8080A66433F6,0xd37D6c54CF9974e6E3A78167fDFE40EcEdF2be4d
8878,15627893,254755,8839156105,252915,1840,466,89,0x1111111254fb6c44bAC0beD2854e76F90643097d,0xe45419390B38f2A90645a8930cE4039D99F116f7
8879,15627893,78538,8805664243,77894,644,138,5,0x12b6893cE26Ea6341919FE289212ef77e51688c8,0xEd0f4e8A17578E44865B47BDA3D1eEB411A7635E
8880,15627893,500000,8805664243,489348,10652,2442,9970,0x3907eD83Ad9cAF34Ba58E4F543FB26f220B3892A,0xF1595809dE873a363d1647853C37dA5506Ed8Da6
8881,15627893,21000,8805664243,21000,0,2,33,0xB7312EdDB85E50dAd4064713d6C9b5E0bcBD673A,0x823E61B7786Dc0f7eb0f0372422A15b689eDF060
8882,15627893,307375,8805664243,304991,2384,522,41,0x283Af0B28c62C092C9727F1Ee09c02CA627EB7F5,0x17E674A8cEb2D36edd5ff54D368F0c28a0a210B5
8883,15627893,80000,8805664243,79056,944,138,0,0xdAC17F958D2ee523a2206206994597C13D831ec7,0x5D16869Fe0a91a7583D93d005B0869289B479e1a
8884,15627893,21000,8805664243,21000,0,2,923,0x7fc2680A085B66Bc0a1f4340e2505839388DceD9,0x942c2fd50c64C99fe65f63e157326F7A67D5E843
8885,15627893,204904,8805664243,202132,2772,842,4212,0x68b3465833fb72A70ecDF485E0e4C7bD8665Fc45,0x4Ed952edDB2DF5EcB924Cab763cC926f10F3F070
8886,15627893,305917,8805664243,303569,2348,522,30,0x283Af0B28c62C092C9727F1Ee09c02CA627EB7F5,0xe67163F37Af775f05B929F9a1647a5601E60af18
8887,15627893,60731,8805664243,53271,7460,2514,16,0x00000000006c3852cbEf3e08E8dF289169EdE581,0x3cF1Ca50c8ef5243e1C51273BE2d5e91DE26a4Ed
8888,15627893,278821,8805664243,278617,204,74,476,0x55f1C36Bb7aE0d7D6caE97902E30A2306686Ec73,0x36151eF8bF252eB963235fd76245B98580D595F0
8889,15627893,21000,8805664243,21000,0,2,59,0xdEC4925B9601064B35879A07B653bfcC9181A52f,0x7B925264a9Bf246103Eb349Fe49c5b0E26E641EB
8890,15627893,53915,8805664243,53427,488,138,16,0x6de7aC835EC6841Af9b94fd1273dB83B8d69e3f7,0xbcc5ACe489bb61De9Bba47F62DB6071AD119F2B3
8891,15627893,62499,8805664243,61547,952,202,402,0xC86664e7d2608f881f796ee8E24FA9d4d7598406,0x7D3E5dD617EAF4A3d42EA550C41097086605c4aF
8892,15627893,46187,8805664243,45615,572,138,88,0xe0c9BfC391cEE9e840825239aE9910C77064b356,0xC5b6A4A7F89A6056A36EFe3d9f07830cc07c8afF
8893,15627893,308504,8805664243,306096,2408,522,28,0x283Af0B28c62C092C9727F1Ee09c02CA627EB7F5,0xF6EB8C9269E1C67ab0e6A54a1F98b866cf94d137
8894,15627893,285326,8805664243,282530,2796,842,0,0x68b3465833fb72A70ecDF485E0e4C7bD8665Fc45,0x808dd2A92e823EF37e7ad0623117383289118Dd8
8895,15627893,181476,8805664243,179912,1564,394,44,0x1Fa8559e873f698292766790AeCf8080A66433F6,0x492413f5B7a6c0A844E0386a5D45c572Fdd0517b
8896,15627893,305588,8805664243,303252,2336,522,26,0x283Af0B28c62C092C9727F1Ee09c02CA627EB7F5,0xfC8CaCDD95cDB797078b7D11fc4cCF8d62B71bA2
8897,15627893,185258,8805664243,182510,2748,842,167,0x68b3465833fb72A70ecDF485E0e4C7bD8665Fc45,0x913e1f1bd40202bfa82447Be99E03Bc1E2DB43d3
8898,15627893,168346,8805664243,165598,2748,842,264,0x68b3465833fb72A70ecDF485E0e4C7bD8665Fc45,0xcC35f4C022992cDb0AB7b19fB45D4173a34fDE02
8899,15627893,181476,8805664243,179912,1564,394,61,0x1Fa8559e873f698292766790AeCf8080A66433F6,0x6F045480aC73c072493B2ce2BA74c66054071BCF
8900,15627893,261146,8805664243,257458,3688,1162,282,0x68b3465833fb72A70ecDF485E0e4C7bD8665Fc45,0xedfFa2dd922A1f7093BC1441f7D53C125038D3D8
8901,15627893,46052,8805664243,45564,488,138,29,0xb967D2335A3879b7CAE42E085f88274EBff90Fc4,0xa53EB60A063c770df2e790fd331Ae2EC08ED15DB
8902,15627893,51968,8805664243,51196,772,202,149,0xcDA72070E455bb31C7690a170224Ce43623d0B6f,0x0212A74AD3a7FBdAcf2601db98153d56aB0799c9
8903,15627893,156947,8805664243,156659,288,74,55,0xFA02a5cd14a15C4717BDC7a4479AbA40Eb93A01C,0x79cAF31d34521BD0a2a03a33a8119e09FcC80769
8904,15627893,306062,8805664243,303726,2336,522,27,0x283Af0B28c62C092C9727F1Ee09c02CA627EB7F5,0x376CB42C8274D78dD51e8BF750D9c28364CF4C6f
8905,15627893,53915,8805664243,53427,488,138,54,0x6de7aC835EC6841Af9b94fd1273dB83B8d69e3f7,0x2C5bE32062Cb81c6F832aD69C0f57942d78A048B
8906,15627893,21000,8805664243,21000,0,2,1,0xA1A252e4e9B8dfaE6b58C6C88a04791dc6B9E558,0x398864d39e3e530b2648cD18de85c4cE475A645c
8907,15627893,180415,8805664243,178731,1684,586,239,0x8B1631ab830d11531aE83725fDa4D86012eCCd77,0xAbbcf7b0735e4Eb152fD13fa02691Cc046FAC0bD
8908,15627893,67544,8805664243,66068,1476,458,101,0x5BABc381C7E9EdCF02654a9C30d384dFE54dd4A1,0x066DC123977849dF818ed709B375E73123E45179
8909,15627893,21000,8805664243,21000,0,2,330,0xB9e08e19Fd59dd849B421e1C566EaD863aAA4fdb,0xD84bA29A09CD6294a3a6b1A9aC340B8c4584B5a7
8910,15627893,306074,8805664243,303726,2348,522,26,0x283Af0B28c62C092C9727F1Ee09c02CA627EB7F5,0xE77e5Ed25e0cA94c88b9Cc72cF758E0ac5cd4BDf
8911,15627893,21000,8805664243,21000,0,2,67,0x3d2996Ae16006101Abd515B11b6A836Ce254507c,0x0752A030a054569DdF5F5eeF7DA0c44e229EdF3C
8912,15627893,179842,8805664243,177034,2808,842,0,0x68b3465833fb72A70ecDF485E0e4C7bD8665Fc45,0x758c810869A6A4A5C722d81a769D3C88Ea1d9a70
8913,15627893,401898,8805664243,398270,3628,1162,631,0x68b3465833fb72A70ecDF485E0e4C7bD8665Fc45,0x944A75Fdeec101544978A8A37EFF27d075F1242b
8914,15627893,21000,8805664243,21000,0,2,5,0x6775d2F91CAc49a854156a89Adad50621AD9f6Ab,0x5ca22dbA4a6661562E97Cc9C42b63D20147672a5
8915,15627893,36027,8805664243,35751,276,74,156,0xC02aaA39b223FE8D0A0e5C4F27eAD9083C756Cc2,0x26c8a2C7175F53fc85438D343B5d5C2cC5F46751
8916,15627893,281960,8805664243,277192,4768,1546,103,0x68b3465833fb72A70ecDF485E0e4C7bD8665Fc45,0x3F7CfB34Ca1bed471f09D98e2412a2095083AB24
8917,15627893,21000,8805664243,21000,0,2,303,0x9e7Ab7F8e04916B48fB86C9CdE15C54E7DAF1a26,0x94d851DCe74ba0F69996bAA6CFAdc649646Cb4c2
8918,15627893,264382,8805664243,262522,1860,458,731,0x7a250d5630B4cF539739dF2C5dAcb4c659F2488D,0x4B90760Cb2174939934e8AAC629E49C75624485D
8919,15627893,239923,8805664243,237115,2808,842,1833,0x68b3465833fb72A70ecDF485E0e4C7bD8665Fc45,0x62Fe7EFe0f3B58d93a3dE3063937409372A83686
8920,15627893,308990,8805664243,306570,2420,522,25,0x283Af0B28c62C092C9727F1Ee09c02CA627EB7F5,0x211149D84eD093B17015A824C8bafc9FED2eCfE6
8921,15627893,500606,8805664243,488994,11612,3666,2849,0xDef1C0ded9bec7F1a1670819833240f027b25EfF,0x8B3f14F0582FbF275BE87d265C931B4dfD5F13B7
8922,15627893,46103,8805664243,45615,488,138,293,0x346378C67d0F71343F80299ed8C0407aC2Df05eB,0xF36976f2C62eD9d58200749e8a59c661244a0805
8923,15627893,34454,8805664243,34454,0,2,181,0x52ec2F3d7C5977A8E558C8D9C6000B615098E8fC,0x83f68939de5b679299De9d72B40A6E4688b6c587
8924,15627893,21000,8805664243,21000,0,2,29,0x7D26C821D92DCe62E3F4c57a191AF42DA3e8088C,0x832e3BcA767095A73228Da1Ecb808d5Ee9304a42
8925,15627893,376175,8805664243,375935,240,74,46,0x7B7E4ab1eCf7A69C1F15B186f9AF11Bb53e764Cb,0xcE4586e371f9AB738eAF6D491ACda7AA9D1DdD70
8926,15627893,390716,8805664243,385424,5292,1610,191,0x68b3465833fb72A70ecDF485E0e4C7bD8665Fc45,0xD12EC12A77D3f30844a58c2E992273B8152A2eD5
8927,15627893,51906,8555664243,51262,644,138,1,0x8eEF5a82E6Aa222a60F009ac18c24EE12dBf4b41,0xFD20B388a51E93061a03beC02bC6DA5caCCAFB0b
8928,15627893,194403,8527990013,193031,1372,586,156,0xed5D5108b66E1bC04b123415372504afcB987309,0xc7186ED47C1B14281c0bD3Dc1A0dE03bfcb8F700
8929,15627893,225863,8527990013,223791,2072,522,47,0xEfF92A263d31888d860bD50809A8D171709b7b1c,0xc18C24d43ee5cE1064941A563E096B7e882c0a7f
8930,15627893,584563,8485273368,579859,4704,1418,3,0xa2398842F37465f89540430bDC00219fA9E4D28a,0xf8bb90EBF6CFb5D162777AEd13Cb7fd34B5881B6
8931,15627893,269098,8406664243,265278,3820,970,106633,0xa57Bd00134B2850B2a1c55860c9e9ea100fDd6CF,0x9AAb3F81604c683a1a0D14019FBfe15bef7aA1ee
8932,15627893,600000,8400219331,599392,608,138,138579,0xdAC17F958D2ee523a2206206994597C13D831ec7,0x974CaA59e49682CdA0AD2bbe82983419A2ECC400
8933,15627893,105000,8400219331,105000,0,2,138580,0x6862E6a70830d8961195f6C7532B08Aac91ff205,0x974CaA59e49682CdA0AD2bbe82983419A2ECC400
8934,15627893,181476,8305664243,179912,1564,394,545,0x1Fa8559e873f698292766790AeCf8080A66433F6,0xa06aEE44f47f1B8892A76f6B338B737AE7017eda
8935,15627893,181476,8305664243,179912,1564,394,21,0x1Fa8559e873f698292766790AeCf8080A66433F6,0xeE4f38062C7EdFF0E7590666ebC01fe8b68398e0
8936,15627893,181476,8305664243,179912,1564,394,798,0x1Fa8559e873f698292766790AeCf8080A66433F6,0x5469295a9a9f9C6e9a70c9264596A482cDD5ef8E
8937,15627893,181458,8305664243,179906,1552,394,662,0x1Fa8559e873f698292766790AeCf8080A66433F6,0xe04014E7812bf6a1F946271b723Cf0928375001B
8938,15627893,181476,8305664243,179912,1564,394,112,0x1Fa8559e873f698292766790AeCf8080A66433F6,0x60Bf2F928984D0e8f85bE66856323EC933Eaf1D4
8939,15627893,74392,8305664243,72440,1952,330,2,0x00000000000C2E074eC69A0dFb2997BA6C7d2e1e,0x2b608cdD82312b3C9F48f9F1a77893cF0C04ec78
8940,15627893,181476,8305664243,179912,1564,394,522,0x1Fa8559e873f698292766790AeCf8080A66433F6,0xBa98130C362431039e34638508c9EB57623D433E
8941,15627893,21000,8305664243,21000,0,2,57306,0x063614796180ECC5FD2DAAbF43d8A8aE885d144a,0xCfC0F98f30742B6d880f90155d4EbB885e55aB33
8942,15627893,1000000,8305664243,997988,2012,522,6335,0xE592427A0AEce92De3Edee1F18E0157C05861564,0x329aFA43F8c89F65Fb6b22397c1A098EA4210D7E
8943,15627893,181476,8305664243,179912,1564,394,1712,0x1Fa8559e873f698292766790AeCf8080A66433F6,0x1fcd4dD0AF97F5124bDEfc86D094463731e1D635
8944,15627893,181440,8305664243,179900,1540,394,131,0x1Fa8559e873f698292766790AeCf8080A66433F6,0xd30E17a73A788850A3a372393Ceb0036406467c2
8945,15627893,181476,8305664243,179912,1564,394,117,0x1Fa8559e873f698292766790AeCf8080A66433F6,0x32380C481674fa0391f75B1735E203c57426F34b
8946,15627893,41739,8305664243,41083,656,138,113057,0x95aD61b0a150d79219dCF64E1E6Cc01f0B64C4cE,0x6081258689a75d253d87cE902A8de3887239Fe80
8947,15627893,165056,8305664243,162284,2772,842,11,0x68b3465833fb72A70ecDF485E0e4C7bD8665Fc45,0x17D1D8DeF765263Ff23F916d2c00Da0FC9E43E00
8948,15627893,270046,8305664243,266238,3808,970,131298,0xa57Bd00134B2850B2a1c55860c9e9ea100fDd6CF,0x60b86AF869f23aEb552fB7F3CaBD11B829f6Ab2F
8949,15627893,268368,8305664243,266112,2256,650,116842,0xA69babEF1cA67A37Ffaf7a485DfFF3382056e78C,0x6046945C5B5eF5933b8E73a98A6AD7bF3e031df7
8950,15627893,181476,8305664243,179912,1564,394,884,0x1Fa8559e873f698292766790AeCf8080A66433F6,0xbBc00e0e99087172FDb6e94A87Da869663467F12
8951,15627893,234969,8305664243,232197,2772,842,248,0x68b3465833fb72A70ecDF485E0e4C7bD8665Fc45,0xa75E3Ac0dD09B9388015125F35db9BAc21cf8783
8952,15627893,181476,8305664243,179912,1564,394,12,0x1Fa8559e873f698292766790AeCf8080A66433F6,0xF1504c74C89620D0aBdC5e46e12C56b24398CfA7
8953,15627893,263898,8305664243,260078,3820,970,97407,0xa57Bd00134B2850B2a1c55860c9e9ea100fDd6CF,0x76e40D0a69Fd81826B5eb7D18145626d46EAFdef
8954,15627893,181458,8305664243,179906,1552,394,70,0x1Fa8559e873f698292766790AeCf8080A66433F6,0x4fAE40C4997B3b426773FDac27e994912C80Cae8
8955,15627893,181476,8305664243,179912,1564,394,542,0x1Fa8559e873f698292766790AeCf8080A66433F6,0x680E8A5A1DC9499342a7bc0BFb3B99dff60eC1F9
8956,15627893,181476,8305664243,179912,1564,394,26,0x1Fa8559e873f698292766790AeCf8080A66433F6,0xa3F5B86b24359F4CCfB3710C56e7880eb166bc18
8957,15627893,102954,7881777593,101302,1652,522,34,0x35CA26A7a7F3ca98F3e60BD94C139C892e45B6C3,0x4e879eF3C9a62d06D33164F45D2ea7e86616D99D
8958,15627893,102954,7881777593,101302,1652,522,33,0x35CA26A7a7F3ca98F3e60BD94C139C892e45B6C3,0x148357d603BfD802ea7A9Cc1f7708Abe584575Fd
8959,15627893,21002,7638800000,21002,0,2,54,0x3819f64f282bf135d62168C1e513280dAF905e06,0x7C98A9d061d280481de819D31f49d8A494C7F4c3
8960,15627893,21000,7558100595,21000,0,2,379,0x0707930FbEbD044dCAE031076a8bAb52a52cb6Af,0x642503c04453F0aDdD2D2D95Ea83ad548F62CE0D
8961,15627893,150756,7558100595,150692,64,10,2,0x65c2e54a4c75ff6da7b6B32369c1677250075fb2,0xd1DBf8C7a8027Ff1aD8FbaD92dE7D571Bd6D71F6
8962,15627893,21000,7558100595,21000,0,2,64,0xfFE804404Af26c2514EF331A7333e375b80BFb9f,0x14D326DD2382183b5944c87dF1110F4Ea21aB02b
8963,15627893,48518,7370893600,47530,988,202,890912,0xdAC17F958D2ee523a2206206994597C13D831ec7,0x340d693ED55d7bA167D184ea76Ea2Fd092a35BDc
8964,15627893,21000,9712131818,21000,0,2,890913,0x09A118747B2eEFC17248a28F738d9c72d9543A78,0x340d693ED55d7bA167D184ea76Ea2Fd092a35BDc
8965,15627893,51700,13761634690,50724,976,202,890914,0xdAC17F958D2ee523a2206206994597C13D831ec7,0x340d693ED55d7bA167D184ea76Ea2Fd092a35BDc
8966,15627893,57274,13397667954,56286,988,202,890915,0xA0b86991c6218b36c1d19D4a2e9Eb0cE3606eB48,0x340d693ED55d7bA167D184ea76Ea2Fd092a35BDc
8967,15627893,208441,7370893600,202721,5720,1674,51,0xa2398842F37465f89540430bDC00219fA9E4D28a,0x27a74bcE8829340f4257dc74339432d56D55AECe
8968,15627893,21000,7370893600,21000,0,2,150326,0x9FfBAC63fde4687F75EeE0f44fE848E09E0131Ac,0x1C727a55eA3c11B0ab7D3a361Fe0F3C47cE6de5d
8969,15627893,51988,7370893600,51044,944,138,17,0x72B169AD8aF6c4FB53056b6a2A85602Ad6863864,0xE71814755D42816716097a6a2EEC5573Aab76768
8970,15627894,650000,35749392899,648152,1848,458,272,0x7a250d5630B4cF539739dF2C5dAcb4c659F2488D,0x206272707E6f10f55C6C813De9333256A3587115
8971,15627894,650000,34749392899,648152,1848,458,2686,0x7a250d5630B4cF539739dF2C5dAcb4c659F2488D,0x345eB826a33bec023A2fb09F35256398563129D4
8972,15627894,26250,34057383529,26250,0,2,452,0xE62d6048956279B41B96Be59c9eaFF8eE868320a,0x7c0CF10Bec97e933Bc61aB2be6A4C400C202782C
8973,15627894,650000,32749392899,648152,1848,458,742,0x7a250d5630B4cF539739dF2C5dAcb4c659F2488D,0x77783fc8bBFCD3edd605488FA8a7B572E4BB45a5
8974,15627894,150000,30000000000,149356,644,138,11173685,0x001A8Ffcb0f03e99141652eBCdecDb0384E3bd6c,0xFBb1b73C4f0BDa4f67dcA266ce6Ef42f520fBB98
8975,15627894,279521,27819633000,268109,11412,3146,572,0x617Dee16B86534a5d792A4d7A62FB491B544111E,0xD25B0DBcf6FD24D05EE90d64042C79ba290c6D19
8976,15627894,94831,15257429774,94223,608,138,2188246,0xdAC17F958D2ee523a2206206994597C13D831ec7,0x75e89d5979E4f6Fba9F97c104c2F0AFB3F1dcB88
8977,15627894,77356,14401559655,76748,608,138,2188247,0x467719aD09025FcC6cF6F8311755809d45a5E5f3,0x75e89d5979E4f6Fba9F97c104c2F0AFB3F1dcB88
8978,15627894,334962,12223051731,333042,1920,458,214,0x7a250d5630B4cF539739dF2C5dAcb4c659F2488D,0x11cE31192602A36f4203b264da3132D2a5A9BF17
8979,15627894,1000000,12223051731,998260,1740,458,38,0x7a250d5630B4cF539739dF2C5dAcb4c659F2488D,0x0794dA9eeF25b56C58CE1fA8990f88b334609D54
8980,15627894,54092,12000000000,53604,488,138,300,0xD27dcbcC8778a8AB33AAc529Df36a634567Be325,0x9ea5882C4C084C56d07140FE2d1d560142009BB6
8981,15627894,79352,12000000000,78744,608,138,0,0xA0b86991c6218b36c1d19D4a2e9Eb0cE3606eB48,0x74b83D991783aDcaF0D84aA3b26A75Ec589De318
8982,15627894,22000,11939186018,22000,0,2,0,0x0AA7F992Dfb485Cf9c4FbE9688F1ECdf9e0A15f9,0xAd4f7eB835B02E371Ef6CC5152C71Cf8b62928B5
8983,15627894,300014,11813630408,298166,1848,458,86098,0x87d9dA48dB6e1F925CB67d3b7d2a292846c24cf7,0x26FD09c8B44AF53df38a9BAD41D5Abc55a1786AF
8984,15627894,54627,11223051731,52299,2328,650,583,0x1A90B3Dead0113740266b7F7Ea1136e8ED1b48C5,0x87D9b41d139189403E008d9c0678F9EEB5754CF8
8985,15627894,300014,11223051731,298794,1220,330,134156,0x98C3d3183C4b8A650614ad179A1a98be0a8d6B8E,0x8e8f818d3371F797A2Db7eDB32803607c8b3c6A9
8986,15627894,63000,10962655140,63000,0,2,2710061,0xf22A206DBE91637FC08C5fCCDF9149257Bd144cb,0xC098B2a3Aa256D2140208C3de6543aAEf5cd3A94
8987,15627894,21000,10828576711,21000,0,2,252,0xDB2C0733e0A8d202BD1246e02047FC59665Dd8D2,0xF930fE78b91351f3F0640266b9752Ad8839E7368
8988,15627894,21000,10560000000,21000,0,2,7,0xf0A86FD79c13b618db29E2062B493e1e46f512f8,0xEDa4739c3E2349adb28fD912a99CCe6485f6A722
8989,15627894,400000,10558730716,397848,2152,586,1512,0x2b3b6d4C350a48D7f224242656aABB6FAe3bc955,0x2268db19a76c8c4Cf570bEf41F0938B0f990A166
8990,15627894,209661,10350000000,208905,756,266,847,0xDC24316b9AE028F1497c275EB9192a3Ea0f67022,0xEc890FCa5C79a443f53849bc658947a99B653A4c
8991,15627894,181476,10223051731,179912,1564,394,246,0x1Fa8559e873f698292766790AeCf8080A66433F6,0x011FC3C8e5a7197FbE3021599F69D1D8a962f8bF
8992,15627894,1000000,10223051731,996736,3264,1034,579,0x68b3465833fb72A70ecDF485E0e4C7bD8665Fc45,0x4FF34D243b0c5e473989c54F565B6f05D421826b
8993,15627894,50000,10074210768,50000,0,2,464126,0x2Df6aDF370B2aD9ce0F7833B6F2b9ac50aA47992,0x3B794929566e3Ba0f25e4263e1987828b5c87161
8994,15627894,181476,9749392899,179912,1564,394,1476,0x1Fa8559e873f698292766790AeCf8080A66433F6,0x1D3dC806d16120C86f3EE7343db5Fe24438f8DA4
8995,15627894,70000,9723051731,69392,608,138,2211,0xA0b86991c6218b36c1d19D4a2e9Eb0cE3606eB48,0xbE8a63b4dDC3D83e38538118ff116e4813A79B63
8996,15627894,90000,9723051731,90000,0,2,35486,0x1012965993555526b16EEAD82A0d46F68Ce037ae,0x8a37F0290AE85D08522d2A605617e76128Fd0712
8997,15627894,21000,9690000000,21000,0,2,705889,0x62d857F6cE8414A9484f1019988d711a5a65AF2C,0x6dfc34609a05bC22319fA4Cce1d1E2929548c0D7
8998,15627894,21000,9689065004,21000,0,2,19,0xCBD6832Ebc203e49E2B771897067fce3c58575ac,0x175aAE2aa202d14a521b8ba10B23B899e03Fb0EF
8999,15627894,1000000,9423051731,996736,3264,1034,3247,0x68b3465833fb72A70ecDF485E0e4C7bD8665Fc45,0xD5Ed772FaD590f3aB6bE1Af795E3D3086c113f8d
9000,15627894,65000,9299271478,65000,0,2,10796,0xdE954D957dA555a276D21A5Ea22f4eE29F290b3B,0xF0C5eD9e061E49B69e410d94D8C9328111AC624A
9001,15627894,60000,9299271478,59444,556,202,34115,0x41c69c8ffb4049fc393ed68Ec0Ce66c37f8CF7a0,0xe8463A6d371581d3E40315daD7dbAB85f1492da8
9002,15627894,60000,9299271478,59444,556,202,37656,0x902F09715B6303d4173037652FA7377e5b98089E,0x339d413CCEfD986b1B3647A9cfa9CBbE70A30749
9003,15627894,224595,9233051731,222559,2036,522,351,0x7a250d5630B4cF539739dF2C5dAcb4c659F2488D,0x788296BAb7c874416c34BB5d7Bc0eb2170c97334
9004,15627894,120000,9226051731,119392,608,138,31672,0xdAC17F958D2ee523a2206206994597C13D831ec7,0x1440ec793aE50fA046B95bFeCa5aF475b6003f9e
9005,15627894,21000,9226051731,21000,0,2,195480,0x209cB8Bc5E355eA6EfD301BdD65F31cdc52D252f,0xB287eaC48aB21c5FB1d3723830d60b4c797555B0
9006,15627894,21000,9224051731,21000,0,2,251472,0x8a10d766620d72730d9A4961E1d0D65972C20cD2,0x151B381058f91cF871E7eA1eE83c45326F61e96D
9007,15627894,48792,9223051731,48184,608,138,2,0xA0b86991c6218b36c1d19D4a2e9Eb0cE3606eB48,0xaC7354DD6827cF569C79707a87D660C8Bf89943B
9008,15627894,48804,9223051731,48184,620,138,0,0xA0b86991c6218b36c1d19D4a2e9Eb0cE3606eB48,0x634859fc9a6D9A8923F0f67f577868726382cBb3
9009,15627894,48792,9223051731,48184,608,138,2,0xA0b86991c6218b36c1d19D4a2e9Eb0cE3606eB48,0xcfceEA55b74924b8D3A04D562B4e11a3892C2a6c
9010,15627894,34857,9223051731,34213,644,138,0,0x4a220E6096B25EADb88358cb44068A3248254675,0xC549b4ADEfe86a1f4Bda0898B9f9CB33Ee08341d
9011,15627894,48792,9223051731,48184,608,138,1,0xA0b86991c6218b36c1d19D4a2e9Eb0cE3606eB48,0x7C047c955ff110204BAFbBB092bacA543BFc8b2C
9012,15627894,34857,9223051731,34213,644,138,1975,0x4a220E6096B25EADb88358cb44068A3248254675,0x2A24f2568B90370A3ED68aa9B689046CC8335d96
9013,15627894,34730,9223051731,34074,656,138,5,0x6B175474E89094C44Da98b954EedeAC495271d0F,0x83d5799862A57855d7b6186c11500120Ca5E2BA9
9014,15627894,40106,9223051731,39462,644,138,0,0x1f9840a85d5aF5bf1D1762F925BDADdC4201F984,0x49710daf3191CAc32363CA37319e1F9F40e08a7A
9015,15627894,21000,9223051731,21000,0,2,1211350,0x7E0F7f873849f0A136E8801188c5Acd8fc94061d,0x95A9bd206aE52C4BA8EecFc93d18EACDd41C88CC
9016,15627894,48792,9223051731,48184,608,138,0,0xA0b86991c6218b36c1d19D4a2e9Eb0cE3606eB48,0xf5eb59674AC055264DBCf4eD8cfb64cb63667b98
9017,15627894,21000,9223051731,21000,0,2,8265758,0xE0841FC56BC4ED2cA4CD4A80F92BF0540Af43785,0xb5d85CBf7cB3EE0D56b3bB207D5Fc4B82f43F511
9018,15627894,186580,9223051731,185936,644,138,15732,0x7Fc66500c84A76Ad7e9c93437bFc5Ac33E2DDaE9,0xbe368f7086b0f9E98aF309be43afB02f40135eAC
9019,15627894,21000,9223051731,21000,0,2,52379,0x5fBcF32FeAb411B63c290CAe05e09118A1178959,0x7c195D981AbFdC3DDecd2ca0Fed0958430488e34
9020,15627894,46097,9223051731,45501,596,138,0,0xdAC17F958D2ee523a2206206994597C13D831ec7,0x27dc9e8490b89ed7B6eBB8c38caF3eb312C4872e
9021,15627894,48792,9223051731,48184,608,138,0,0xA0b86991c6218b36c1d19D4a2e9Eb0cE3606eB48,0x4ef8f1a0451f1E8349C5e68145898d5331478aeE
9022,15627894,48792,9223051731,48184,608,138,46,0xA0b86991c6218b36c1d19D4a2e9Eb0cE3606eB48,0x8DC880ed5C124c91fe832a1290380aFA1d31EEBC
9023,15627894,48792,9223051731,48184,608,138,22,0xA0b86991c6218b36c1d19D4a2e9Eb0cE3606eB48,0x00e8f905E062a68094C989C417D6eB5375748122
9024,15627894,21000,9223051731,21000,0,2,6578038,0x62B2e73bF6a46A8C9FB51D91e8754976ed457054,0xeB2629a2734e272Bcc07BDA959863f316F4bD4Cf
9025,15627894,250000,9223051731,249048,952,202,0,0x881D4032abe4188e2237eFCD27aB435E81FC6bb1,0x7Bd496a6e7e414200af7508FA4d47E12E438729E
9026,15627894,46097,9223051731,45501,596,138,7,0xdAC17F958D2ee523a2206206994597C13D831ec7,0xDb0DbD38022f6451Df4720725310e486ac19ba6d
9027,15627894,42000,9223051731,42000,0,2,329551,0x859701Cc57580C4a064edC2317E1760430347eCF,0x9430801EBAf509Ad49202aaBC5F5Bc6fd8A3dAf8
9028,15627894,46109,9223051731,45501,608,138,72,0xdAC17F958D2ee523a2206206994597C13D831ec7,0x23368B6fc26D637e5b377f17E5d7C66c726F7027
9029,15627894,48780,9223051731,48184,596,138,3,0xA0b86991c6218b36c1d19D4a2e9Eb0cE3606eB48,0x32F5059f91A84D79b8bcF894d91AF6254b70D048
9030,15627894,2000000,9223051731,1996108,3892,970,171054,0xA9D1e08C7793af67e9d92fe308d5697FB81d3E43,0x7830c87C02e56AFf27FA8Ab1241711331FA86F43
9031,15627894,48792,9223051731,48184,608,138,1,0xA0b86991c6218b36c1d19D4a2e9Eb0cE3606eB48,0xCb6A53a9b89bB4670027D8e8A9ed345F33CD5839
9032,15627894,250000,9223051731,249048,952,202,0,0x881D4032abe4188e2237eFCD27aB435E81FC6bb1,0xb082A4F1D6f9dB905B492569Ad8840AB959309c4
9033,15627894,250000,9223051731,249048,952,202,0,0x881D4032abe4188e2237eFCD27aB435E81FC6bb1,0xc7d020Deb72Eb3805d65f23c452F72eE27fC037E
9034,15627894,2000000,9223051731,1985476,14524,3082,171055,0xA9D1e08C7793af67e9d92fe308d5697FB81d3E43,0x7830c87C02e56AFf27FA8Ab1241711331FA86F43
9035,15627894,250000,9223051731,249048,952,202,0,0x881D4032abe4188e2237eFCD27aB435E81FC6bb1,0x491d51E987482cC2fc131585b5208A1C48850075
9036,15627894,46109,9223051731,45501,608,138,0,0xdAC17F958D2ee523a2206206994597C13D831ec7,0xe6f5e2a53A5A43aF808Bb9E967045E67b07e16ae
9037,15627894,250000,9223051731,249048,952,202,0,0x881D4032abe4188e2237eFCD27aB435E81FC6bb1,0xbeA574304A3e6180cA50A7b702C62BC5ee21817F
9038,15627894,250000,9223051731,249048,952,202,0,0x881D4032abe4188e2237eFCD27aB435E81FC6bb1,0x6BbDAb46d8e179fFD2265135D944Cc8eC835551B
9039,15627894,69163,9223051731,68555,608,138,7,0xdAC17F958D2ee523a2206206994597C13D831ec7,0x7B841a9dEeC695891A4e1bc1Cb62A52606fA61e1
9040,15627894,406768,9223051731,406088,680,138,4,0xb12494C8824fc069757F47d177E666c571Cd49aE,0xD6e1bfac36293989D03De2D893157Cd080968803
9041,15627894,250000,9223051731,249048,952,202,0,0x881D4032abe4188e2237eFCD27aB435E81FC6bb1,0x86F1F3fC211f91c7bD2A9a20E27f74FBB3250947
9042,15627894,250000,9223051731,249048,952,202,0,0x881D4032abe4188e2237eFCD27aB435E81FC6bb1,0x6e2FeF567bfe19122ba15811635f26A16602DEdb
9043,15627894,45605,9223051731,45541,64,10,3,0x6097004C68F7B350d72226003226Ac089597D579,0xCCA6815482a886227eA5f751445505fbA516215a
9044,15627894,2500000,9223051731,2495904,4096,1162,1384,0x061a813676F47022F34fc3097E8Fe5bF12660E03,0xF468D4a36023351Cc25Ac31c31658B3077C936D0
9045,15627894,600000,9223051731,598152,1848,458,660,0x7a250d5630B4cF539739dF2C5dAcb4c659F2488D,0x19B17B12AE586670E9Df3dC982Ea74d8fb83fa6F
9046,15627894,900000,9223051731,898152,1848,458,961,0x7a250d5630B4cF539739dF2C5dAcb4c659F2488D,0xbaAbc782E6Ca0F76072301461aaC0d8A27209F58
9047,15627894,600000,9223051731,597952,2048,522,7015,0x7a250d5630B4cF539739dF2C5dAcb4c659F2488D,0x8FFdD83b2C1541e661c2437B1887844654E050c9
9048,15627894,770000,9223051731,768400,1600,394,175,0x5b7901b8732fD30544cC0007b5FE1B6b8393fa7B,0x1DEAD1c404B962b8C17DC75c17be402065aB5a12
9049,15627894,900000,9223051731,898152,1848,458,28,0x7a250d5630B4cF539739dF2C5dAcb4c659F2488D,0x7676E4779F14C73d9ED01f47DCdec51A0C99687a
9050,15627894,750000,9223051731,747680,2320,586,119,0x9bC6369a2D947BdfAEdd74207d3589dbaFc48b52,0x2C5789571A40a5554114bB6548DD9bc69D494b15
9051,15627894,750000,9223051731,747680,2320,586,115,0x9bC6369a2D947BdfAEdd74207d3589dbaFc48b52,0x35328a6bbb43BB53f0838Ec98225C46Bc367087d
9052,15627894,750000,9223051731,748152,1848,458,30,0x7a250d5630B4cF539739dF2C5dAcb4c659F2488D,0xF6b782b9727ec94bb5BA7DC91e4d29759D4b2fe7
9053,15627894,600000,9223051731,597952,2048,522,4610,0x7a250d5630B4cF539739dF2C5dAcb4c659F2488D,0x84Ab6D0401831896Fe2484f5eeeeb944B5BA95DB
9054,15627894,600000,9223051731,598164,1836,458,200,0x7a250d5630B4cF539739dF2C5dAcb4c659F2488D,0x4Afab73079477b2ddaA684B8953AE800A8f38a9A
9055,15627894,750000,9223051731,748152,1848,458,23,0x7a250d5630B4cF539739dF2C5dAcb4c659F2488D,0xB286776A207ddC1dF0033BA9323891F9309319BA
9056,15627894,600000,9223051731,597656,2344,586,582,0x61ccc13104B547d79fC554CFF9479ecb1AcEDA50,0x3249614aD399BBFcC4aC9eF19a6d408abe5aAE36
9057,15627894,750000,9223051731,748152,1848,458,41,0x7a250d5630B4cF539739dF2C5dAcb4c659F2488D,0xD17fD2Cf7E6FD7380a233Be314E389Dd43DD0195
9058,15627894,1000000,9223051731,998860,1140,266,7871,0xef519E5530C4EcdeD73E78CEC6cf41224ee11EF5,0xbCb05a3F85d34f0194C70d5914d5C4E28f11Cc02
9059,15627894,600000,9223051731,597952,2048,522,1733,0x7a250d5630B4cF539739dF2C5dAcb4c659F2488D,0x6bc3c65C6EAFC491AE6482B8a9995abdf79cEB8E
9060,15627894,1000000,9223051731,996736,3264,1034,8532,0x68b3465833fb72A70ecDF485E0e4C7bD8665Fc45,0xf8EfD62b7f6E397a387a7FB232a54fe8f59C6B2A
9061,15627894,600000,9223051731,597964,2036,522,3214,0x7a250d5630B4cF539739dF2C5dAcb4c659F2488D,0xDC001E4F2F29b6cdd6F3C0B78Ad89719e40857Be
9062,15627894,2000000,9223051731,1998272,1728,458,48,0x7a250d5630B4cF539739dF2C5dAcb4c659F2488D,0x2eD539e35419d017E6448C932ed8268964883287
9063,15627894,1000000,9223051731,996748,3252,1034,10853,0x68b3465833fb72A70ecDF485E0e4C7bD8665Fc45,0xb6007a21D1c890742bd9a3A4E2C0CA8Df646b0Be
9064,15627894,1000000,9223051731,996736,3264,1034,5211,0x68b3465833fb72A70ecDF485E0e4C7bD8665Fc45,0x9a62aa30A68b4bDEb6DD646D3ed316602fFe2321
9065,15627894,600000,9223051731,598140,1860,458,931,0x7a250d5630B4cF539739dF2C5dAcb4c659F2488D,0x6D8E9842D102d652b6eA333B028458f1Ef945C7F
9066,15627894,100000,9223051731,99056,944,138,7872,0x6097004C68F7B350d72226003226Ac089597D579,0xbCb05a3F85d34f0194C70d5914d5C4E28f11Cc02
9067,15627894,750000,9223051731,748152,1848,458,282,0x7a250d5630B4cF539739dF2C5dAcb4c659F2488D,0xA02468fF43E56dcE88Ce5a55E560b7812bBf82C4
9068,15627894,600000,9223051731,597656,2344,586,972,0x61ccc13104B547d79fC554CFF9479ecb1AcEDA50,0xE72Ca43063EE8271B681C55fFb760Fa39F676e01
9069,15627894,1000000,9223051731,996760,3240,1034,210,0x68b3465833fb72A70ecDF485E0e4C7bD8665Fc45,0x0f86A7ac82C47e8C305Cc58839C842F5B6Fb031a
9070,15627894,750000,9223051731,747680,2320,586,137,0x9bC6369a2D947BdfAEdd74207d3589dbaFc48b52,0x5010973206B3cA1c2fA12C846D6465FB5efD98BE
9071,15627894,600000,9223051731,597964,2036,522,7604,0x7a250d5630B4cF539739dF2C5dAcb4c659F2488D,0x7D29c4f95c009CE4B158f68f06D56f02f460c9Bb
9072,15627894,600000,9223051731,598152,1848,458,334,0x7a250d5630B4cF539739dF2C5dAcb4c659F2488D,0xb04F4bB5e69e1A27E559890dDc98e1D6cb418501
9073,15627894,750000,9223051731,748152,1848,458,1108,0x7a250d5630B4cF539739dF2C5dAcb4c659F2488D,0x64AA949A7952b2b0E51BacdB8cdC11feba1e6DDA
9074,15627894,1500000,9223051731,1495904,4096,1162,1973,0x91eE438d39D436492532350F80052600C1C155e7,0xb46E6dAefED2591385FD5214d0E42806a2d4f2C6
9075,15627894,1000000,9223051731,998140,1860,458,99,0x7a250d5630B4cF539739dF2C5dAcb4c659F2488D,0x43F0BAF4d39468C654d07Ee46a10B9c0285F1bFE
9076,15627894,600000,9223051731,597952,2048,522,3238,0x7a250d5630B4cF539739dF2C5dAcb4c659F2488D,0x17F50ea08EBD0Bd4148dE58E57C72C08803c5634
9077,15627894,600000,9223051731,597952,2048,522,5785,0x7a250d5630B4cF539739dF2C5dAcb4c659F2488D,0xf65760f5088902333FCDC50352781F8F82FB6F07
9078,15627894,750000,9223051731,748164,1836,458,98,0x7a250d5630B4cF539739dF2C5dAcb4c659F2488D,0x68226A002D6747905457273473204cbb9694a38d
9079,15627894,750000,9223051731,747680,2320,586,555,0x9bC6369a2D947BdfAEdd74207d3589dbaFc48b52,0xE95B3f559B9da49fbc3f95976A76D91168d854F8
9080,15627894,1000000,9223051731,996736,3264,1034,8422,0x68b3465833fb72A70ecDF485E0e4C7bD8665Fc45,0x840eA0F0A71Cfc8b56C3518A029186300B738Ac4
9081,15627894,105910,9223051731,105290,620,138,3,0xB4375E8aaCf0147aDf6B2a296c61Ad6141010c37,0x8Fbbb24Bf54C0Bf2BdD86A79a910e5d33d01F5B5
9082,15627894,1000000,9223051731,996736,3264,1034,10512,0x68b3465833fb72A70ecDF485E0e4C7bD8665Fc45,0x2fB8e9Fe1AD2764687Aaa1806290a1c178446Def
9083,15627894,1000000,9223051731,996736,3264,1034,12340,0x68b3465833fb72A70ecDF485E0e4C7bD8665Fc45,0xeb467F831233c47b25877eaF895773C6031D7E71
9084,15627894,600000,9223051731,597656,2344,586,528,0x61ccc13104B547d79fC554CFF9479ecb1AcEDA50,0x2709C2C583b06E98b7A8d81288AEA32aA00462db
9085,15627894,600000,9223051731,597988,2012,522,290,0x7a250d5630B4cF539739dF2C5dAcb4c659F2488D,0xA4F52138B57D3F3225D917dEF563300e35e81198
9086,15627894,600000,9223051731,598140,1860,458,245,0x7a250d5630B4cF539739dF2C5dAcb4c659F2488D,0xe715d5FaDD5E475F3d3a629c3056F49a4a2ECB14
9087,15627894,1000000,9223051731,996748,3252,1034,5644,0x68b3465833fb72A70ecDF485E0e4C7bD8665Fc45,0x67F800Af89484FB207bF7af891B334ea28a2C204
9088,15627894,600000,9223051731,597656,2344,586,189,0x61ccc13104B547d79fC554CFF9479ecb1AcEDA50,0x0D46d49863d8354EFb02070e5Cf01502C28140f9
9089,15627894,1000000,9223051731,996736,3264,1034,5034,0x68b3465833fb72A70ecDF485E0e4C7bD8665Fc45,0xb446AF9F25a7c2Ee75706b15149a4A54dFB9d338
9090,15627894,1000000,9223051731,996736,3264,1034,3299,0x68b3465833fb72A70ecDF485E0e4C7bD8665Fc45,0xdEAd30072080a33629b8b5111A1303914a2b4a3e
9091,15627894,1000000,9223051731,996736,3264,1034,9607,0x68b3465833fb72A70ecDF485E0e4C7bD8665Fc45,0x42AD5aAAF1b94Eff0776f3F7F86234dD1c124456
9092,15627894,1000000,9223051731,996736,3264,1034,3436,0x68b3465833fb72A70ecDF485E0e4C7bD8665Fc45,0x25e3aA20B61e078D41901f3AD02Bf444A329DC71
9093,15627894,1000000,9223051731,996724,3276,1034,5499,0x68b3465833fb72A70ecDF485E0e4C7bD8665Fc45,0x0bd10a26BbA585D74Bb1E7C05eB608e948354A6d
9094,15627894,1000000,9223051731,996748,3252,1034,4591,0x68b3465833fb72A70ecDF485E0e4C7bD8665Fc45,0xA5A5D38366C213b1c8caeA7107321937B412C700
9095,15627894,600000,9223051731,597668,2332,586,1904,0x61ccc13104B547d79fC554CFF9479ecb1AcEDA50,0xeA491bfBD5cD014706118c8e060001ebE8d96529
9096,15627894,600000,9223051731,597952,2048,522,3065,0x7a250d5630B4cF539739dF2C5dAcb4c659F2488D,0xDEE6ae5B452E5354fbBD344A8f2c953C29A4c206
9097,15627894,600000,9223051731,597952,2048,522,1709,0x7a250d5630B4cF539739dF2C5dAcb4c659F2488D,0xB48AAfa1c46E12441472F6F3734190AaB531C933
9098,15627894,90000,9223051731,90000,0,2,9201,0x8790B7dE5D4B555C28428df2D928905b36B1522D,0xA86309988947559b6E72Ef716C5058F479386C0F
9099,15627894,1000000,9223051731,996736,3264,1034,481,0x68b3465833fb72A70ecDF485E0e4C7bD8665Fc45,0xcB673b8FD92fB398C782ffbB422bbb1Be5C56607
9100,15627894,750000,9223051731,747680,2320,586,617,0x9bC6369a2D947BdfAEdd74207d3589dbaFc48b52,0xD103855B83ff26e0e6a67a0203E45455F37ca713
9101,15627894,1000000,9223051731,996736,3264,1034,3174,0x68b3465833fb72A70ecDF485E0e4C7bD8665Fc45,0x9619EB67c2CB6B099a7Ec46FFb85d2504704A7Ec
9102,15627894,750000,9223051731,747680,2320,586,1381,0x9bC6369a2D947BdfAEdd74207d3589dbaFc48b52,0xDc1D18df7182b285a69502aB7C08d9a2AA2BDfae
9103,15627894,600000,9223051731,597668,2332,586,1160,0x61ccc13104B547d79fC554CFF9479ecb1AcEDA50,0xb3004D6d3258A417542A3d43e3444ca17d0B0274
9104,15627894,90000,9223051731,90000,0,2,9202,0x6AdA4Ce7537E022367c8c392D196E4ae4F04cEe7,0xA86309988947559b6E72Ef716C5058F479386C0F
9105,15627894,1000000,9223051731,997904,2096,522,71,0x61ccc13104B547d79fC554CFF9479ecb1AcEDA50,0x1eadFC7314101EFB69EAfC620D6AB4ED1cf5e267
9106,15627894,1000000,9223051731,997904,2096,522,195,0x61ccc13104B547d79fC554CFF9479ecb1AcEDA50,0x60118bA5Ef8eD0529fb08bC21C202E6dF15549c2
9107,15627894,21000,9223051731,21000,0,2,0,0x06635F048b35e3Ea1AD9335d3727736c3D45af60,0xD8ce550E67E0beD74dfB0c803d564F41e8cD3952
9108,15627894,21000,9223051731,21000,0,2,6578039,0x6fB626B622fE5956E3925fC72352f6B0047138Ac,0xeB2629a2734e272Bcc07BDA959863f316F4bD4Cf
9109,15627894,550000,9223051731,548152,1848,458,88,0x7a250d5630B4cF539739dF2C5dAcb4c659F2488D,0x00804aD8aa538E852f5Bb4A49f8957a783ac132f
9110,15627894,2000000,9223051731,1998272,1728,458,830,0x7a250d5630B4cF539739dF2C5dAcb4c659F2488D,0xb19AD65C65C6c12C6dCe444F740449714A488A7F
9111,15627894,600000,9223051731,597952,2048,522,2099,0x7a250d5630B4cF539739dF2C5dAcb4c659F2488D,0x81E805660B2b43d582372BECc06Ae504f788E8Ce
9112,15627894,90000,9223051731,90000,0,2,9203,0x22551748ad434dFeBdDd4dccd95C237808877B58,0xA86309988947559b6E72Ef716C5058F479386C0F
9113,15627894,140088,9223051731,138524,1564,394,10,0x1Fa8559e873f698292766790AeCf8080A66433F6,0xD23B0FD5D3C3D1d2d4991a6AfFf62C1703a37302
9114,15627894,90000,9223051731,90000,0,2,9204,0x29cfeB478d5A10FbAa247c09aced7c840dE59C18,0xA86309988947559b6E72Ef716C5058F479386C0F
9115,15627894,215824,9223051731,213988,1836,458,636,0x7a250d5630B4cF539739dF2C5dAcb4c659F2488D,0xbB16B9DD8d06231A4Fd7403cA2BD38EaB20C062B
9116,15627894,1000000,9223051731,996736,3264,1034,629,0x68b3465833fb72A70ecDF485E0e4C7bD8665Fc45,0x3a5B75ff34950cBb5ceD49cde2258E5e3344EAF6
9117,15627894,207128,9223051731,206508,620,138,1312159,0xdAC17F958D2ee523a2206206994597C13D831ec7,0xf60c2Ea62EDBfE808163751DD0d8693DCb30019c
9118,15627894,383031,9223051731,378203,4828,1546,1552,0x68b3465833fb72A70ecDF485E0e4C7bD8665Fc45,0x8250D9a54b1D5C25619265Fa9dCC61744d160d5C
9119,15627894,500000,9223051731,490604,9396,2378,19677,0x03f34bE1BF910116595dB1b11E9d1B2cA5D59659,0x0F9E99217e8a96E6Fd31d2228c8a72C14497116D
9120,15627894,21000,9223051731,21000,0,2,1783211,0x264b5D9587A96F98E9b1700DE699dEc27e9a1A1b,0x503828976D22510aad0201ac7EC88293211D23Da
9121,15627894,39630,9223051731,39354,276,74,82,0xC02aaA39b223FE8D0A0e5C4F27eAD9083C756Cc2,0x60E8A79573782a2c0d383c26C2001dC688E3031b
9122,15627894,21000,9223051731,21000,0,2,8804467,0xc94E8354137F28B3223975cFEaeCA012540317d0,0x3cD751E6b0078Be393132286c442345e5DC49699
9123,15627894,21000,9223051731,21000,0,2,52380,0xcC44d5332527Ac2B96BE8faD172e4966Fc47316e,0x7c195D981AbFdC3DDecd2ca0Fed0958430488e34
9124,15627894,278348,8723051732,276056,2292,650,111462,0xA69babEF1cA67A37Ffaf7a485DfFF3382056e78C,0x065e3DbaFCb2C26A978720f9eB4Bce6aD9D644a1
9125,15627894,46103,8723051731,45615,488,138,116,0x346378C67d0F71343F80299ed8C0407aC2Df05eB,0x9171d441448F16427E1a0a0Cf2e5e32c5F830a15
9126,15627894,213017,8723051731,210977,2040,650,40,0x72Ce9c846789fdB6fC1f34aC4AD25Dd9ef7031ef,0x457b6AC8a31f19AFba1668a4B705b816Bc8EB224
9127,15627894,29005,8723051731,26705,2300,522,272,0x63A993502e74828ddba5710327AFC6dc78d661b2,0xaBfbc4E106219ec35392FC9eC06C26da632BB460
9128,15627894,196344,8723051731,194656,1688,330,21,0x8AA0d86B9A7Dd09fFf4bF7C4f02ae47005C2F930,0xBae73D40b01D4Cb690381926E53Ca01EcD7f2071
9129,15627894,21000,8723051731,21000,0,2,9,0x46b46931423e711D051e264020ACad89c0e147Bd,0x80eD3D73D530f570709c88E43E30F37b8d02045F
9130,15627894,21000,8723051731,21000,0,2,0,0x662f77b70C50E6b6fcdEe5C5A7ad9e187A291CcA,0xBD65Bf9f4b909f0B532a92F260897C4FB8Aa13E8
9131,15627894,181458,8723051731,179906,1552,394,973,0x1Fa8559e873f698292766790AeCf8080A66433F6,0xB8f8130787015d2055B0aE2A34590546c4F261c0
9132,15627894,219324,8723051731,208736,10588,3466,173,0xb4E7B8946fA2b35912Cc0581772cCCd69A33000c,0x7d18504239Dec7672bC64c63E2ECe217557A1B9A
9133,15627894,181476,8723051731,179912,1564,394,2585,0x1Fa8559e873f698292766790AeCf8080A66433F6,0x4a87D1b71937F06Db976631BdFacC82A5cdd076A
9134,15627894,21000,8723051731,21000,0,2,80,0x961ACea233b64d5266AaBC544E7a093aeA434aA2,0xF259D9eB621477acc4eDcbA9B84A00994eD25f76
9135,15627894,165328,8723051731,162592,2736,842,3,0x68b3465833fb72A70ecDF485E0e4C7bD8665Fc45,0xbE56C177E41a2B8a37216b7816231b1C19B20594
9136,15627894,21000,8723051731,21000,0,2,1,0x706391776FCBA77CaCe9302990b3109D8411ef6b,0xd4C2c2427641967DB4Ef106d4665a6B1b90F0c56
9137,15627894,60703,8723051731,53271,7432,2506,825,0x00000000006c3852cbEf3e08E8dF289169EdE581,0x23f3c4dD6297A36A2140d5478188D9e773D3Ac9E
9138,15627894,46103,8723051731,45615,488,138,790,0x34Bc797F40Df0445c8429d485232874B15561728,0x5548584D74f7B5Bd5eD8016755bc1DE27AA35621
9139,15627894,59378,8723051731,52558,6820,2122,20,0x00000000006c3852cbEf3e08E8dF289169EdE581,0xc396cd9EF5C5Fe00B89130DD3834d302972241Fb
9140,15627894,535485,8723051731,531833,3652,1162,100,0x68b3465833fb72A70ecDF485E0e4C7bD8665Fc45,0xB35bCc2a72e69D4a5AB3b08FFe3bdDAED2ce5151
9141,15627894,188096,8723051731,184468,3628,1162,524,0x68b3465833fb72A70ecDF485E0e4C7bD8665Fc45,0x20aBC8fDeB737c921a20dB6dd7a8e9672747a490
9142,15627894,42000,8723051731,42000,0,2,646174,0x2E449298768F76C3981AaBdc94BB9bE75272D131,0x29D5527CaA78f1946a409FA6aCaf14A0a4A0274b
9143,15627894,153115,8723051731,147295,5820,1610,145,0x00000000006c3852cbEf3e08E8dF289169EdE581,0xd99881A272e14666a5b4394f9deeb383fa05F38B
9144,15627894,73188,8723051731,72580,608,138,135,0xA0b86991c6218b36c1d19D4a2e9Eb0cE3606eB48,0x0298d36661300E9146dE58c05A2161155e7b9C38
9145,15627894,235987,8723051731,233239,2748,842,211,0x68b3465833fb72A70ecDF485E0e4C7bD8665Fc45,0x9AC3b437ce4D8F10210955D7A7829f3312612D90
9146,15627894,242090,8723051731,240266,1824,458,1,0x7a250d5630B4cF539739dF2C5dAcb4c659F2488D,0xC6Fc3f59b26e057D965730B7d3758e646568c6A8
9147,15627894,181458,8723051731,179906,1552,394,275,0x1Fa8559e873f698292766790AeCf8080A66433F6,0x4DE51e1699D403483C7da1fb9bf0F49b27028D44
9148,15627894,100569,8723051731,100517,52,10,142,0x1F78bF06b1b14aaF29833Efa371fC090e11D1420,0xFF2C00c056Af3bF2dad57400C8249DEf4744AF7A
9149,15627894,27938,8723051731,27874,64,10,251,0xC02aaA39b223FE8D0A0e5C4F27eAD9083C756Cc2,0x021946d496e19F6a8d7BBA9BC95BE255EbF684D3
9150,15627894,46859,8723051731,46371,488,138,55,0x197492CCB4B1acaAAcd43432657A17832E36AB49,0x3067421ccd1a67d875AD29055185742201363949
9151,15627894,21000,8723051731,21000,0,2,178,0x8E623f3eaA36ED755865CEadEF5a06b761CC16F2,0xD542C581389CE26636A62dFe358cEaE78aEf8A1f
9152,15627894,46255,8723051731,45691,564,74,25,0x283Af0B28c62C092C9727F1Ee09c02CA627EB7F5,0x375613Dd7A028aFb7D865FF5f015b5A62474171b
9153,15627894,21000,8723051731,21000,0,2,79,0x56306d1D113c02D537B4574C6d7572B5DAf35fF4,0x9891f1eD22De10FD7072bD7A22F1e5DFBeBf3EeB
9154,15627894,176930,8723051731,170354,6576,1802,312,0x00000000006c3852cbEf3e08E8dF289169EdE581,0xD6b04B80481Be090E7CD87c8164437c0663E7AB5
9155,15627894,21000,8723051731,21000,0,2,892,0xF162fC5D1174449137E0536923495F3bD9a1380c,0x09682cb7e3545aDa58e8a90776b7dE2ff4011BC6
9156,15627894,21000,8723051731,21000,0,2,15,0x7d03fBc8B6B927bEe5939dcF7766EA8fe35e67A4,0xb8D679335DedCCD4202754458A2334110432b8F3
9157,15627894,21000,8723051731,21000,0,2,285,0x1299f169C0D42d7812A5FAE65feD007984C64c88,0x671c78Ae0eB55e918Cab907AE9201Df00E20A3ea
9158,15627894,399572,8723051731,375784,23788,8338,1362,0x00000000006c3852cbEf3e08E8dF289169EdE581,0xA48a59a8A800af4c0d95261702CeBcD10Fc0EDb9
9159,15627894,45433,8723051731,44789,644,138,86,0x9B9647431632AF44be02ddd22477Ed94d14AacAa,0x2f73ff6Fa843876179AE3db9DCF9422935f66073
9160,15627894,117604,8723051731,113528,4076,1290,9,0x0000000000c2d145a2526bD8C716263bFeBe1A72,0x75a892eF74071e64Ee7a66Cce292867d3b81ACFD
9161,15627894,223043,8723051731,204055,18988,4618,525,0x00000000006c3852cbEf3e08E8dF289169EdE581,0x03A4518Ff4872850d82Dc41450E153AB0c37e6bb
9162,15627894,21000,8723051731,21000,0,2,9,0x1F940B8fACeBE89fF2DC228CC9cBCC60Cdb079B1,0xea7de818f7cf7d74AF242d5F2939B06Bb2EA5133
9163,15627894,21000,8723051731,21000,0,2,18,0xf55f86Cba8f8A64b88f099E944b113B795C60659,0x603cFacd4B16BF416117700666036A38B15625F7
9164,15627894,21000,8723051731,21000,0,2,9,0xcAB4754E5f6Fcac6C0cfD749f3569076C5C293A3,0x6eF314FE7C08Cb78D58Df1995dE6CdF2060435F9
9165,15627894,278954,8723051731,275614,3340,970,38,0x68b3465833fb72A70ecDF485E0e4C7bD8665Fc45,0x3816e1adA945f0a4495036D8F7E852A82495F4f4
9166,15627894,37137,8223051731,36493,644,138,0,0x0F5D2fB29fb7d3CFeE444a200298f468908cC942,0x6c7E44ac12158a8B8181fc0BCd68B8AF289d2D90
9167,15627894,46109,8223051731,45501,608,138,0,0xdAC17F958D2ee523a2206206994597C13D831ec7,0xC2Cd9648aE5E2918ba0bd02403E064728040eFe7
9168,15627894,37043,8223051731,36387,656,138,0,0x2Ab6Bb8408ca3199B8Fa6C92d5b455F820Af03c4,0xFe30Cc59020fE8519F0B2bd3C75777EB5495d864
9169,15627894,37250,8223051731,36606,644,138,5611,0x9f8F72aA9304c8B593d555F12eF6589cC3A579A2,0x05A0F770229Be7FE32cF3849ea33C1E78DEEe8d8
9170,15627894,46097,8223051731,45501,596,138,7,0xdAC17F958D2ee523a2206206994597C13D831ec7,0x867805cc764D075cdBc100a4C163Ebe28Da685ae
9171,15627894,34625,8223051731,33969,656,138,65,0x4e3FBD56CD56c3e72c1403e103b45Db9da5B9D2B,0xA4c507a1eB3cd1bf2c1389F2D6cb93C9be971911
9172,15627894,46121,8223051731,45501,620,138,0,0xdAC17F958D2ee523a2206206994597C13D831ec7,0x87114caD3245fbeC0f5B0a3575f73C67dB8a4C81
9173,15627894,34613,8223051731,33945,668,138,206,0xf1f955016EcbCd7321c7266BccFB96c68ea5E49b,0xDAfc095D560c544d5D37DD4006C87d22fc4F7339
9174,15627894,46097,8223051731,45501,596,138,0,0xdAC17F958D2ee523a2206206994597C13D831ec7,0x1A1F7B0D3d114dc4C7Bbf74712eA421C4B27e0b0
9175,15627894,224901,8223051731,223333,1568,402,6,0x1111111254fb6c44bAC0beD2854e76F90643097d,0x2354d3Ebb064C6610e371e88e26806088D2e443e
9176,15627894,37058,8223051731,36402,656,138,6143,0xd26114cd6EE289AccF82350c8d8487fedB8A0C07,0x6fD72C7A8D1E521B17F321ec6bfC4F83FF58c1e2
9177,15627894,36928,8223051731,36272,656,138,0,0x7D1AfA7B718fb893dB30A3aBc0Cfc608AaCfeBB0,0xeb6a0F6CCC904B9A150EC6f7AA8ceC7fd3cE3e07
9178,15627894,46109,8223051731,45501,608,138,9,0xdAC17F958D2ee523a2206206994597C13D831ec7,0xbcd372E502886C756fE814E400E5D86030B79319
9179,15627894,46097,8223051731,45501,596,138,0,0xdAC17F958D2ee523a2206206994597C13D831ec7,0x485Cb923f3aF87366A79489b58f71edd272Ac995
9180,15627894,46728,8223051731,46240,488,138,49,0x77654e7E579b3C817a3672C1c66c050058b92B85,0x9c9eA22B7DdC9A75c74A0fc22764163c164bef1E
9181,15627894,175110,8223051731,173546,1564,394,1904,0x1Fa8559e873f698292766790AeCf8080A66433F6,0x5B25adE8DbA55fe6D3D7F7719018504899B729e2
9182,15627894,181476,8223051731,179912,1564,394,23,0x1Fa8559e873f698292766790AeCf8080A66433F6,0x6F4CF021C496D0bf8F02dF88517348Cfcb9b5637
9183,15627894,181476,8223051731,179912,1564,394,537,0x1Fa8559e873f698292766790AeCf8080A66433F6,0xaD5efb0A72254eCe67BAfdB22F18E439c42Bb02C
9184,15627894,181476,8223051731,179912,1564,394,300,0x1Fa8559e873f698292766790AeCf8080A66433F6,0x858013142255cad3FD5137bDf4a7A40348Cb4D4a
9185,15627894,175092,8223051731,173540,1552,394,248,0x1Fa8559e873f698292766790AeCf8080A66433F6,0xeC4A2742BBCfBA37234d91cF15224dc5e0dA1A9E
9186,15627894,288746,8223051731,286374,2372,522,363,0x283Af0B28c62C092C9727F1Ee09c02CA627EB7F5,0x023645715ea40e371c01Ff0118AEee075659Bc94
9187,15627894,175110,8223051731,173546,1564,394,10,0x1Fa8559e873f698292766790AeCf8080A66433F6,0xfBccbDf92f1033D260ea8B9E74F44Cf04ae233f4
9188,15627894,181458,8223051731,179906,1552,394,94,0x1Fa8559e873f698292766790AeCf8080A66433F6,0xf3cBd630782A6E306Cca675c55F40EEA24e028e9
9189,15627894,177819,8223051731,177615,204,74,1,0x4F2ac972CC34c6C72015Fd4Cf9D1A7b074DfB285,0x4dbf0d853F8f0Ee58894BF1C612cE3397D8b875C
9190,15627894,181458,8223051731,179906,1552,394,472,0x1Fa8559e873f698292766790AeCf8080A66433F6,0x2334554085b75482C754f94318a277c200561875
9191,15627894,181476,8223051731,179912,1564,394,5,0x1Fa8559e873f698292766790AeCf8080A66433F6,0xA60965F8a89027D0d86692C52adc3350810ed920
9192,15627894,181458,8223051731,179906,1552,394,38,0x1Fa8559e873f698292766790AeCf8080A66433F6,0x95827d2Ab16a42e3A4A4c8451100e8c6fAcC9FA8
9193,15627894,577632,8223051731,575904,1728,458,7996,0x7a250d5630B4cF539739dF2C5dAcb4c659F2488D,0x11191bcfe30c6aE7bBEF74c6De97c8D52FF957F9
9194,15627894,21000,8136800000,21000,0,2,1,0x562680a4dC50ed2f14d75BF31f494cfE0b8D10a1,0x6391712eDDFF3790A7a83DC3751f9c148871F722
9195,15627894,21000,8000000000,21000,0,2,1,0xCDE1C24aCA739AAe96bFDB918367be6215Db14cF,0x7684005E9ea453804aA39108B848C670E795F406
9196,15627894,222222,8000000000,220658,1564,394,109,0x1Fa8559e873f698292766790AeCf8080A66433F6,0xB480E31afd259Fa731d5A7067fb378dFc3c9d983
9197,15627894,80000,8000000000,79392,608,138,4,0xdAC17F958D2ee523a2206206994597C13D831ec7,0xf019aCB78D8c109b1DFBa81D7850EaBe2AF6FfBC
9198,15627894,328490,7458973556,162002,166488,21032,183253,0x5E4e65926BA27467555EB562121fac00D24E9dD2,0x6887246668a3b87F54DeB3b94Ba47a6f63F32985
9199,15627895,500000,100000000000,498116,1884,458,7509,0x7a250d5630B4cF539739dF2C5dAcb4c659F2488D,0xC5C018EDb7Ec3e4217728C1e1F608b28057Dd507
9200,15627895,650000,34541586068,648140,1860,458,2687,0x7a250d5630B4cF539739dF2C5dAcb4c659F2488D,0x345eB826a33bec023A2fb09F35256398563129D4
9201,15627895,890000,32749392899,888164,1836,458,1374,0x7a250d5630B4cF539739dF2C5dAcb4c659F2488D,0x3fD29eFC91BBf692D4cDf5Ce423Fb6B7EE669a6e
9202,15627895,650000,32541586068,648140,1860,458,743,0x7a250d5630B4cF539739dF2C5dAcb4c659F2488D,0x77783fc8bBFCD3edd605488FA8a7B572E4BB45a5
9203,15627895,800000,22638656376,799056,944,138,546,0x6097004C68F7B350d72226003226Ac089597D579,0x2579ae275E44ff501f57962c79ce67F56266c4A5
9204,15627895,800000,22638656376,799056,944,138,1385,0x6097004C68F7B350d72226003226Ac089597D579,0xF468D4a36023351Cc25Ac31c31658B3077C936D0
9205,15627895,800000,22638656376,799056,944,138,458,0x6097004C68F7B350d72226003226Ac089597D579,0xF41F37c584835426DBC519766f888dC5881A3827
9206,15627895,400000,17541586068,399012,988,202,395,0xdAC17F958D2ee523a2206206994597C13D831ec7,0x856EF59Ccfb4cae6947f138Bf29f16bC6552e172
9207,15627895,800000,14425604645,795060,4940,714,24950,0x767AF52d988D1241A346851a1B39cCd11357376E,0xD1b72A8Ae97f51D7bd4Af257A124175688924001
9208,15627895,21000,14000000000,21000,0,2,2,0x500A746c9a44f68Fe6AA86a92e7B3AF4F322Ae66,0x578C0EcF700a8A5b17877Bc535a82B61075f49c0
9209,15627895,90000,13000000000,89392,608,138,0,0xdAC17F958D2ee523a2206206994597C13D831ec7,0x30868223A3cb6Dc4B1746EE8807FAa7372457540
9210,15627895,800000,12638656376,798164,1836,458,128,0x7a250d5630B4cF539739dF2C5dAcb4c659F2488D,0xe001b672D7e2E779fDc34D0E69bB223994621403
9211,15627895,300014,11638656376,298142,1872,458,14276,0x0c3DE458b51A11da7D4616f42F66C861e3859D3E,0xf4b4e6fCD0CFb6E3d70821c136b9c5aA0E0936f2
9212,15627895,500000,11638656376,498716,1284,266,4496,0x3E4a3a4796d16c0Cd582C382691998f7c06420B6,0x15ec4512516D980090050fE101de21832c8edFee
9213,15627895,100000,11312379102,99392,608,138,181439,0x473037de59cf9484632f4A27B509CFE8d4a31404,0x6238872A0Bd9F0E19073695532a7Ed77ce93C69E
9214,15627895,500000,10638656376,498040,1960,394,60931,0x585C3d4Da9b533C7e3dF8AC7356C882859298cEe,0xd5cf0Cb9a8DF9B46f077f561d8b76c34A69bD82F
9215,15627895,181476,10638656376,179912,1564,394,448,0x1Fa8559e873f698292766790AeCf8080A66433F6,0x78B23Ba27451F96F835f9A3F2EE716bCAfA02479
9216,15627895,329040,10138656376,324708,4332,1034,2,0x197492CCB4B1acaAAcd43432657A17832E36AB49,0x1887d0c56E5F929C30B3A7f5e3aB4e88e84341A7
9217,15627895,1000000,10138656376,999056,944,138,211,0x6097004C68F7B350d72226003226Ac089597D579,0x0f86A7ac82C47e8C305Cc58839C842F5B6Fb031a
9218,15627895,50000,10074210768,50000,0,2,1210293,0xA8Ee673bd7838C9cC1F01E52762bD1942c338c8a,0x912fD21d7a69678227fE6d08C64222Db41477bA0
9219,15627895,21000,10000000000,21000,0,2,168679,0x7178B4D9BF19C6Ad413E4442bD317f8c8428139F,0x4E5B2e1dc63F6b91cb6Cd759936495434C7e972F
9220,15627895,21000,9688656376,21000,0,2,98,0xda32C9E44c143585856610de6F8395544fae61Ff,0x77F91D80D731953604B6956453Ff38Dd59199F33
9221,15627895,21000,9638656376,21000,0,2,52381,0xE4981713393d2Ae532CAe7b7c6551f18205e5BAA,0x7c195D981AbFdC3DDecd2ca0Fed0958430488e34
9222,15627895,890000,9638656376,887964,2036,522,446,0x7a250d5630B4cF539739dF2C5dAcb4c659F2488D,0x6a75Ab6741Ef07b927d22c3befbfB7794E395a40
9223,15627895,890000,9638656376,888140,1860,458,347,0x7a250d5630B4cF539739dF2C5dAcb4c659F2488D,0x44640943CAabaaeA2c8bA9760B4678e880Ab1feA
9224,15627895,21000,9638656376,21000,0,2,7100804,0xe1c0C620bf9c63C996b2d319EB6dD8b1b166D8c1,0xddfAbCdc4D8FfC6d5beaf154f18B778f892A0740
9225,15627895,890000,9638656376,887964,2036,522,1784,0x7a250d5630B4cF539739dF2C5dAcb4c659F2488D,0xf3B3E4C1b2e215ffe8d1d82904070a5170D6bE63
9226,15627895,49542,9638656376,49478,64,10,245,0xC02aaA39b223FE8D0A0e5C4F27eAD9083C756Cc2,0x122917e191d4A0e46A35d5a5f79Ae9d3fea765A1
9227,15627895,39617,9638656376,39353,264,74,90,0xC02aaA39b223FE8D0A0e5C4F27eAD9083C756Cc2,0xfcAEd3c07DAa9Af2A4Ff266B0DFBD5214FE25f24
9228,15627895,21000,9638656376,21000,0,2,6032,0x3887f9F1fEb1957530Fb02C3b3A6328418AC247D,0x65768f7e9448595181271a0Af9A2351D383ace1a
9229,15627895,49542,9638656376,49478,64,10,219,0xC02aaA39b223FE8D0A0e5C4F27eAD9083C756Cc2,0x00002Af92bFc4502bcE533589f7C7d8340280e67
9230,15627895,54040,9638656376,53764,276,74,186,0xC02aaA39b223FE8D0A0e5C4F27eAD9083C756Cc2,0x6a5e857D6Cf35083480224AE0619BB801acDC4BC
9231,15627895,207128,9638656376,206532,596,138,4708713,0xdAC17F958D2ee523a2206206994597C13D831ec7,0x28C6c06298d514Db089934071355E5743bf21d60
9232,15627895,207128,9638656376,207128,0,2,4232349,0x1162A9D22E3a40aefE5Ab0985da25efe2A6B57C0,0xDFd5293D8e347dFe59E90eFd55b2956a1343963d
9233,15627895,207128,9638656376,207128,0,2,3199183,0xb9e2b6b3367180f4408fc37075e77c7EfEEFCa41,0x9696f59E4d72E237BE84fFD425DCaD154Bf96976
9234,15627895,207128,9638656376,207128,0,2,4468964,0xA7B24b28fAcf1ad498b38fE57C532E2Ed502fe82,0x21a31Ee1afC51d94C2eFcCAa2092aD1028285549
9235,15627895,207128,9638656376,207128,0,2,3492289,0x473eb485A3af9767E1c68d84E7D59e2270FE0596,0x56Eddb7aa87536c09CCc2793473599fD21A8b17F
9236,15627895,207128,9638656376,207128,0,2,1679536,0x091caFe937Cc446fCC45a87FCbB8d55590B862Dd,0x4976A4A02f38326660D17bf34b431dC6e2eb2327
9237,15627895,181458,9638656376,179906,1552,394,88,0x1Fa8559e873f698292766790AeCf8080A66433F6,0xf11E043369BcFeA0A11B7eEDC8DD6D1b1a9024a9
9238,15627895,100000,9638656376,99036,964,202,88942,0xdAC17F958D2ee523a2206206994597C13D831ec7,0x3018018c44338B9728d02be12d632C6691E020d1
9239,15627895,2899460,9638656376,2899396,64,10,8,0xda1f37F7d37bcE8ffc3Ef9188d853573236978E9,0x062d96Dfc60e90c2C40BBA382e3EbA9D3fB91901
9240,15627895,21000,9638656376,21000,0,2,62,0xB3350Fd1980e04a1282954b216DbC68b9f05D653,0xcc8992DcA072330ACC2E0DCC13d67edf27ddCf32
9241,15627895,193423,9638656376,193219,204,74,592,0xd06966a7860131a8f858573bd76d08c27e7286bA,0xCB405895fe35Ca438BF87Bf59fa490ad16c45500
9242,15627895,266456,9456957877,266456,0,2,111042,0x36a454aEF52938c8637CD4689B2980C1Cfd43389,0x36a454aEF52938c8637CD4689B2980C1Cfd43389
9243,15627895,21000,9430000000,21000,0,2,705890,0x87a5Fa4BE404Cf3F61EF8951919f9F5f9523dAB9,0x6dfc34609a05bC22319fA4Cce1d1E2929548c0D7
9244,15627895,409452,9148656376,408520,932,330,1080,0x838af967537350D2C44ABB8c010E49E32673ab94,0xc926Ea5c9897cCBB7932BDfCC5AFF8e903804559
9245,15627895,92151,9138656376,92087,64,10,77,0x4Dbd4fc535Ac27206064B68FfCf827b0A60BAB3f,0xE76f1230c61160206306CB55e524d5843bAD697a
9246,15627895,576559,9138656376,573035,3524,546,49932,0xED77777586D73C58EB4D6BEBDF9c85C2d5F56C2d,0x4425C20D8e84c48AEbEB116cF7b9838D4833f78D
9247,15627895,801980,9138656376,798716,3264,650,68004,0x00000000C2Cf7648c169b25ef1C217864bFa38cC,0x6B113626451dE75986D43F5FdF67fE7fDD777a92
9248,15627895,46109,9138656376,45621,488,138,49,0xF7b8aabC98D169020b9EE716FC55541cF3e8B55B,0xe167891353Ea02692d4aCfC04660BE1DdA20C68E
9249,15627895,69951,9138656376,68223,1728,458,614,0x495f947276749Ce646f68AC8c248420045cb7b5e,0xAa884ac9BB63d810baEdA6a4A5E8406FEE088D51
9250,15627895,46479,9138656376,45535,944,138,9,0x5f98805A4E8be255a32880FDeC7F6728C6568bA0,0xc4363bB3064F37c5E83630f28075a36f0C455cD6
9251,15627895,181476,9138656376,179912,1564,394,182,0x1Fa8559e873f698292766790AeCf8080A66433F6,0xebdB40f3c45c19f060e9413D8c7b93209d0F289c
9252,15627895,1000000,9138656376,999380,620,138,4121142,0x467719aD09025FcC6cF6F8311755809d45a5E5f3,0x0D0707963952f2fBA59dD06f2b425ace40b492Fe
9253,15627895,92151,9138656376,92087,64,10,80,0x4Dbd4fc535Ac27206064B68FfCf827b0A60BAB3f,0x5cF89dddc12F5Fa6796fA925E3175D43b8958268
9254,15627895,61459,9138656376,53271,8188,2506,48,0x00000000006c3852cbEf3e08E8dF289169EdE581,0x5B471f5294eAe5014b61D9FF18e7493eA667A8C5
9255,15627895,21000,9138656376,21000,0,2,353,0x1750fAa03511E5BbaF0713f9692F461E4a3985eE,0xD13d8625FAeE6695d88c63e181c3c9BEd5883D36
9256,15627895,46280,9138656376,45420,860,138,20,0xC02aaA39b223FE8D0A0e5C4F27eAD9083C756Cc2,0x0579f9Bc6396B0F185B4B9dcC5Ca5578F59502a9
9257,15627895,135887,9138656376,133771,2116,778,1383,0x34c3f58058E2ad098ef437Ee5Ea1ff1fE2fe4214,0x33de5f7c0dcFfBbC399b603FF539250a2c132E3c
9258,15627895,73170,9138656376,72574,596,138,3,0xA0b86991c6218b36c1d19D4a2e9Eb0cE3606eB48,0xc73B7188C60796453Df1bEEA13cA718642cB3239
9259,15627895,161554,9138656376,154990,6564,1802,255,0x00000000006c3852cbEf3e08E8dF289169EdE581,0xeC89443A080c12c456adCf754764eC31a32865f3
9260,15627895,200000,9138656376,199392,608,138,1,0xA0b86991c6218b36c1d19D4a2e9Eb0cE3606eB48,0x50e9eee45E2bAA80075fcA9cb77279b3fe2aAa06
9261,15627895,55978,9138656376,55034,944,138,173,0xd4cB651749953988647eEE9b51DDB8DB5aeb3410,0xdF5b47c2da00c1666c365f20521D08E860167539
9262,15627895,170256,9138656376,141548,28708,9610,304,0x00000000006c3852cbEf3e08E8dF289169EdE581,0xb25FdD291170a350dC09bc26c12C6c11704e64Ee
9263,15627895,21000,9138656376,21000,0,2,357,0x28C756268ca3BcC488db5554578Dc4Ef74Bb580d,0xCd8A0439E08c13d1610af5CCFf2470726Ca2201e
9264,15627895,73188,9138656376,72580,608,138,13,0xA0b86991c6218b36c1d19D4a2e9Eb0cE3606eB48,0x3d4159Bc4980D53C99291b924cB7970F6AdC2265
9265,15627895,46267,9138656376,45691,576,74,75,0x283Af0B28c62C092C9727F1Ee09c02CA627EB7F5,0x9Ac7F0164eC02E7b8ba0787b08176a8c125938Df
9266,15627895,51547,9138656376,50951,596,138,237,0x467719aD09025FcC6cF6F8311755809d45a5E5f3,0x2EF99ffCcEF20d1C2e7A0073994a9b957dB6b3F1
9267,15627895,200000,9138656376,199404,596,138,1,0xA0b86991c6218b36c1d19D4a2e9Eb0cE3606eB48,0xa51E7979A6679C14f45E0ddAd75adE4779683863
9268,15627895,184732,9138656376,184528,204,74,99,0xa404F66B9278c4aB8428225014266B4B239bcdc7,0x8bA6C358fC7513369d32DCe31bECb5Eee52Ab11F
9269,15627895,191606,9138656376,172094,19512,4682,1158,0x00000000006c3852cbEf3e08E8dF289169EdE581,0xEd04eff2e061f1FFF5F04bfd97E3B9A07B698855
9270,15627895,81694,9138656376,79930,1764,458,29,0xFbdDaDD80fe7bda00B901FbAf73803F2238Ae655,0x2959EF031fF4a358867433002ede7Cb24B2C7Def
9271,15627895,21000,9138656376,21000,0,2,46,0xacc71131DFADD1c658F11AAbEd9508559Ba55630,0x08d70b5dD4e03e1F433B10bD7EFD671ef08fe6A3
9272,15627895,227359,9138656376,207835,19524,4682,25,0x00000000006c3852cbEf3e08E8dF289169EdE581,0xD49C4eab9b614bF8AE0c21D9e9b751ad3Cae900a
9273,15627895,21000,9138656376,21000,0,2,142,0xB7312EdDB85E50dAd4064713d6C9b5E0bcBD673A,0x70cC3dBf976a17d1109a90dA0613d030942e0977
9274,15627895,94831,9138656376,94211,620,138,5,0xdAC17F958D2ee523a2206206994597C13D831ec7,0x404583ebd340981AfD4D03abC0476C2bb593281b
9275,15627895,21000,9138656376,21000,0,2,797,0xd1ecD014788e5ba060b6EA5994dcC882574C0d99,0xFDcad20E6C388E2FF2197Ed53C7Fc7648f653527
9276,15627895,21000,9138656376,21000,0,2,27,0x61888F465d4855BE550B023861d5ab48210E0BC6,0xc26e25534A74CF5fAE0b47778d17Cc11548B622a
9277,15627895,21000,9138656376,21000,0,2,89,0x112BE2529e1fFC64d486189293Cd60dE0B52e7E0,0x9fec0B651a5624687001BCc24e86958a2750ba0a
9278,15627895,53915,9138656376,53427,488,138,536,0x6de7aC835EC6841Af9b94fd1273dB83B8d69e3f7,0xB8c8B2c88EF35d8403CC98d8A28Fdf77288D56AC
9279,15627895,49175,9138656376,48687,488,138,2205,0x7f738Ad7072187909384B2ffBaEEdC3C1DA1b686,0xF6926D15fC0Ee0113aC4840E7d881D92Cf193a7d
9280,15627895,51458,9138656376,50970,488,138,121,0x7F9306FC1978938d5C1C57Bf6044dc67E07eeB8a,0x53cF6198b88c405870D88D75968B34ce53a6C968
9281,15627895,200000,9138656376,199320,680,138,1,0x514910771AF9Ca656af840dff83E8264EcF986CA,0x48B5D88E43AAa483FA33B1cd70E294ba0A694dF5
9282,15627895,21000,9138656376,21000,0,2,151,0xdA9b84861223ccBB7B93aDC9c9b8F9bD94A75af6,0x3a548339a9cD1ce58DCcbdc317131cB193aECb77
9283,15627895,200000,9138656376,199332,668,138,1,0xBB0E17EF65F82Ab018d8EDd776e8DD940327B28b,0xf755285e0940b909e306eA17BeEA1415b1c9A605
9284,15627895,92151,9138656376,92087,64,10,61,0x4Dbd4fc535Ac27206064B68FfCf827b0A60BAB3f,0x7E9f0b4F5b2EFB71a4e8c28fEBAb563b9317b5F9
9285,15627895,200000,9138656376,199320,680,138,1,0x3845badAde8e6dFF049820680d1F14bD3903a5d0,0xeA1E5Ad97A124E15F209959a39f7c77BEFB1cD79
9286,15627895,188306,9138656376,176766,11540,3594,924,0x74312363e45DCaBA76c59ec49a7Aa8A65a67EeD3,0xc0592a97737faAE28575EB7181947DD528027CE6
9287,15627895,21000,9138656376,21000,0,2,2483,0xb7B1568E2A54784b29AEC162AC34012fa9938B90,0xeb6Bc3940C9fe8D7A90BAeB168F64F2FeCD9A5cE
9288,15627895,216497,9138656376,213749,2748,650,1893238,0xD1669Ac6044269b59Fa12c5822439F609Ca54F41,0xD2C82F2e5FA236E114A81173e375a73664610998
9289,15627895,185283,9138656376,181703,3580,1162,295,0x68b3465833fb72A70ecDF485E0e4C7bD8665Fc45,0xd8d415806d20a7D1d28758C6BD73285ef2657888
9290,15627895,56713,9138656376,55769,944,138,1653,0x1C4853Ec0d55e420002c5eFaBc7Ed8e0bA7A4121,0x3d26b43dD2181471b46cF484dd8c06C47c050d4C
9291,15627895,85449,8768656376,84517,932,138,62,0xae7ab96520DE3A18E5e111B5EaAb095312D7fE84,0x57559246958078503FBc24D8E8D5b419d6CAb24C
9292,15627895,90307,8760000000,90243,64,10,68,0xb55e1442EDA37d31249f97b3fCA6DEF588346FeF,0x3E19C16f4e89f982e75d18e3B4DAeE565Fb45B0d
9293,15627895,264968,8693080199,260188,4780,1042,0,0x1111111254fb6c44bAC0beD2854e76F90643097d,0x433dC467dD8EF8c30c93C81829258804BC276167
9294,15627895,250000,8638656376,250000,0,2,45337148,0x687072b41a8bb5cb78fd72c43c21c7C9428Ce749,0xEA674fdDe714fd979de3EdF0F56AA9716B898ec8
9295,15627895,250000,8638656376,250000,0,2,45337149,0x5A14E054b88f3E72F75153300C70D9Aa1e6644E8,0xEA674fdDe714fd979de3EdF0F56AA9716B898ec8
9296,15627895,181476,8638656376,179912,1564,394,383,0x1Fa8559e873f698292766790AeCf8080A66433F6,0x18a55Cf5abB202e8f289AD561D0985aF5b02699b
9297,15627895,250000,8638656376,250000,0,2,45337150,0x1d85087C6535C4A837C3920f844f6CD4BFCbD8c6,0xEA674fdDe714fd979de3EdF0F56AA9716B898ec8
9298,15627895,250000,8638656376,250000,0,2,45337151,0xba29A01EFb2A7edb81010BFfB6e44e51d73240F5,0xEA674fdDe714fd979de3EdF0F56AA9716B898ec8
9299,15627895,250000,8638656376,250000,0,2,45337152,0xb72B044a749bC6f11c411eE6ffae7B516BEa8E8C,0xEA674fdDe714fd979de3EdF0F56AA9716B898ec8
9300,15627895,250000,8638656376,250000,0,2,45337153,0xEF2fA4d50300E00a6B176cF9A36D66F9E5001545,0xEA674fdDe714fd979de3EdF0F56AA9716B898ec8
9301,15627895,113310,8638656376,113106,204,74,367,0x5D004ddB5D92938dAF8448b9eac1CaA593cd26Ca,0x26DC5D39Bd7A8bc2d792dcAAAC55FE6DCef25593
9302,15627895,250000,8638656376,250000,0,2,45337154,0x01Ab9345C102718C42B1dee9a531C1F3F2B30bf7,0xEA674fdDe714fd979de3EdF0F56AA9716B898ec8
9303,15627895,250000,8638656376,250000,0,2,45337155,0x04724Eb5a38a349131A4DBA4aa723947475EbF26,0xEA674fdDe714fd979de3EdF0F56AA9716B898ec8
9304,15627895,250000,8638656376,250000,0,2,45337156,0x619B36Eb86512789615d0b706Ed9fFfF214Cb7Ab,0xEA674fdDe714fd979de3EdF0F56AA9716B898ec8
9305,15627895,250000,8638656376,250000,0,2,45337157,0x2CbeC3126d155b55672F08696b355407d1Ff8Dde,0xEA674fdDe714fd979de3EdF0F56AA9716B898ec8
9306,15627895,250000,8638656376,250000,0,2,45337158,0x070389f319EFaDAD21e190C62C6a6a2037e8c48c,0xEA674fdDe714fd979de3EdF0F56AA9716B898ec8
9307,15627895,175110,8638656376,173546,1564,394,1,0x1Fa8559e873f698292766790AeCf8080A66433F6,0x4423e59d349ACED9612C8CfcED3Dfc1f8f6880B7
9308,15627895,113310,8638656376,113106,204,74,368,0x5D004ddB5D92938dAF8448b9eac1CaA593cd26Ca,0x26DC5D39Bd7A8bc2d792dcAAAC55FE6DCef25593
9309,15627895,175110,8638656376,173546,1564,394,101,0x1Fa8559e873f698292766790AeCf8080A66433F6,0xAaeA22f95EA7ceCa052ba6461E7D1c8b40AD109d
9310,15627895,181476,8638656376,179912,1564,394,3858,0x1Fa8559e873f698292766790AeCf8080A66433F6,0x3FBe2fd902D278e3f05575149505F998445Ea4b0
9311,15627895,252266,8638656376,248950,3316,970,26,0x68b3465833fb72A70ecDF485E0e4C7bD8665Fc45,0xC4b658Af0BB4524185da99dF5E84DB2B4CB69B08
9312,15627895,113310,8638656376,113106,204,74,369,0x5D004ddB5D92938dAF8448b9eac1CaA593cd26Ca,0x26DC5D39Bd7A8bc2d792dcAAAC55FE6DCef25593
9313,15627895,181476,8638656376,179912,1564,394,114,0x1Fa8559e873f698292766790AeCf8080A66433F6,0x9AbbdeCc074db1F6ceD3500B3Eb6A5C416B218A9
9314,15627895,274299,8638656376,272975,1324,394,897,0x283Af0B28c62C092C9727F1Ee09c02CA627EB7F5,0x42E2f1c250d46e3d13102a2e1da6298bB8116F87
9315,15627895,175110,8638656376,173546,1564,394,34,0x1Fa8559e873f698292766790AeCf8080A66433F6,0xE6C2d21e3e54B8a38C593Bf1970fACCDab3B2761
9316,15627895,200000,8638656376,199392,608,138,1,0xA0b86991c6218b36c1d19D4a2e9Eb0cE3606eB48,0x1203a61d05B99b0c3D3A93CBF7CA6c4dCC686510
9317,15627895,200000,8638656376,199380,620,138,1,0xA0b86991c6218b36c1d19D4a2e9Eb0cE3606eB48,0x78418eAdDFbbfa9c60ced65445647848396D6Aae
9318,15627895,113310,8638656376,113106,204,74,370,0x5D004ddB5D92938dAF8448b9eac1CaA593cd26Ca,0x26DC5D39Bd7A8bc2d792dcAAAC55FE6DCef25593
9319,15627895,181476,8638656376,179912,1564,394,15,0x1Fa8559e873f698292766790AeCf8080A66433F6,0xA7Cbc9a3d64D4a2a62f5b07dD97b5c08bD33519e
9320,15627895,181476,8638656376,179912,1564,394,1081,0x1Fa8559e873f698292766790AeCf8080A66433F6,0x52b531749d8DF5eaA86e932245E3FA57c953f489
9321,15627895,21000,8638656376,21000,0,2,102641,0xe147122Ae0092357960945e3b56aC8debF0458cf,0x2Db1D8CdF1Abe8C70b531a790CDf2FF38aecF652
9322,15627895,113310,8638656376,113106,204,74,371,0x5D004ddB5D92938dAF8448b9eac1CaA593cd26Ca,0x26DC5D39Bd7A8bc2d792dcAAAC55FE6DCef25593
9323,15627895,333846,8485273368,325334,8512,2386,186,0x1111111254fb6c44bAC0beD2854e76F90643097d,0xeBB1110Cb4F95B779b2239702f39b452353295Bc
9324,15627895,2000000,8295744675,1997928,2072,522,404,0x7a250d5630B4cF539739dF2C5dAcb4c659F2488D,0xC1604496e206B7ff546c602Fdd5Ab69cF15f3DA7
9325,15627895,2000000,8295744675,1997940,2060,522,476,0x7a250d5630B4cF539739dF2C5dAcb4c659F2488D,0xCa6b060a4E795473a2205ebD1ff2599A8bEF1DF8
9326,15627895,21000,8120000000,21000,0,2,43,0x8924da29eEAAaeF281454d588D9E570eF090F3A0,0x17d035769a5Cd06B2d725A33d9BB8d1b0bb62ed9
9327,15627895,116536,8000000000,116236,300,74,100,0xEA5edef17986EAbb7333bacdC9E2F574C7Fe6935,0x5bA8c6D365fa5D0d21a831753F38C74b4ba7D89B
9328,15627895,51290,8000000000,50346,944,138,416,0x3Cf19Ba410FA07e20854e8520227f756c8Afd655,0x3A73b93c5bd2FF728741b1F62E83477b7367B8EB
9329,15627895,55978,7977238281,55034,944,138,55,0xd4cB651749953988647eEE9b51DDB8DB5aeb3410,0x0f9bcc9A6A53aC3B0Dd792A355D9c64c4EA34848
9330,15627895,49000,7910000000,49000,0,2,19268,0xd20C2eb211990D13aa2eeBc94Fb69686f0E99a07,0x8924da29eEAAaeF281454d588D9E570eF090F3A0
9331,15627896,279952,305581515638,279952,0,2,122593,0x1c8F6A5F009E051CaB9C3851ca2DA2c936b2775A,0x1c8F6A5F009E051CaB9C3851ca2DA2c936b2775A
9332,15627896,257602,278975604848,256322,1280,264,12090,0xBEEFBaBEeA323F07c59926295205d3b7a17E8638,0x6Cffc7fe15CAA05078e55c2EDE55FBBBcceEBc84
9333,15627896,496735,126063672984,481323,15412,4882,1405,0x1111111254fb6c44bAC0beD2854e76F90643097d,0x47c62785133330467304Ae83Db4b4DD5fBb4Ce1b
9334,15627896,71000,80752188244,71000,0,2,2360,0xd10Cd08975256CC9db51F0d6c888244D231A3002,0xd10Cd08975256CC9db51F0d6c888244D231A3002
9335,15627896,600000,80000000000,599056,944,138,335,0x6097004C68F7B350d72226003226Ac089597D579,0xb04F4bB5e69e1A27E559890dDc98e1D6cb418501
9336,15627896,600000,80000000000,599056,944,138,661,0x6097004C68F7B350d72226003226Ac089597D579,0x19B17B12AE586670E9Df3dC982Ea74d8fb83fa6F
9337,15627896,750000,70000000000,749056,944,138,1109,0x6097004C68F7B350d72226003226Ac089597D579,0x64AA949A7952b2b0E51BacdB8cdC11feba1e6DDA
9338,15627896,750000,70000000000,749056,944,138,24,0x6097004C68F7B350d72226003226Ac089597D579,0xB286776A207ddC1dF0033BA9323891F9309319BA
9339,15627896,161524,67310711031,160176,1348,190,2326,0x9507c04B10486547584C37bCBd931B2a4FeE9A41,0x0f2De9AE421d6951dE9AE7128b4C8074fdD07c89
9340,15627896,126966,53000000000,126322,644,138,109228,0x4Fabb145d64652a948d72533023f6E7A623C7C53,0xc5a8859c44aC8AA2169aFaCF45B87C08593beC10
9341,15627896,600000,50000000000,599056,944,138,201,0x6097004C68F7B350d72226003226Ac089597D579,0x4Afab73079477b2ddaA684B8953AE800A8f38a9A
9342,15627896,243158,7459669672,242514,644,90,103246,0x01FF6318440f7D5553a82294D78262D5f5084EFF,0x5AA17fC7F2950ECa85376C3A8CB1509e8e4B39dF
9343,15627896,334962,12459669672,333042,1920,458,215,0x7a250d5630B4cF539739dF2C5dAcb4c659F2488D,0x11cE31192602A36f4203b264da3132D2a5A9BF17
9344,15627896,188055,102226244449,187079,976,130,103247,0x01FF6318440f7D5553a82294D78262D5f5084EFF,0x5AA17fC7F2950ECa85376C3A8CB1509e8e4B39dF
9345,15627896,45000,31621665801,45000,0,2,53739,0x0000000000007F150Bd6f54c40A34d7C3d5e9f56,0x048Fde2d3d47F54d3E7bE0Be7A40e1cb5AfF5d72
9346,15627896,31205,27847748597,31205,0,2,48496,0x4dC9e781Fef18fa4Dc5217A5Ee1156f668B5aF55,0x4dC9e781Fef18fa4Dc5217A5Ee1156f668B5aF55
9347,15627896,800000,22459669672,798012,1988,522,1386,0x7a250d5630B4cF539739dF2C5dAcb4c659F2488D,0xF468D4a36023351Cc25Ac31c31658B3077C936D0
9348,15627896,800000,22459669672,798012,1988,522,547,0x7a250d5630B4cF539739dF2C5dAcb4c659F2488D,0x2579ae275E44ff501f57962c79ce67F56266c4A5
9349,15627896,800000,22459669672,798012,1988,522,459,0x7a250d5630B4cF539739dF2C5dAcb4c659F2488D,0xF41F37c584835426DBC519766f888dC5881A3827
9350,15627896,90000,20000000000,90000,0,2,308764,0xe8b8FeBD75aadB85DF33ade6e7Fa261093959C5D,0xCAc725beF4f114F728cbCfd744a731C2a463c3Fc
9351,15627896,69938,17459669672,68994,944,138,49,0x6097004C68F7B350d72226003226Ac089597D579,0x2eD539e35419d017E6448C932ed8268964883287
9352,15627896,21000,15879305761,21000,0,2,33037,0x871b426a1653E49518a0Dd2b557dDE9297d5364b,0xBd9B34cCbb8db0FDECb532B1EAF5D46f5b673fE8
9353,15627896,21000,15400000000,21000,0,2,5,0x500A746c9a44f68Fe6AA86a92e7B3AF4F322Ae66,0xdF6D0772AC912f2ED5FAf89f2Bfdb9535a4e3ceb
9354,15627896,800000,14246617941,795060,4940,714,24951,0x767AF52d988D1241A346851a1B39cCd11357376E,0xD1b72A8Ae97f51D7bd4Af257A124175688924001
9355,15627896,268420,8459669672,266152,2268,650,119833,0xA69babEF1cA67A37Ffaf7a485DfFF3382056e78C,0xeCa2e2D894D19778939bD4DfC34D2a3C45E96456
9356,15627896,250312,18238620597,249020,1292,204,13129,0x54e349aBB411acE43AcFc81e3f102DF4314875C1,0xc207C7b5A4735DE955C4CF844E10bE8c8034d760
9357,15627896,269532,12798202877,267264,2268,650,106634,0xA69babEF1cA67A37Ffaf7a485DfFF3382056e78C,0x9AAb3F81604c683a1a0D14019FBfe15bef7aA1ee
9358,15627896,350000,12560041628,349392,608,138,6925065,0xdAC17F958D2ee523a2206206994597C13D831ec7,0x46340b20830761efd32832A74d7169B29FEB9758
9359,15627896,350000,12560041628,350000,0,2,6925066,0xD0732775F0B7bbEe8e4580451a4dfA61F8AbF148,0x46340b20830761efd32832A74d7169B29FEB9758
9360,15627896,350000,12560041628,349332,668,138,6925067,0x95aD61b0a150d79219dCF64E1E6Cc01f0B64C4cE,0x46340b20830761efd32832A74d7169B29FEB9758
9361,15627896,600000,12459669672,599056,944,138,1974,0x6097004C68F7B350d72226003226Ac089597D579,0xb46E6dAefED2591385FD5214d0E42806a2d4f2C6
9362,15627896,600000,12459669672,599056,944,138,1122,0x6097004C68F7B350d72226003226Ac089597D579,0xe8d3861316f5732c96559eCFf25701c7aDc7ca7b
9363,15627896,600000,12459669672,599056,944,138,989,0x6097004C68F7B350d72226003226Ac089597D579,0x989f9Bf517053378a055df4DD555010673734a18
9364,15627896,385088,12459669672,383360,1728,458,6,0x7a250d5630B4cF539739dF2C5dAcb4c659F2488D,0x5cc8E247536d19Cd4fa8245eb84ce8677bB20c2E
9365,15627896,181458,12000000000,179906,1552,394,396,0x1Fa8559e873f698292766790AeCf8080A66433F6,0x26003CFF6bb26bF68Ab49622f18c8Ec247c083bF
9366,15627896,162582,11459669672,160974,1608,230,5351,0x9507c04B10486547584C37bCBd931B2a4FeE9A41,0xF42508a3f1F3F097E7cfe5080feba1A8FD97D192
9367,15627896,63000,11217884547,63000,0,2,2710062,0x88877A586B1D7FCAA8859F1E22f6F0009Dd1B3f8,0xC098B2a3Aa256D2140208C3de6543aAEf5cd3A94
9368,15627896,97381,11199273081,96785,596,138,4709939,0xA0b86991c6218b36c1d19D4a2e9Eb0cE3606eB48,0x2FAF487A4414Fe77e2327F0bf4AE2a264a776AD2
9369,15627896,68695,11217884547,67671,1024,202,4709940,0x32353A6C91143bfd6C7d363B546e62a9A2489A20,0x2FAF487A4414Fe77e2327F0bf4AE2a264a776AD2
9370,15627896,146253,11000000000,145309,944,138,962,0x6097004C68F7B350d72226003226Ac089597D579,0xbaAbc782E6Ca0F76072301461aaC0d8A27209F58
9371,15627896,146253,11000000000,145309,944,138,29,0x6097004C68F7B350d72226003226Ac089597D579,0x7676E4779F14C73d9ED01f47DCdec51A0C99687a
9372,15627896,181476,11000000000,179912,1564,394,895,0x1Fa8559e873f698292766790AeCf8080A66433F6,0x1171945fA7c887eE25380AEF02c9c620638283b6
9373,15627896,242150,11000000000,241782,368,138,71,0x0802f7a7c48426E972a30aAaB3C2f35c14a35Bc8,0x3bd75973B3A6Bd6eB69632898182B0677216b064
9374,15627896,111588,11000000000,109636,1952,330,10,0x00000000000C2E074eC69A0dFb2997BA6C7d2e1e,0x03cc71FBe5E1620f5a3D9aC2135642260ADC82bb
9375,15627896,241557,11000000000,240425,1132,394,399,0x5411894842e610C4D0F6Ed4C232DA689400f94A1,0x9753Dc0C13b3685833756a3Cb0006D5ef3e78458
9376,15627896,62182,10820000000,61538,644,138,9,0x6B175474E89094C44Da98b954EedeAC495271d0F,0x54e301D503684e37fc48Dc2B2CD3CbB4C23f339d
9377,15627896,55345,10760000000,54725,620,138,12,0xdAC17F958D2ee523a2206206994597C13D831ec7,0xCE02e328BDE6197dB738567a5153482845931Ce5
9378,15627896,750000,7459669672,744172,5828,1482,19,0x0352086e5Ce73fc2eC4C41fef56361F7dEF6Ea91,0xE8FB27B448726AA39bdb3322aac31B6a3D583cFA
9379,15627896,55926,10459669672,54982,944,138,72,0x6097004C68F7B350d72226003226Ac089597D579,0x1eadFC7314101EFB69EAfC620D6AB4ED1cf5e267
9380,15627896,55926,10459669672,54982,944,138,120,0x6097004C68F7B350d72226003226Ac089597D579,0x2C5789571A40a5554114bB6548DD9bc69D494b15
9381,15627896,55926,10459669672,54982,944,138,116,0x6097004C68F7B350d72226003226Ac089597D579,0x35328a6bbb43BB53f0838Ec98225C46Bc367087d
9382,15627896,55926,10459669672,54982,944,138,138,0x6097004C68F7B350d72226003226Ac089597D579,0x5010973206B3cA1c2fA12C846D6465FB5efD98BE
9383,15627896,300344,10459669672,298260,2084,522,327,0x7a250d5630B4cF539739dF2C5dAcb4c659F2488D,0xdB9d5D8F4337f6c94acf6fC7ED4d5772EE190d05
9384,15627896,50000,10236951661,50000,0,2,503554,0x2Df6aDF370B2aD9ce0F7833B6F2b9ac50aA47992,0x000F422887eA7d370FF31173FD3B46c8F66A5B1c
9385,15627896,191041,10000000000,190165,876,266,1400,0xd588b586D61C826A0e87919b3D1a239206d58bf2,0xC22d03e13B888Dabb33A1575e4F6542f0e996622
9386,15627896,700000,9959669672,699056,944,138,8533,0x6097004C68F7B350d72226003226Ac089597D579,0xf8EfD62b7f6E397a387a7FB232a54fe8f59C6B2A
9387,15627896,700000,9959669672,699056,944,138,10854,0x6097004C68F7B350d72226003226Ac089597D579,0xb6007a21D1c890742bd9a3A4E2C0CA8Df646b0Be
9388,15627896,305905,9959669672,298905,7000,970,543,0x9b3B6974531d8AA15A87908FFd821A64863Ede5B,0x4075823E2B9b47A53281fafFB10eC9581aAE8296
9389,15627896,100000,9946198598,99332,668,138,1050391,0xf1Dc500FdE233A4055e25e5BbF516372BC4F6871,0xf16E9B0D03470827A95CDfd0Cb8a8A3b46969B91
9390,15627896,228295,9859669672,226471,1824,458,169,0x7a250d5630B4cF539739dF2C5dAcb4c659F2488D,0xDB11551EB2b0F08E337e01E7f0E7d4D82077f5Af
9391,15627896,56659,9859669672,55715,944,138,170,0xAD13C2a8d418d01F3236F4d8b9d724575a4e9d24,0xDB11551EB2b0F08E337e01E7f0E7d4D82077f5Af
9392,15627896,21000,9850000000,21000,0,2,0,0x6dfc34609a05bC22319fA4Cce1d1E2929548c0D7,0x84F746217fc44B55eefab6CB82c6cFE51d53b34C
9393,15627896,21000,9780000000,21000,0,2,1,0x2C18B2b26EFd5e0A062f7925E15Aab1Fc10E58e7,0x66FCdaB8bcd6CA7d86cD15D9f56c1Dc59430324b
9394,15627896,21000,9667662077,21000,0,2,17,0xE0C929D37209866ef3C1C59D39b961758C23eE66,0xd463632A0E8618995fe4c2809856E97d0E52C028
9395,15627896,21000,9661665144,21000,0,2,6271,0xFDe0d1575Ed8E06FBf36256bcdfA1F359281455A,0xFDe0d1575Ed8E06FBf36256bcdfA1F359281455A
9396,15627896,100000,9659669672,99056,944,138,7016,0x6097004C68F7B350d72226003226Ac089597D579,0x8FFdD83b2C1541e661c2437B1887844654E050c9
9397,15627896,100000,9659669672,99056,944,138,4611,0x6097004C68F7B350d72226003226Ac089597D579,0x84Ab6D0401831896Fe2484f5eeeeb944B5BA95DB
9398,15627896,581428,9461483735,577928,3500,546,16447,0xED77777586D73C58EB4D6BEBDF9c85C2d5F56C2d,0x5f0df4aE784dB40B2D5460Aa4415A662527e43Cf
9399,15627896,300000,9460669672,299392,608,138,27208,0xdAC17F958D2ee523a2206206994597C13D831ec7,0xF26f397FEf9f338b7502c6fC42aa18EBD1aF756D
9400,15627896,21000,9460669672,21000,0,2,274873,0xD5cd8f34ed380310F67bB43BC74F64994A6d968A,0x389044F3ac7472060A0618116e3624A5f0f20F28
9401,15627896,21000,9460669672,21000,0,2,261875,0x0f15B7f840ce3f513b4387285Ba2D7d42163224E,0xBBd0D4d067d5aF2065B1B6fD936d93237Ae1c56C
9402,15627896,21000,9460669672,21000,0,2,251065,0x2D552FD645F0D366041ECfe6F4e801D59746f245,0x8216874887415e2650D12D53Ff53516F04a74FD7
9403,15627896,21000,9460669672,21000,0,2,274874,0xa2A985d58da1d1B1bB442D9089663fC7EBd320B1,0x389044F3ac7472060A0618116e3624A5f0f20F28
9404,15627896,42000,9459669672,42000,0,2,329552,0x3720cf2E5420F6ed2907aDDEA62D9A58748D9413,0x9430801EBAf509Ad49202aaBC5F5Bc6fd8A3dAf8
9405,15627896,21000,9459669672,21000,0,2,52382,0x417D11Ac3a6a1BfA5418aB922C7FC8FB82C19301,0x7c195D981AbFdC3DDecd2ca0Fed0958430488e34
9406,15627896,55935,9459669672,54991,944,138,36,0x037A54AaB062628C9Bbae1FDB1583c195585fe41,0xC42542925B540371708e319df9f093D1Ef49eE2f
9407,15627896,21000,9459669672,21000,0,2,2,0x852e8F2d469A464d67Afa38080d93076BA0c0Ed5,0x09F43DA7021532CDD2810AB98B872390E1C82548
9408,15627896,181476,9459669672,179912,1564,394,2444,0x1Fa8559e873f698292766790AeCf8080A66433F6,0xba7933402348A902064499ed883c49843Eeb7019
9409,15627896,272500,9459669672,268884,3616,1162,1281,0x68b3465833fb72A70ecDF485E0e4C7bD8665Fc45,0x0bA16231c8632079f96DF505E35e00D62e214D70
9410,15627896,502948,9459669672,498668,4280,1098,2,0xe66B31678d6C16E9ebf358268a790B763C133750,0xAaA44864499A11B270b93CE078a5D11f7aCa2D95
9411,15627896,37449,9459669672,36829,620,138,3183,0xA0b73E1Ff0B80914AB6fe0444E65848C4C34450b,0xC32C8Ef175a3606966e5Ff4A126Bd84D2C7B972c
9412,15627896,500000,9459669672,498260,1740,458,1262743,0xa24787320ede4CC19D800bf87B41Ab9539c4dA9D,0x89e51fA8CA5D66cd220bAed62ED01e8951aa7c40
9413,15627896,181458,9459669672,179906,1552,394,2449,0x1Fa8559e873f698292766790AeCf8080A66433F6,0x3a6BbD21A6D53cE91f8B4D160894c846326804fF
9414,15627896,318515,9459669672,301431,17084,3978,541,0x1A90B3Dead0113740266b7F7Ea1136e8ED1b48C5,0xab18Dd4e8090dE887E50776d66A9924a648d5759
9415,15627896,500000,9459669672,498328,1672,394,176,0x5b7901b8732fD30544cC0007b5FE1B6b8393fa7B,0x1DEAD1c404B962b8C17DC75c17be402065aB5a12
9416,15627896,39603,9459669672,39351,252,74,192,0xC02aaA39b223FE8D0A0e5C4F27eAD9083C756Cc2,0x2E8Cc0C30E447c5679886E0D2B97aDA74664127D
9417,15627896,21000,9459669672,21000,0,2,2759950,0x68d9B4Fc2eE1606bDf49d85f708B7195d29a0613,0x267be1C1D684F78cb4F6a176C4911b741E4Ffdc0
9418,15627896,238948,9459669672,236164,2784,842,2058,0x68b3465833fb72A70ecDF485E0e4C7bD8665Fc45,0x3461F903D434CCf3684D6f82d9F8833799Da177c
9419,15627896,90000,9459669672,89344,656,138,2414,0x1f9840a85d5aF5bf1D1762F925BDADdC4201F984,0xe401A6A38024d8f5aB88f1B08cad476cCaCA45E8
9420,15627896,149903,9459669672,143327,6576,1802,202,0x00000000006c3852cbEf3e08E8dF289169EdE581,0xF9E229b3323Bd3f87d80fd578b93d91fE0cFf0Ca
9421,15627896,92151,9459669672,92087,64,10,1,0x4Dbd4fc535Ac27206064B68FfCf827b0A60BAB3f,0x7D26C821D92DCe62E3F4c57a191AF42DA3e8088C
9422,15627896,231102,9459669672,225954,5148,1484,6,0x881D40237659C251811CEC9c364ef91dC08D300C,0x5ca22dbA4a6661562E97Cc9C42b63D20147672a5
9423,15627896,219909,9459669672,219209,700,202,25,0x07F76e1ec845c5C54b7BA81f16d8Ac0EB31bd48a,0x2A207956B61AA0eF50a84E9058Eb9bf3793da136
9424,15627896,105910,9459669672,105290,620,138,4,0xB4375E8aaCf0147aDf6B2a296c61Ad6141010c37,0x8Fbbb24Bf54C0Bf2BdD86A79a910e5d33d01F5B5
9425,15627896,56659,9459669672,55715,944,138,868,0x9431DE2DFE10BDB30995bd3791dE03a6c9570054,0xc9BF80eA3918c2fcbf8Fa9e2325241E69A413874
9426,15627896,21000,9459669672,21000,0,2,7100805,0x5DD9B12f6790f06a88ED9D0E3e4218C834F281E8,0xddfAbCdc4D8FfC6d5beaf154f18B778f892A0740
9427,15627896,21000,9330000000,21000,0,2,30,0x6dfc34609a05bC22319fA4Cce1d1E2929548c0D7,0x09c9f73f4CbEF8bB486ba31338D2C942B1a0f8db
9428,15627896,269218,9111169673,269218,0,2,117901,0x26bce6eCb5b10138e4bf14aC0ffcc8727FEF3B2e,0x26bce6eCb5b10138e4bf14aC0ffcc8727FEF3B2e
9429,15627896,144631,9000000000,144427,204,74,6,0x7F9306FC1978938d5C1C57Bf6044dc67E07eeB8a,0x04Ef3980187CFa014b282be0A3cbaC861B2Aea22
9430,15627896,216673,8993161534,215225,1448,402,272,0x1111111254fb6c44bAC0beD2854e76F90643097d,0x85b90a9Aad3EEF15CEA4a57cc8c7a055eF3f3721
9431,15627896,953041,8993161534,927729,25312,8146,539,0x1111111254fb6c44bAC0beD2854e76F90643097d,0xa57C927dF5b836D203560A5B568aF75831939Eed
9432,15627896,69529,8969669672,68921,608,138,310,0xdAC17F958D2ee523a2206206994597C13D831ec7,0x16fEA469A34a8901946B2552550dcAbA9540C11A
9433,15627896,201611,8959669672,195363,6248,1674,1108,0x00000000006c3852cbEf3e08E8dF289169EdE581,0x0b4534c69A278beaEC2CA225aE7F57a89B5DAf9D
9434,15627896,190058,8959669672,184050,6008,1674,928,0x00000000006c3852cbEf3e08E8dF289169EdE581,0x07F4b7f3c85Aa8a3fceb113b7A424aB822ce77a9
9435,15627896,94813,8959669672,94205,608,138,0,0xdAC17F958D2ee523a2206206994597C13D831ec7,0x03FD0659A4f09ac35c18AaB0f30e13C75388A1A6
9436,15627896,120637,8959669672,120573,64,10,19,0xf7db4205032153a81BCB6ed0561c00E65Ac55a06,0x2D8084c08F9Ec0995B20fbC3c32864dE691cd987
9437,15627896,520387,8959669672,517579,2808,842,24,0x68b3465833fb72A70ecDF485E0e4C7bD8665Fc45,0x8001E22B2b3948E8B2cEDCa34e0c1eAF24a7B648
9438,15627896,21000,8959669672,21000,0,2,219,0x3654867406D3618665CB67943a91e352930e8249,0x3faD24D76807eF5c818863891f9E947bad91Bf5f
9439,15627896,21000,8959669672,21000,0,2,649,0x62a3EcEA934B476c58B0B5A23E22f28B26dEa26F,0x1248965D608840EEF68A0f6b745a305d0eCDa75D
9440,15627896,21000,8959669672,21000,0,2,830,0x9aF1647F198D592AeE54D95134Bb4b05a29b7c04,0x3Cd1b9620ACAe5Ab113039E4F916d0bf94158074
9441,15627896,689781,8959669672,686141,3640,1162,343,0x68b3465833fb72A70ecDF485E0e4C7bD8665Fc45,0x40cA6bDc1b3Eb4AD28224Ca4B3811989d7eFbdB9
9442,15627896,179761,8959669672,176217,3544,1162,3,0x68b3465833fb72A70ecDF485E0e4C7bD8665Fc45,0xFac48d5EC2fbF4dDE98341923FD14778F85456F1
9443,15627896,261630,8959669672,255686,5944,1738,211,0x68b3465833fb72A70ecDF485E0e4C7bD8665Fc45,0xF35d1e3D72f52b57ac616EfbCE60cC95e47F3188
9444,15627896,170326,8959669672,163422,6904,1810,38,0x00000000006c3852cbEf3e08E8dF289169EdE581,0x188b9f204BdED52A1333c645aD212D5e6358bAD9
9445,15627896,21000,8959669672,21000,0,2,9,0xAb0065817923a0a19e70De8D85a1D3df2354F3EF,0x6b65456F5Aa434568146Ed7Cf8dF075f82611BE0
9446,15627896,21000,8959669672,21000,0,2,14,0xDd4298c1bbdBDFf6D550329d07736718cf8b94dF,0xd28Ff6DD7d851371162489EC9B031B8DC0949F74
9447,15627896,21000,8959669672,21000,0,2,508,0x1C472542FB9bad7e21C1A8B6fed2Cb2F431028A6,0x0E0e3af1144f0cD4cB5FC208719fe4382f1e17B6
9448,15627896,46663,8959669672,46175,488,138,268,0xd38ea4423086ECBc3080E876AE435ce6544DC553,0x9F6d012d84c9e94D4148c982e3E0ad9554667047
9449,15627896,46255,8959669672,45691,564,74,300,0x283Af0B28c62C092C9727F1Ee09c02CA627EB7F5,0xc4120B8DF72d6A41cD1ed721266c86463B2C978a
9450,15627896,51495,8959669672,50923,572,138,207,0xEfAEd650f1a94801806BB110019d9B0dc79531A8,0xE1782BcBeF30270fbbFa96a11130eE5dd5422a88
9451,15627896,429489,8959669672,429261,228,74,70,0x6c3810649c140d2f43Ec4D88B2f733e1375E4C74,0x06926D6F3812E34890f37ABDcE0A10a80af46f39
9452,15627896,21000,8959669672,21000,0,2,190,0x34dc02f936dbaC056e01f3fAb59ed82B3567D7E2,0xb7a1A757B44f5F4d61d3C160A0B400fc5A545f99
9453,15627896,77655,8959669672,67887,9768,1418,10,0xa2c14852974afE7755eA824260Ca5dF03B816458,0x393684f8b5082C8168bD49a1231E9222C116BBEB
9454,15627896,21000,8959669672,21000,0,2,5,0x261b82C35233aD844dc109F4F9912c055C56C3FF,0x878380eeB5Edf2BAC8EbAd3C2CC4A5a4e3f90C88
9455,15627896,46103,8959669672,45615,488,138,1377,0x346378C67d0F71343F80299ed8C0407aC2Df05eB,0xa59C963ad0FB3e3544DC902f5C72ce4b38c7F7fb
9456,15627896,21000,8959669672,21000,0,2,10,0x1232A18C318E5b33af9933edD81BB7BC8e6A1838,0x80eD3D73D530f570709c88E43E30F37b8d02045F
9457,15627896,21000,8959669672,21000,0,2,203,0x8C662f325Ea7a6B51340c47298126Ecd2e485F01,0xAD0bc71Da62040A4204bbbB0D83c4F4DCE5c8B03
9458,15627896,147775,8959669672,145927,1848,458,5,0x03f7724180AA6b939894B5Ca4314783B0b36b329,0x57592d6066a82625cf91ee4881F55D27Ddc0Fe9A
9459,15627896,1281975,8959669672,1263315,18660,3338,522,0x23E79722Bb8B55a0d04f3AFbCFC34eb771526Adb,0x13c7EE16Ebd8a2f34dF4D24af490Cb35c2E726f8
9460,15627896,241602,8959669672,236662,4940,714,127,0x000000000000509081d6FCD3ee63e791aD1db763,0xe4DF1262d69b02CE385745e1ead6f348fD4c6d88
9461,15627896,392244,8959669672,390668,1576,394,2,0x7a250d5630B4cF539739dF2C5dAcb4c659F2488D,0xDa7AB0C15b74327EF904919bD075aC503C4fF905
9462,15627896,21000,8959669672,21000,0,2,70,0x13A2a74759837f56c28F90b9F45b168Fd074be6a,0x133Ff22DBd0f4dd33430CB3a2fBE8dfFf026E986
9463,15627896,46157,8959669672,45669,488,138,1,0xEb4e856F69158052aC0AaF7Dc26f63DCb1ee067F,0xf0127a33AD1809f60DA2b251E383446e7AC7EeDb
9464,15627896,21000,8959669672,21000,0,2,27,0x3D7262FD87aAe02A3CD659a27Fa3e41111Edd419,0x8ee043cabfd9375041A61e4Ad6253b4C70caC7b1
9465,15627896,429489,8959669672,429261,228,74,71,0x6c3810649c140d2f43Ec4D88B2f733e1375E4C74,0x06926D6F3812E34890f37ABDcE0A10a80af46f39
9466,15627896,94463,8959669672,94031,432,74,215,0xA0c68C638235ee32657e8f720a23ceC1bFc77C77,0x93D56eD4Dd2E9F3f914b06E9aA9DD18bac07c6bc
9467,15627896,181476,8959669672,179912,1564,394,1161,0x1Fa8559e873f698292766790AeCf8080A66433F6,0x97F05bD0E0b0E7Af776ABbAbc01CfD8601Ca93C1
9468,15627896,21000,8959669672,21000,0,2,3,0xF83aa7596C2c0eD33Ee2022f9DCE38F5B724BA44,0x7A0DD67577D580d15271970E2C909c6f14294837
9469,15627896,21000,8959669672,21000,0,2,525,0xa1f0F2D744C1E4447618394B519C1E03F6AFA799,0x20aBC8fDeB737c921a20dB6dd7a8e9672747a490
9470,15627896,278821,8959669672,278617,204,74,477,0x55f1C36Bb7aE0d7D6caE97902E30A2306686Ec73,0x36151eF8bF252eB963235fd76245B98580D595F0
9471,15627896,93234,8959669672,93170,64,10,1773,0xD057B63f5E69CF1B929b356b579Cba08D7688048,0x07c2af75788814BA7e5225b2F5c951eD161cB589
9472,15627896,222775,8959669672,222571,204,74,82,0xa404F66B9278c4aB8428225014266B4B239bcdc7,0x727b6DB9f66a43A314fAE0Bd5944C5c330b264Ea
9473,15627896,46612,8959669672,46124,488,138,801,0x2160dcdb088196E7e5fAf12c2346456D933DB34E,0x0a5C6E05CEAA5E9C91C13bD9d8bf23ac8bd4B2D6
9474,15627896,21000,8959669672,21000,0,2,152,0xC40A021cc795cb2dF4a108f9769B8ffD84730A83,0x3a548339a9cD1ce58DCcbdc317131cB193aECb77
9475,15627896,122512,8959669672,121264,1248,458,405,0x4e32004D8b81847A670b4a1778ACe4dCF2bBA01E,0x399cC15527d172741476bDaCfBb4199898A50c7d
9476,15627896,79564,8959669672,79172,392,138,35,0x2b591e99afE9f32eAA6214f7B7629768c40Eeb39,0xCd20418Fc29288Ff61eEC92bfe49Ef8A655Db373
9477,15627896,21000,8959669672,21000,0,2,0,0xe97d5419C74DB944B9307393dbC535372ae99026,0x007a298e8053c862Bd4b069DF148946b5314475A
9478,15627896,21000,8959669672,21000,0,2,95,0xa914e25784885DcbA88eB4ad5478Da0c8EaC41BC,0x3FB0Be5316a579c477E24B2a276f1c103BA6Cce8
9479,15627896,144919,8959669672,143979,940,202,140,0xa1B91e06392777F6157da163CcEBB110a33145d1,0x9C0a187Ace0062b232Cc586d9152b934068a8228
9480,15627896,46125,8959669672,45637,488,138,97,0x21374D22F169849cFD680241F3f37cD61AC2eea5,0x7deb0836e4D0B267d1C49Ef2e87d438d1888c523
9481,15627896,238934,8959669672,236162,2772,842,74,0x68b3465833fb72A70ecDF485E0e4C7bD8665Fc45,0x5e52EBD5763465d808984E428e599D7e7876e91A
9482,15627896,46747,8959669672,46175,572,138,24,0x71012ccB475bFD17E7c0ea10AB8036974dA9FC85,0x9686b6A96083b7Ed7cef93319B05c96D4D0cf0d9
9483,15627896,73170,8959669672,72574,596,138,489,0xA0b86991c6218b36c1d19D4a2e9Eb0cE3606eB48,0x2EceCf5a33d038694133BbF3A22AEAFBc96d4B04
9484,15627896,195760,8959669672,193060,2700,842,993,0x68b3465833fb72A70ecDF485E0e4C7bD8665Fc45,0x0E20DE7B8a72f6AFF5823dE0e695C38186d7C701
9485,15627896,248900,8959669672,246140,2760,842,14,0x68b3465833fb72A70ecDF485E0e4C7bD8665Fc45,0x4bC32c75f4DE5AFD4098cd0AA394AD4cD4996dfc
9486,15627896,46255,8959669672,45691,564,74,46,0x283Af0B28c62C092C9727F1Ee09c02CA627EB7F5,0x80626F32C252EB332C1963F21836969f6c03629E
9487,15627896,46255,8959669672,45691,564,74,26,0x283Af0B28c62C092C9727F1Ee09c02CA627EB7F5,0x375613Dd7A028aFb7D865FF5f015b5A62474171b
9488,15627896,127890,8959669672,127262,628,202,3,0x084b1c3C81545d370f3634392De611CaaBFf8148,0x5B072e124297e7C5e39575174c609220b230CEd8
9489,15627896,66386,8959669672,65446,940,202,14,0xd16809C0a7d82C9E7552a01Fd608fFF90EFb564f,0x2A68b9b461ff3E1962676A6F4B592b002B582573
9490,15627896,56659,8959669672,55715,944,138,797,0xAD13C2a8d418d01F3236F4d8b9d724575a4e9d24,0x6953Ba87386bD829F800C533D73264BFA5d43D6D
9491,15627896,54580,8959669672,53892,688,202,312,0x084b1c3C81545d370f3634392De611CaaBFf8148,0xf4810E5445d4D49a985846DeC2a3E9214949AfbC
9492,15627896,46267,8959669672,45691,576,74,297,0x283Af0B28c62C092C9727F1Ee09c02CA627EB7F5,0xBd3aE808d527a8d17531274A4a604eEd708f73Dd
9493,15627896,59954,8959669672,52558,7396,2122,178,0x00000000006c3852cbEf3e08E8dF289169EdE581,0x10b3b8075558B4c8f41c76FDA2C4dcA146Ba137a
9494,15627896,384580,8959669672,361224,23356,8146,1389,0x00000000006c3852cbEf3e08E8dF289169EdE581,0xa83a74C209DdF22483C13B0c7E8caFa49EdCE501
9495,15627896,148298,8959669672,142214,6084,1682,6,0x00000000006c3852cbEf3e08E8dF289169EdE581,0x977551e712E99105fD16c1B9115717aa6961eA43
9496,15627896,46119,8959669672,45631,488,138,101,0xB852c6b5892256C264Cc2C888eA462189154D8d7,0x8E623f3eaA36ED755865CEadEF5a06b761CC16F2
9497,15627896,21000,8959669672,21000,0,2,7,0x855Fe2303AC1B3A3EC9A06c7f1b8f62B47fCF2E7,0xb9B484F5F9D8a67b60E3Baf4be441Bb6a7c2e025
9498,15627896,8000000,8950768267,7999936,64,10,15107,0x88266E58a66cB5b1880814F6BFe5E12b68832B9D,0xb2AA4a5DF3641D42e72D7F07a40292794dfD07a0
9499,15627896,48897,8950768267,47953,944,138,0,0xdAC17F958D2ee523a2206206994597C13D831ec7,0xdE954D957dA555a276D21A5Ea22f4eE29F290b3B
9500,15627896,247388,8559670672,242068,5320,1612,2,0x881D40237659C251811CEC9c364ef91dC08D300C,0x4aFbA42b2Ad424c8492E67EA915CbF77Ab38ac98
9501,15627896,284418,8790673302,278622,5796,1676,228,0x881D40237659C251811CEC9c364ef91dC08D300C,0xC4B0dc090E87345151D1E486B5b8eb49aE4fFF2F
9502,15627896,65000,8540473389,64404,596,138,646175,0xdAC17F958D2ee523a2206206994597C13D831ec7,0x29D5527CaA78f1946a409FA6aCaf14A0a4A0274b
9503,15627896,294032,7459669672,287272,6760,1930,203,0x00De00c2009EEB00dFf874E969000000E9001B38,0x5e6a2ff745863BD5500130387ebcc9E0531b93b0
9504,15627896,181458,8459669672,179906,1552,394,764,0x1Fa8559e873f698292766790AeCf8080A66433F6,0xD5792f2C0a161225a500fE80Ec6707DaC4739B47
9505,15627896,55861,8459669672,54917,944,138,0,0x95aD61b0a150d79219dCF64E1E6Cc01f0B64C4cE,0xD604fE2Dc2D5f3A400F72f5EEb5d7429665B23cA
9506,15627896,181476,8459669672,179912,1564,394,318,0x1Fa8559e873f698292766790AeCf8080A66433F6,0x337F4D863564C0C82BF45EEc9B1A4286Ba683811
9507,15627896,181476,8459669672,179912,1564,394,798,0x1Fa8559e873f698292766790AeCf8080A66433F6,0x4A608698FdC658A8e329658835365ce1Ebd33F52
9508,15627896,181476,8459669672,179912,1564,394,21,0x1Fa8559e873f698292766790AeCf8080A66433F6,0x315151C29B84170e4Dd816D63d127Cbb2Daf8CD4
9509,15627896,100000,8459669672,99056,944,138,7997,0x6097004C68F7B350d72226003226Ac089597D579,0x11191bcfe30c6aE7bBEF74c6De97c8D52FF957F9
9510,15627896,122446,8459669672,120882,1564,394,488,0x1Fa8559e873f698292766790AeCf8080A66433F6,0xF7f5090cf84771bE616d738fefC5092F33f87B74
9511,15627896,181476,8459669672,179912,1564,394,1258,0x1Fa8559e873f698292766790AeCf8080A66433F6,0x7a44a31423A2eb681d9f5cCD918Acb0879578901
9512,15627896,181476,8459669672,179912,1564,394,575,0x1Fa8559e873f698292766790AeCf8080A66433F6,0x7858c16d980B942Ef5d74F49ce19EA5c556c6b70
9513,15627896,263527,8459669672,261619,1908,458,16,0x7a250d5630B4cF539739dF2C5dAcb4c659F2488D,0x0cB5B5C356FcE965b26683E0B3854a6f098108aC
9514,15627896,113310,8459669672,113106,204,74,372,0x5D004ddB5D92938dAF8448b9eac1CaA593cd26Ca,0x26DC5D39Bd7A8bc2d792dcAAAC55FE6DCef25593
9515,15627896,181476,8459669672,179912,1564,394,782,0x1Fa8559e873f698292766790AeCf8080A66433F6,0x4018F4A2253b69599d9d2fbA58eb94234844e316
9516,15627896,239008,8459669672,235744,3264,1034,46,0x68b3465833fb72A70ecDF485E0e4C7bD8665Fc45,0xd50621a46607532Ea7ed6Aa944b05672a1044549
9517,15627896,87234,8459669672,87170,64,10,72,0xb55e1442EDA37d31249f97b3fCA6DEF588346FeF,0x7f87Bf3a90d6bA5314404327bb3cA18EFdd17f28
9518,15627896,210885,8459669672,209709,1176,338,23,0x1111111254fb6c44bAC0beD2854e76F90643097d,0x682F2f677A5e0Af1b6b3f2565808943266306bAC
9519,15627896,113310,8459669672,113106,204,74,373,0x5D004ddB5D92938dAF8448b9eac1CaA593cd26Ca,0x26DC5D39Bd7A8bc2d792dcAAAC55FE6DCef25593
9520,15627896,181476,8459669672,179912,1564,394,37,0x1Fa8559e873f698292766790AeCf8080A66433F6,0x0980C672196660DFC77959a6A99ddbD857274F2a
9521,15627896,113310,8459669672,113106,204,74,374,0x5D004ddB5D92938dAF8448b9eac1CaA593cd26Ca,0x26DC5D39Bd7A8bc2d792dcAAAC55FE6DCef25593
9522,15627896,181476,8459669672,179912,1564,394,64,0x1Fa8559e873f698292766790AeCf8080A66433F6,0xc33cdf065235173011a583399D60a29B96270125
9523,15627896,181458,8459669672,179906,1552,394,574,0x1Fa8559e873f698292766790AeCf8080A66433F6,0x17f9fd48fcEBb2DF94B78652f2f3B4A8998c6757
9524,15627896,181476,8459669672,179912,1564,394,103,0x1Fa8559e873f698292766790AeCf8080A66433F6,0xb3522C52FFf4d3721671CE515Df51f3Ce6CC494A
9525,15627896,181476,8459669672,179912,1564,394,5,0x1Fa8559e873f698292766790AeCf8080A66433F6,0xCED113daD6a4E737FFFABc16fC3328a945aD46c6
9526,15627896,56659,8459669672,55715,944,138,38,0x12b6893cE26Ea6341919FE289212ef77e51688c8,0xCcFF09E3bfF2be98f001D18D4Ed73cefafECb089
9527,15627896,181476,8459669672,179912,1564,394,141,0x1Fa8559e873f698292766790AeCf8080A66433F6,0x99899e4F5d32f7F0c5d68966dE7c73EfD497123A
9528,15627896,181476,8459669672,179912,1564,394,389,0x1Fa8559e873f698292766790AeCf8080A66433F6,0xE0579fd142e3039aE3FEc3370C58F5AD6D81A128
9529,15627896,181476,8459669672,179912,1564,394,18,0x1Fa8559e873f698292766790AeCf8080A66433F6,0xaf21eE3DA9857D7E9Ec09E109542408dBf7077e2
9530,15627896,113310,8459669672,113106,204,74,375,0x5D004ddB5D92938dAF8448b9eac1CaA593cd26Ca,0x26DC5D39Bd7A8bc2d792dcAAAC55FE6DCef25593
9531,15627896,181476,8459669672,179912,1564,394,8,0x1Fa8559e873f698292766790AeCf8080A66433F6,0x84E210b896B982A6C6cCD6775F3F3328b8178AeE
9532,15627896,181476,8459669672,179912,1564,394,300,0x1Fa8559e873f698292766790AeCf8080A66433F6,0x8F5D478647f5B7Ef9C18a9A0186E7B3af50d89D7
9533,15627896,181476,8459669672,179912,1564,394,329,0x1Fa8559e873f698292766790AeCf8080A66433F6,0xC3D4a2D7caE22e33076B36421d2A2e7edB2e0759
9534,15627896,181476,8459669672,179912,1564,394,283,0x1Fa8559e873f698292766790AeCf8080A66433F6,0x47b1530d7B308Ef8eAdD6EC5A5407F13794af394
9535,15627896,113310,8459669672,113106,204,74,376,0x5D004ddB5D92938dAF8448b9eac1CaA593cd26Ca,0x26DC5D39Bd7A8bc2d792dcAAAC55FE6DCef25593
9536,15627896,181458,8459669672,179906,1552,394,326,0x1Fa8559e873f698292766790AeCf8080A66433F6,0xd8Cbc4b575078620418379Cb77530FEa699A4Fbd
9537,15627896,181476,8459669672,179912,1564,394,404,0x1Fa8559e873f698292766790AeCf8080A66433F6,0x459b02518bd0C6C9a402C850CFf7B56CF4d76111
9538,15627896,175110,8459669672,173546,1564,394,2135,0x1Fa8559e873f698292766790AeCf8080A66433F6,0x34Ff7D54E31D0b31Fe1f0263D4a4d7dB39a849DC
9539,15627896,1000000,8459669672,997988,2012,522,6336,0xE592427A0AEce92De3Edee1F18E0157C05861564,0x329aFA43F8c89F65Fb6b22397c1A098EA4210D7E
9540,15627896,181458,8459669672,179906,1552,394,132,0x1Fa8559e873f698292766790AeCf8080A66433F6,0x9e7Ab7F8e04916B48fB86C9CdE15C54E7DAF1a26
9541,15627896,113310,8459669672,113106,204,74,377,0x5D004ddB5D92938dAF8448b9eac1CaA593cd26Ca,0x26DC5D39Bd7A8bc2d792dcAAAC55FE6DCef25593
9542,15627896,181476,8459669672,179912,1564,394,178,0x1Fa8559e873f698292766790AeCf8080A66433F6,0xdc7DC88971E6f9e46421FCb60Cd7515ab5c1ba7D
9543,15627896,181476,8459669672,179912,1564,394,286,0x1Fa8559e873f698292766790AeCf8080A66433F6,0x407060a47fB14bA0ABd40A657Ab9260588619489
9544,15627896,304724,8459669672,303316,1408,394,866,0x99C9fc46f92E8a1c0deC1b1747d010903E884bE1,0xA5D62640081d2a1bc5deD398F2AA5aC6e463746b
9545,15627896,181476,8459669672,179912,1564,394,337,0x1Fa8559e873f698292766790AeCf8080A66433F6,0x6288cf9185efB87a0843C5c9029393802b614784
9546,15627896,113310,8459669672,113106,204,74,378,0x5D004ddB5D92938dAF8448b9eac1CaA593cd26Ca,0x26DC5D39Bd7A8bc2d792dcAAAC55FE6DCef25593
9547,15627896,181476,8459669672,179912,1564,394,2933,0x1Fa8559e873f698292766790AeCf8080A66433F6,0xFf9911abdBe9d1f7D1A19595B93905C2a9aD60f4
9548,15627896,113310,8459669672,113106,204,74,379,0x5D004ddB5D92938dAF8448b9eac1CaA593cd26Ca,0x26DC5D39Bd7A8bc2d792dcAAAC55FE6DCef25593
9549,15627896,120000,8459669672,119392,608,138,18761,0xdAC17F958D2ee523a2206206994597C13D831ec7,0xfB8131c260749c7835a08ccBdb64728De432858E
9550,15627896,181458,8459669672,179906,1552,394,108,0x1Fa8559e873f698292766790AeCf8080A66433F6,0x5eE25c4F452B50eE80F14f42e3F41ac5dA7Df3E8
9551,15627896,94795,8324697897,94199,596,138,2,0xdAC17F958D2ee523a2206206994597C13D831ec7,0x6bCa06a6876e7F54EEC143Cf8776022a6c984b2b
9552,15627896,67590,8305664243,66646,944,138,372,0x030bA81f1c18d280636F32af80b9AAd02Cf0854e,0x907206D1Fb31AeB9E36Fdc98CE09F5B088bE56bF
9553,15627896,21000,8268307111,21000,0,2,95240,0xb318F8061dc0C1739232f80788FCA2d2a00fdC14,0x8EB871bbB6F754a04bCa23881A7D25A30aAD3f23
9554,15627896,181476,8223051731,179912,1564,394,487,0x1Fa8559e873f698292766790AeCf8080A66433F6,0x25043fA1dF1e76871CBc9132295A043160AeFF52
9555,15627896,181476,8000000000,179912,1564,394,1196,0x1Fa8559e873f698292766790AeCf8080A66433F6,0xeBe1125c2Bb2676C157A0948AF88b9af17f9bAbE
9556,15627896,222222,8000000000,220658,1564,394,121,0x1Fa8559e873f698292766790AeCf8080A66433F6,0x857F7f08fA652381Fc6b77d551C0D7022F3bc9E6
9557,15627896,241400,7459669672,239240,2160,650,119382,0xA69babEF1cA67A37Ffaf7a485DfFF3382056e78C,0x0cac3d1a887206e0f6169222C4504301A8b4b993
9558,15627896,90000,7695591497,90000,0,2,154376,0x5c1a712f0fC824958124d69E2a16D2048Ac60678,0xCBD6832Ebc203e49E2B771897067fce3c58575ac
9559,15627896,90000,7695591497,90000,0,2,154377,0xa0D30fcC63EA8370aD29be0a2f6e85b69d7CA214,0xCBD6832Ebc203e49E2B771897067fce3c58575ac
9560,15627896,200000,7541586068,199404,596,138,1973,0xA0b86991c6218b36c1d19D4a2e9Eb0cE3606eB48,0x1F144ac496BB5e3DDdcc9a5fa5A98B43749722C4
9561,15627896,46267,7541586068,45691,576,74,593,0x283Af0B28c62C092C9727F1Ee09c02CA627EB7F5,0xc000F1c46f62872BaAB948eC6E8593c73C1C41D7
9562,15627896,26000,7459669672,26000,0,2,12031,0x5e517c3820430abe2F78B4c47298d90C80bAFcFf,0xDAFEA492D9c6733ae3d56b7Ed1ADB60692c98Bc5
9563,15627897,304695,57931982387,302835,1860,458,1054,0x7a250d5630B4cF539739dF2C5dAcb4c659F2488D,0xA1CC352bC94caDdFddaA4D095762F37B2b9bc57A
9564,15627897,254127,37931982387,252375,1752,458,16,0x7a250d5630B4cF539739dF2C5dAcb4c659F2488D,0xfD8d921494B5fB3d26c65382552A09F8FA32BE24
9565,15627897,254109,37931982387,252369,1740,458,17,0x7a250d5630B4cF539739dF2C5dAcb4c659F2488D,0x26009ff057450897BBe7eF1c3a9115c2d2C47ff4
9566,15627897,21000,15400000000,21000,0,2,1,0x500A746c9a44f68Fe6AA86a92e7B3AF4F322Ae66,0x565AAc4C7dd25c5692237183dE1E7F6ac9B83CCE
9567,15627897,21000,14000000000,21000,0,2,7,0x500A746c9a44f68Fe6AA86a92e7B3AF4F322Ae66,0x410582aDbC98D2Eff31B3510c484276473c172E9
9568,15627897,21000,14000000000,21000,0,2,2,0x500A746c9a44f68Fe6AA86a92e7B3AF4F322Ae66,0x9EC043564b15Afa3ffF59b55924d9D80d55F9780
9569,15627897,751291,13052000000,736435,14856,4682,0,0x3b3ae790Df4F312e745D270119c6052904FB6790,0xa444DA422D8382A19761Dc10b15A11EDc6D5cAF3
9570,15627897,650937,12931982387,647333,3604,1162,566,0x68b3465833fb72A70ecDF485E0e4C7bD8665Fc45,0x4207b21744413D37831833184559D46c49063656
9571,15627897,294306,12931982387,292470,1836,458,155,0x7a250d5630B4cF539739dF2C5dAcb4c659F2488D,0x5c7bfC47a62beB16f11c3881D437c59B0d08b84C
9572,15627897,63000,11690197262,63000,0,2,2710063,0x72A2ADFcCB81873d31033316d1545F4D00c7830d,0xC098B2a3Aa256D2140208C3de6543aAEf5cd3A94
9573,15627897,181476,10931982387,179912,1564,394,168,0x1Fa8559e873f698292766790AeCf8080A66433F6,0x8c0EF28D17c1D7d73C5C6e1A55c2199b1D2445D5
9574,15627897,96229,10931982387,94977,1252,394,57,0x710515Bf543fDb6834144F9269BBf0D1d32B1702,0x25ceE3a836286d1D9188e54bc563E5C74BE984A9
9575,15627897,172350,10431982387,171922,428,138,219,0x28c6ea3F9cF9bC1a07A828fce1e7783261691B49,0x158DF9e0dF873286B1233CbA5F4965044cb779C8
9576,15627897,120432,10431982387,120228,204,74,2404,0x5D004ddB5D92938dAF8448b9eac1CaA593cd26Ca,0x74456CF397975601D7924Ee113BdA64F9024EFaB
9577,15627897,150756,10431982387,150692,64,10,7,0x65c2e54a4c75ff6da7b6B32369c1677250075fb2,0xcbFd68eA71cf9af23933964F33b11654a7eBa6ed
9578,15627897,389893,10331982387,387845,2048,522,320,0x7a250d5630B4cF539739dF2C5dAcb4c659F2488D,0x096bF23C777c4DD6a20D6dE0bBF5C89C111A8Ef2
9579,15627897,42001,9620027188,41345,656,138,6,0x514910771AF9Ca656af840dff83E8264EcF986CA,0x118A15552139346412eC765B20eeD843ce22822A
9580,15627897,21000,9620000000,21000,0,2,0,0x6dfc34609a05bC22319fA4Cce1d1E2929548c0D7,0xaD37fbd4Ecd9B92d366aC2f0D6825A442ac164d6
9581,15627897,21000,9620000000,21000,0,2,705891,0x26135faA3bf04F947d7d2C0ee5F5967b2b0b8253,0x6dfc34609a05bC22319fA4Cce1d1E2929548c0D7
9582,15627897,21000,9620000000,21000,0,2,705892,0x8501eC17F81fc3C38FB6c80f8bBc6e3A0bE85383,0x6dfc34609a05bC22319fA4Cce1d1E2929548c0D7
9583,15627897,21000,9932982387,21000,0,2,274875,0x8E8eda7DD6B3E1ecfa01adBb46FE75E94a533fd5,0x389044F3ac7472060A0618116e3624A5f0f20F28
9584,15627897,120000,9932982387,119380,620,138,79,0xdAC17F958D2ee523a2206206994597C13D831ec7,0xd0d0DBB33ca627e327a4B80aB85e1113D40f20C9
9585,15627897,140088,9931982387,138524,1564,394,4,0x1Fa8559e873f698292766790AeCf8080A66433F6,0x5AdcA636bd61989482dfDa33adb26450099f9f73
9586,15627897,140088,9931982387,138524,1564,394,7,0x1Fa8559e873f698292766790AeCf8080A66433F6,0xBc23D07BB110C978178a833446BBDc090E2AB68f
9587,15627897,140088,9931982387,138524,1564,394,4,0x1Fa8559e873f698292766790AeCf8080A66433F6,0xdfB51E335D778903bF82Ac3C96c02EE0Fcb250AC
9588,15627897,140088,9931982387,138524,1564,394,7,0x1Fa8559e873f698292766790AeCf8080A66433F6,0xb685c6ae4d23Bed43b734d8d11ed0D6634EC4513
9589,15627897,140088,9931982387,138524,1564,394,7,0x1Fa8559e873f698292766790AeCf8080A66433F6,0xC16453f790153f0965bd058083d68807fEf3c39d
9590,15627897,140088,9931982387,138524,1564,394,7,0x1Fa8559e873f698292766790AeCf8080A66433F6,0x681baE3d6cF9592aC668f06c5f0db08E4C296988
9591,15627897,140088,9931982387,138524,1564,394,7,0x1Fa8559e873f698292766790AeCf8080A66433F6,0x5d6B25Fd40aC8Ba20e59d5BfD8c40872aa5796FF
9592,15627897,140088,9931982387,138524,1564,394,7,0x1Fa8559e873f698292766790AeCf8080A66433F6,0x426822138Fd6F37684f4ac787673E4fe349235Cf
9593,15627897,140073,9931982387,138521,1552,394,7,0x1Fa8559e873f698292766790AeCf8080A66433F6,0x5100c1138f387376F18452D471d2094A69688Fd3
9594,15627897,140088,9931982387,138524,1564,394,7,0x1Fa8559e873f698292766790AeCf8080A66433F6,0x0E4c54c16E871C01A27A58b9F6787ba6797b319a
9595,15627897,140073,9931982387,138521,1552,394,4,0x1Fa8559e873f698292766790AeCf8080A66433F6,0x3767Ca010DcAF7fea70C38ff0D9C07a29eEFe0Da
9596,15627897,140088,9931982387,138524,1564,394,7,0x1Fa8559e873f698292766790AeCf8080A66433F6,0x8ed3Ca3775a2BA18e4A744B2f204b7FA7480dFAc
9597,15627897,181476,9931982387,179912,1564,394,2054,0x1Fa8559e873f698292766790AeCf8080A66433F6,0x508B610a51bed4F2C8fF98CfD820271DA7AC231A
9598,15627897,181476,9931982387,179912,1564,394,0,0x1Fa8559e873f698292766790AeCf8080A66433F6,0xE15b96AD34780dE68c6A44B3477A4966fBe2F82b
9599,15627897,181476,9931982387,179912,1564,394,4657,0x1Fa8559e873f698292766790AeCf8080A66433F6,0xEB156cAA9f0A48300F953b924f4632f39CC929C6
9600,15627897,140088,9931982387,138524,1564,394,3,0x1Fa8559e873f698292766790AeCf8080A66433F6,0xADd7AC52e9fcFf671d86C02D066Fa9a761Ec86D0
9601,15627897,140088,9931982387,138524,1564,394,15,0x1Fa8559e873f698292766790AeCf8080A66433F6,0x93F2d77926711Ce36e4c1ea414C9E77157F29429
9602,15627897,140088,9931982387,138524,1564,394,7,0x1Fa8559e873f698292766790AeCf8080A66433F6,0x2203B698f05Db0393340C14215AEe2C82c2536F3
9603,15627897,140088,9931982387,138524,1564,394,6,0x1Fa8559e873f698292766790AeCf8080A66433F6,0xAb82CDa903D3c5bdA6F4EB30F6e73ded54fB84f0
9604,15627897,140073,9931982387,138521,1552,394,7,0x1Fa8559e873f698292766790AeCf8080A66433F6,0x1E4b545c7577A3D9330feAE03a84005310e66A3f
9605,15627897,140088,9931982387,138524,1564,394,17,0x1Fa8559e873f698292766790AeCf8080A66433F6,0xa38BFb1EAdfb624903De5dBBae4bbFEADf8f734c
9606,15627897,140088,9931982387,138524,1564,394,17,0x1Fa8559e873f698292766790AeCf8080A66433F6,0x673Ca58469378C3f2c8f0e987B2b915dE3b26e4F
9607,15627897,140088,9931982387,138524,1564,394,7,0x1Fa8559e873f698292766790AeCf8080A66433F6,0x6d5b4Ef60366dbeab4B992ceE27FDf0A234a77C4
9608,15627897,140073,9931982387,138521,1552,394,4,0x1Fa8559e873f698292766790AeCf8080A66433F6,0x7Cb54d144d048700DDc06aBB2A8B3b0d765c55F4
9609,15627897,140073,9931982387,138521,1552,394,7,0x1Fa8559e873f698292766790AeCf8080A66433F6,0xaE7f72Fd7f17104e6fc240a970203A039a310b9A
9610,15627897,140088,9931982387,138524,1564,394,7,0x1Fa8559e873f698292766790AeCf8080A66433F6,0x2165A10bC68884888570E47DBB7AFfcd88309378
9611,15627897,140088,9931982387,138524,1564,394,17,0x1Fa8559e873f698292766790AeCf8080A66433F6,0xBCf5dCD5dEc5151b3db1C6E756f0eF051385CbbF
9612,15627897,207128,9931982387,207128,0,2,1679537,0x80A29115627fa0D514A9664CC2205d92bD77365A,0x4976A4A02f38326660D17bf34b431dC6e2eb2327
9613,15627897,140088,9931982387,138524,1564,394,14,0x1Fa8559e873f698292766790AeCf8080A66433F6,0xFd2f50EadDE8687c6a8C1F48A66840B47dB71291
9614,15627897,140088,9931982387,138524,1564,394,7,0x1Fa8559e873f698292766790AeCf8080A66433F6,0xc66c70E7F906c41d5f6F79Ce699eaF8E1d471597
9615,15627897,140088,9931982387,138524,1564,394,6,0x1Fa8559e873f698292766790AeCf8080A66433F6,0xEE1C0aC9Eb324b8eEbdF1368A0c5Cd2d39f5e961
9616,15627897,140088,9931982387,138524,1564,394,3,0x1Fa8559e873f698292766790AeCf8080A66433F6,0x59964DC8Ae088CB923C90488A44955D8c983d859
9617,15627897,140088,9931982387,138524,1564,394,16,0x1Fa8559e873f698292766790AeCf8080A66433F6,0x2F7744c59C49f9B7020D241FeECf6C9610e44968
9618,15627897,140088,9931982387,138524,1564,394,3,0x1Fa8559e873f698292766790AeCf8080A66433F6,0x2eA588689a755Ccc10bCD1AC426E6bacab6ba659
9619,15627897,140073,9931982387,138521,1552,394,3,0x1Fa8559e873f698292766790AeCf8080A66433F6,0xd048bE26122f412B98e806A600cDC2E6d81E6a66
9620,15627897,140088,9931982387,138524,1564,394,6,0x1Fa8559e873f698292766790AeCf8080A66433F6,0x599221674B31f6149777920986280E7218911bd8
9621,15627897,140088,9931982387,138524,1564,394,6,0x1Fa8559e873f698292766790AeCf8080A66433F6,0x911865Bc7CC3f7969aDB04a5FD62903Afc9Ff07D
9622,15627897,140088,9931982387,138524,1564,394,3,0x1Fa8559e873f698292766790AeCf8080A66433F6,0xA9fAD6C95ae3A7095FB3D2B2AcD6660C9d5FbE24
9623,15627897,140088,9931982387,138524,1564,394,6,0x1Fa8559e873f698292766790AeCf8080A66433F6,0xbb4bFbDB3bF4D1952C5CD09b62BE263e91200350
9624,15627897,140088,9931982387,138524,1564,394,7,0x1Fa8559e873f698292766790AeCf8080A66433F6,0xD8d0Dd3A2720D0b68E8e337eAA61e3bbF1F616d1
9625,15627897,207128,9931982387,207128,0,2,4232350,0x007d172F80c5B5909D9C7728b41465c9d9Ec6423,0xDFd5293D8e347dFe59E90eFd55b2956a1343963d
9626,15627897,207128,9931982387,206472,656,138,4232351,0x4d224452801ACEd8B2F0aebE155379bb5D594381,0xDFd5293D8e347dFe59E90eFd55b2956a1343963d
9627,15627897,42000,9931982387,42000,0,2,329553,0x0ECB4742668Ee6bC2568Cf5EB8EA4d1A15840ec0,0x9430801EBAf509Ad49202aaBC5F5Bc6fd8A3dAf8
9628,15627897,207128,9931982387,206532,596,138,4468965,0xdAC17F958D2ee523a2206206994597C13D831ec7,0x21a31Ee1afC51d94C2eFcCAa2092aD1028285549
9629,15627897,207128,9931982387,206460,668,138,4468966,0x4E15361FD6b4BB609Fa63C81A2be19d873717870,0x21a31Ee1afC51d94C2eFcCAa2092aD1028285549
9630,15627897,207128,9931982387,206532,596,138,3199184,0xdAC17F958D2ee523a2206206994597C13D831ec7,0x9696f59E4d72E237BE84fFD425DCaD154Bf96976
9631,15627897,207128,9931982387,207128,0,2,4708714,0x8A380C5691A4FD38935A32949fAdb499db9f7985,0x28C6c06298d514Db089934071355E5743bf21d60
9632,15627897,207128,9931982387,206496,632,138,4708715,0x3845badAde8e6dFF049820680d1F14bD3903a5d0,0x28C6c06298d514Db089934071355E5743bf21d60
9633,15627897,140088,9931982387,138524,1564,394,18,0x1Fa8559e873f698292766790AeCf8080A66433F6,0x7Bf0fB3E493ca38ba40C96F1CaD633A40bdE7580
9634,15627897,140088,9931982387,138524,1564,394,18,0x1Fa8559e873f698292766790AeCf8080A66433F6,0x762134d8060F89413ecC23f493DF75bCDB4615ee
9635,15627897,140088,9931982387,138524,1564,394,14,0x1Fa8559e873f698292766790AeCf8080A66433F6,0xcF80c03106415b866053058b3772FC5D9cdD64ae
9636,15627897,140088,9931982387,138524,1564,394,17,0x1Fa8559e873f698292766790AeCf8080A66433F6,0xFFC6947138a36C7C1cfa2F4A55A5D314E0f171dC
9637,15627897,140073,9931982387,138521,1552,394,17,0x1Fa8559e873f698292766790AeCf8080A66433F6,0xe3c4Ef24d17300A546f216fb0514dBC040Fd5A2C
9638,15627897,140088,9931982387,138524,1564,394,20,0x1Fa8559e873f698292766790AeCf8080A66433F6,0x54Cb10B2634e85Cd64CB09Ee071b0A86b8DFe3ab
9639,15627897,140088,9931982387,138524,1564,394,18,0x1Fa8559e873f698292766790AeCf8080A66433F6,0x29B6C55e399403E020F2CD16ae2D1edF99019a25
9640,15627897,140088,9931982387,138524,1564,394,17,0x1Fa8559e873f698292766790AeCf8080A66433F6,0x12A025e90A80223F2492564b0A814ae24d225D30
9641,15627897,140088,9931982387,138524,1564,394,18,0x1Fa8559e873f698292766790AeCf8080A66433F6,0x35b701BEbce0C5e6cE79a239E7FcBDa36C038543
9642,15627897,140088,9931982387,138524,1564,394,6,0x1Fa8559e873f698292766790AeCf8080A66433F6,0x6756D16a809d1d1B8F5ec04E5729798F894E5e43
9643,15627897,140088,9931982387,138524,1564,394,21,0x1Fa8559e873f698292766790AeCf8080A66433F6,0x630d4A05C445f0Fc5e0b94a7C49618dfd7589a07
9644,15627897,140088,9931982387,138524,1564,394,17,0x1Fa8559e873f698292766790AeCf8080A66433F6,0x72d99803bF5Cb45697F32399217D4E2Ed8cCE5F5
9645,15627897,140073,9931982387,138521,1552,394,18,0x1Fa8559e873f698292766790AeCf8080A66433F6,0x0bbf46b893F4FD5ab645570cb3bD5EEdA072cA6A
9646,15627897,140088,9931982387,138524,1564,394,17,0x1Fa8559e873f698292766790AeCf8080A66433F6,0x50ceD9A12De4e7ABc68DaB9Aa3b04d8Dd6fFF482
9647,15627897,140088,9931982387,138524,1564,394,21,0x1Fa8559e873f698292766790AeCf8080A66433F6,0xE81cC7998cf3dd8F88101e53307C6E742B0866AB
9648,15627897,140059,9931982387,138519,1540,394,15,0x1Fa8559e873f698292766790AeCf8080A66433F6,0xd59011a2Ad00883343733608fB515F322c3f8F0c
9649,15627897,140088,9931982387,138524,1564,394,3,0x1Fa8559e873f698292766790AeCf8080A66433F6,0x111edDAE34726e1955BB3123fc029D04646CDb42
9650,15627897,140088,9931982387,138524,1564,394,14,0x1Fa8559e873f698292766790AeCf8080A66433F6,0x92D37382D7b1062a3FDF12222794755cE1461b08
9651,15627897,140088,9931982387,138524,1564,394,17,0x1Fa8559e873f698292766790AeCf8080A66433F6,0x986d31a47C79B142118A553b43F8e1160D32b5ef
9652,15627897,140088,9931982387,138524,1564,394,6,0x1Fa8559e873f698292766790AeCf8080A66433F6,0x8D91202f8A48D5cD5ec57191851AFF9793e584fB
9653,15627897,63419,9931982387,53983,9436,2890,107,0x00000000006c3852cbEf3e08E8dF289169EdE581,0x2BD29af09c6743C7B1CD3358C2ecE9582e20eF09
9654,15627897,140088,9931982387,138524,1564,394,14,0x1Fa8559e873f698292766790AeCf8080A66433F6,0x2ACfd77a1a2591B3D0Cec77Ba2614f1E2ba539C0
9655,15627897,140088,9931982387,138524,1564,394,17,0x1Fa8559e873f698292766790AeCf8080A66433F6,0xb9ddf4a7C36B24024f11D846a1cC0587e73C3441
9656,15627897,140088,9931982387,138524,1564,394,6,0x1Fa8559e873f698292766790AeCf8080A66433F6,0xe872514DA318d5dDb55190D4e641C93c60AAab63
9657,15627897,140088,9931982387,138524,1564,394,17,0x1Fa8559e873f698292766790AeCf8080A66433F6,0x8B12AcD09b8EaF068791663D7e3485414443088f
9658,15627897,140088,9931982387,138524,1564,394,14,0x1Fa8559e873f698292766790AeCf8080A66433F6,0xb6BF55BD5ff8D98fA03E3AD6C94bC958e1E24DfE
9659,15627897,140088,9931982387,138524,1564,394,14,0x1Fa8559e873f698292766790AeCf8080A66433F6,0xa2cA03c99Bc97B7B4DfD0B4F2acF48C88eda60d0
9660,15627897,140088,9931982387,138524,1564,394,21,0x1Fa8559e873f698292766790AeCf8080A66433F6,0xcB7F70AFE1650C56dBF4d924486C4051DBF32d28
9661,15627897,140088,9931982387,138524,1564,394,18,0x1Fa8559e873f698292766790AeCf8080A66433F6,0xaB66F8578A0F0Cb8C65F82DeB2e9Dd7d059e83A8
9662,15627897,140088,9931982387,138524,1564,394,12,0x1Fa8559e873f698292766790AeCf8080A66433F6,0xA5C173300FdfC60e24DC317C43f5CEF61e564df2
9663,15627897,140088,9931982387,138524,1564,394,12,0x1Fa8559e873f698292766790AeCf8080A66433F6,0xCB0dcC12D5C37bfdF87e911Bd3EDcd54187D250F
9664,15627897,140088,9931982387,138524,1564,394,17,0x1Fa8559e873f698292766790AeCf8080A66433F6,0x793355D9f907299A2E0b62523Da46f7aAa0F6d26
9665,15627897,140088,9931982387,138524,1564,394,15,0x1Fa8559e873f698292766790AeCf8080A66433F6,0x1c178fdC982104655a842A4BE26D282FD4c4A05a
9666,15627897,140073,9931982387,138521,1552,394,14,0x1Fa8559e873f698292766790AeCf8080A66433F6,0x0f744B008dAB20a3962a69947d168F46952Ca182
9667,15627897,140088,9931982387,138524,1564,394,11,0x1Fa8559e873f698292766790AeCf8080A66433F6,0x5638F7C872BD4440bCcCA6Ab3d52aBb778AC6969
9668,15627897,140088,9931982387,138524,1564,394,17,0x1Fa8559e873f698292766790AeCf8080A66433F6,0x4a0FE3A9AD3B47E7ff2751eC6Ad19B9FE158163B
9669,15627897,140088,9931982387,138524,1564,394,19,0x1Fa8559e873f698292766790AeCf8080A66433F6,0x9ae471399D0fAE62912Bee2bCC5a3443a6987982
9670,15627897,140059,9931982387,138519,1540,394,17,0x1Fa8559e873f698292766790AeCf8080A66433F6,0x7913B54064319c30Bb2f00e731f4FAD0f838B2f3
9671,15627897,140088,9931982387,138524,1564,394,21,0x1Fa8559e873f698292766790AeCf8080A66433F6,0xCAc5C4287C3324A42f29702eB80D648D216F166e
9672,15627897,140073,9931982387,138521,1552,394,18,0x1Fa8559e873f698292766790AeCf8080A66433F6,0x3873220F5084C8F7419680e5B66A52BEf57925Eb
9673,15627897,140088,9931982387,138524,1564,394,17,0x1Fa8559e873f698292766790AeCf8080A66433F6,0x034b978e957392Ddfe91EE5d3727A05ca269c3B3
9674,15627897,140088,9931982387,138524,1564,394,3,0x1Fa8559e873f698292766790AeCf8080A66433F6,0x4fB2a6ceb322f8F90956099154bff23301Bc525e
9675,15627897,140088,9931982387,138524,1564,394,18,0x1Fa8559e873f698292766790AeCf8080A66433F6,0x71091a9730f0E1E6875327D658695752a50B1531
9676,15627897,140088,9931982387,138524,1564,394,19,0x1Fa8559e873f698292766790AeCf8080A66433F6,0xD92797cD1D6E0a2A7363578982b84e4Ceb99ABE1
9677,15627897,140088,9931982387,138524,1564,394,15,0x1Fa8559e873f698292766790AeCf8080A66433F6,0x251A6F5eF080823507637a2CdaBE66B67fc54eD8
9678,15627897,140073,9931982387,138521,1552,394,15,0x1Fa8559e873f698292766790AeCf8080A66433F6,0x290ab255F4E0B159591A5Da0300CdEFF5E78566F
9679,15627897,140088,9931982387,138524,1564,394,15,0x1Fa8559e873f698292766790AeCf8080A66433F6,0x3AC4684d05c3F743f72894943173f72682bBeD20
9680,15627897,140088,9931982387,138524,1564,394,15,0x1Fa8559e873f698292766790AeCf8080A66433F6,0x653Ea568bB4f5025e888Dc3Dc410cCeb7d052a75
9681,15627897,140088,9931982387,138524,1564,394,3,0x1Fa8559e873f698292766790AeCf8080A66433F6,0xdCeDF78E445d95459eCE94b21abD8BaDF25D5733
9682,15627897,140073,9931982387,138521,1552,394,6,0x1Fa8559e873f698292766790AeCf8080A66433F6,0x92d514d800D3337e894912935348027EC9c73740
9683,15627897,140088,9931982387,138524,1564,394,18,0x1Fa8559e873f698292766790AeCf8080A66433F6,0x8FceF931fC15F324213F4880Ca0dc24C75D574a8
9684,15627897,140088,9931982387,138524,1564,394,14,0x1Fa8559e873f698292766790AeCf8080A66433F6,0xcB89d1C309e4E3D036ccBF7D2460bA499EAA6154
9685,15627897,140088,9931982387,138524,1564,394,16,0x1Fa8559e873f698292766790AeCf8080A66433F6,0x35ef1F5c1c25d397e4cBF1Ba3d8E57E6c5181607
9686,15627897,140088,9931982387,138524,1564,394,9,0x1Fa8559e873f698292766790AeCf8080A66433F6,0x81017F9f84E28D53ff13D2021f7b31f3E3D80796
9687,15627897,140073,9931982387,138521,1552,394,19,0x1Fa8559e873f698292766790AeCf8080A66433F6,0x871a2135b2fe699204B36eBBC1a127f7e6636fD9
9688,15627897,140088,9931982387,138524,1564,394,18,0x1Fa8559e873f698292766790AeCf8080A66433F6,0x9604E0d9d828833259Ff03522AbdC82555761c04
9689,15627897,140088,9931982387,138524,1564,394,6,0x1Fa8559e873f698292766790AeCf8080A66433F6,0x330f822bcB6Be4AF1347bD3a71EeeB66661209d9
9690,15627897,140088,9931982387,138524,1564,394,6,0x1Fa8559e873f698292766790AeCf8080A66433F6,0xeE254AB31fc75fcc29232b48Ed4b132b86B5Ab95
9691,15627897,140088,9931982387,138524,1564,394,16,0x1Fa8559e873f698292766790AeCf8080A66433F6,0x0C5AB0122d35Bde604478Ec99f1fCAda03fA71E5
9692,15627897,140088,9931982387,138524,1564,394,19,0x1Fa8559e873f698292766790AeCf8080A66433F6,0xe71A58F91647257EfC8DeE5f59718ddFf97905B4
9693,15627897,140059,9931982387,138519,1540,394,17,0x1Fa8559e873f698292766790AeCf8080A66433F6,0xA52153B0b271Ce7D6Bda7a0BFc50707c006a92a0
9694,15627897,140088,9931982387,138524,1564,394,17,0x1Fa8559e873f698292766790AeCf8080A66433F6,0xa4071Df406725d9b2d50a65889153bE93875B466
9695,15627897,140088,9931982387,138524,1564,394,3,0x1Fa8559e873f698292766790AeCf8080A66433F6,0x3305c5bF34c7509294feFe7a26c5B01864629d77
9696,15627897,140088,9931982387,138524,1564,394,13,0x1Fa8559e873f698292766790AeCf8080A66433F6,0x2e04289a459D8F38FB17B84CBd5D9608ec3dB40C
9697,15627897,140088,9931982387,138524,1564,394,15,0x1Fa8559e873f698292766790AeCf8080A66433F6,0xd234F0dce6cce62c670515597a82bCd5ad152585
9698,15627897,140088,9931982387,138524,1564,394,19,0x1Fa8559e873f698292766790AeCf8080A66433F6,0xFA72Aa6A5156f3516AD1636B49797Dd1Fc2b5D79
9699,15627897,140088,9931982387,138524,1564,394,6,0x1Fa8559e873f698292766790AeCf8080A66433F6,0x9b3Ffe8d4a3B69f102BBA2d3BA1b95CFEC7aD2bF
9700,15627897,140088,9931982387,138524,1564,394,16,0x1Fa8559e873f698292766790AeCf8080A66433F6,0x1BBACDFD7BBCDF76547AaebA601CCb7d80A73b77
9701,15627897,140088,9931982387,138524,1564,394,3,0x1Fa8559e873f698292766790AeCf8080A66433F6,0x69c0d7622f32d7bc11D122239320eE5D04603612
9702,15627897,140088,9931982387,138524,1564,394,18,0x1Fa8559e873f698292766790AeCf8080A66433F6,0x11848f43ef5cEDa57DB87dd719B0B705aeb4A0C4
9703,15627897,140088,9931982387,138524,1564,394,12,0x1Fa8559e873f698292766790AeCf8080A66433F6,0x0B5926eE37676e5c5a1703cE78ae49557555a1A2
9704,15627897,140088,9931982387,138524,1564,394,16,0x1Fa8559e873f698292766790AeCf8080A66433F6,0x0e117ef709d9336D2426FB683414CaB8E41f7C6b
9705,15627897,140088,9931982387,138524,1564,394,19,0x1Fa8559e873f698292766790AeCf8080A66433F6,0x26d6D482a8BDf8706E6715A0Ef74A828cB07B5fD
9706,15627897,140088,9931982387,138524,1564,394,14,0x1Fa8559e873f698292766790AeCf8080A66433F6,0xC8E80bCb41BeDe2e2ff3ee4BB831f439075206f6
9707,15627897,140088,9931982387,138524,1564,394,6,0x1Fa8559e873f698292766790AeCf8080A66433F6,0x3137e672cF309efc64aaB4349c935824E5110727
9708,15627897,140088,9931982387,138524,1564,394,17,0x1Fa8559e873f698292766790AeCf8080A66433F6,0xf93f5ee43682795e013e8c2eB156A8f0276fa194
9709,15627897,140088,9931982387,138524,1564,394,17,0x1Fa8559e873f698292766790AeCf8080A66433F6,0x385E73e0f2048E364Cf1ba7e20904e7dC88Bb4fE
9710,15627897,140088,9931982387,138524,1564,394,12,0x1Fa8559e873f698292766790AeCf8080A66433F6,0xc5DC6a09F8Db3283a4940FC0e2cb4A220eeD341f
9711,15627897,140073,9931982387,138521,1552,394,18,0x1Fa8559e873f698292766790AeCf8080A66433F6,0x9f995bf6250fc713F18EA957d6d1004c82f360E4
9712,15627897,140088,9931982387,138524,1564,394,17,0x1Fa8559e873f698292766790AeCf8080A66433F6,0xA5578C4A2213CB3E33D68A105CDA73cb17D10125
9713,15627897,140073,9931982387,138521,1552,394,16,0x1Fa8559e873f698292766790AeCf8080A66433F6,0x1DEDAdEd3F4eFc1aAeFaBbAf50658e571725221B
9714,15627897,140088,9931982387,138524,1564,394,21,0x1Fa8559e873f698292766790AeCf8080A66433F6,0x3a88bdF528494ba042C26C2D6Cfa3b9Ce3fe7170
9715,15627897,140088,9931982387,138524,1564,394,11,0x1Fa8559e873f698292766790AeCf8080A66433F6,0x5BAe60578B5E649BA8e8CCc94FC6aa128466D831
9716,15627897,140073,9931982387,138521,1552,394,21,0x1Fa8559e873f698292766790AeCf8080A66433F6,0xaaDdDBaB5E22887a119dD5a34280E46B8F77803A
9717,15627897,140088,9931982387,138524,1564,394,6,0x1Fa8559e873f698292766790AeCf8080A66433F6,0xEA2c1fB2BC59a751d29E71AC8697bfFd59135b34
9718,15627897,140088,9931982387,138524,1564,394,14,0x1Fa8559e873f698292766790AeCf8080A66433F6,0x0418DE83Bb31d2373E0eb95736BA33585DDD5A86
9719,15627897,140088,9931982387,138524,1564,394,19,0x1Fa8559e873f698292766790AeCf8080A66433F6,0x3d841c17C4E63FBF9d24CCC3F04bfF0f9d520a5b
9720,15627897,140088,9931982387,138524,1564,394,6,0x1Fa8559e873f698292766790AeCf8080A66433F6,0x72578b077591105030BbEE2982f067388fd719dC
9721,15627897,140088,9931982387,138524,1564,394,22,0x1Fa8559e873f698292766790AeCf8080A66433F6,0xe662DE668C94Bf017b24b9485660e8331Bc84024
9722,15627897,140088,9931982387,138524,1564,394,18,0x1Fa8559e873f698292766790AeCf8080A66433F6,0x63bA8741873A42D8AA48b74b02851002d8Da3C5b
9723,15627897,140088,9931982387,138524,1564,394,16,0x1Fa8559e873f698292766790AeCf8080A66433F6,0xc6440bcB84E6FcBc75F8fcd9Aa4339dA64b75131
9724,15627897,140088,9931982387,138524,1564,394,17,0x1Fa8559e873f698292766790AeCf8080A66433F6,0xa11058BD9c57b4f0d7730Af5ceE5d514235BdDBE
9725,15627897,140088,9931982387,138524,1564,394,22,0x1Fa8559e873f698292766790AeCf8080A66433F6,0x80064183410f53767a8e4CdB13A85650a487E337
9726,15627897,140088,9931982387,138524,1564,394,14,0x1Fa8559e873f698292766790AeCf8080A66433F6,0x157053eB3b49842368Cd4d433b9228dB2063171a
9727,15627897,140088,9931982387,138524,1564,394,14,0x1Fa8559e873f698292766790AeCf8080A66433F6,0x67e67AE26c5dB1b8C8B719Bd20ec459D2895c5dD
9728,15627897,140088,9931982387,138524,1564,394,6,0x1Fa8559e873f698292766790AeCf8080A66433F6,0xD167993e43B36f81AA76fD7d079Ac36ae37Ff077
9729,15627897,140088,9931982387,138524,1564,394,6,0x1Fa8559e873f698292766790AeCf8080A66433F6,0xa18B106B6e7db6250a57E13D1D458dA0CdfADB01
9730,15627897,140088,9931982387,138524,1564,394,6,0x1Fa8559e873f698292766790AeCf8080A66433F6,0xc66D3d0c1b6872714A57E156A4c7308211c22B70
9731,15627897,21000,9931982387,21000,0,2,7418,0x3f821488575a92A42ADd5c914790D67d9c6F922e,0xB00B6D69822dA235a99d2242376066507C9a97b7
9732,15627897,21000,9931982387,21000,0,2,0,0x3cD751E6b0078Be393132286c442345e5DC49699,0xB47559b1C290c60c8ABd06CFC14945c81FcaB2AD
9733,15627897,21000,9931982387,21000,0,2,18569,0x3cD751E6b0078Be393132286c442345e5DC49699,0x90E18a6920985DBACc3d76Cf27a3F2131923C720
9734,15627897,21000,9931982387,21000,0,2,0,0x3cD751E6b0078Be393132286c442345e5DC49699,0xEC4D6d860d74c505540631908ae9bfF37c55FD3C
9735,15627897,21000,9931982387,21000,0,2,5,0x3cD751E6b0078Be393132286c442345e5DC49699,0xB6cEDCE5c9FB9f2D60ccEca034BC12eaA09A47d0
9736,15627897,21000,9931982387,21000,0,2,5725,0x3cD751E6b0078Be393132286c442345e5DC49699,0x4675C7e5BaAFBFFbca748158bEcBA61ef3b0a263
9737,15627897,21000,9931982387,21000,0,2,4,0x3cD751E6b0078Be393132286c442345e5DC49699,0x23beF28c250b14471987EB8378D951247457ea90
9738,15627897,21000,9931982387,21000,0,2,2,0x3cD751E6b0078Be393132286c442345e5DC49699,0xC74d2a1bb179a10FC52DdB1d97b611D7eC324116
9739,15627897,227606,9931982387,222254,5352,1292,526,0x881D40237659C251811CEC9c364ef91dC08D300C,0x03A4518Ff4872850d82Dc41450E153AB0c37e6bb
9740,15627897,21000,9931982387,21000,0,2,8,0x3cD751E6b0078Be393132286c442345e5DC49699,0xd0d34Fc132cFf5087925004575aF6a17b513956C
9741,15627897,23300,9931982387,23300,0,2,0,0xA9D1e08C7793af67e9d92fe308d5697FB81d3E43,0x06635F048b35e3Ea1AD9335d3727736c3D45af60
9742,15627897,23300,9931982387,23300,0,2,1,0xA9D1e08C7793af67e9d92fe308d5697FB81d3E43,0xc7d020Deb72Eb3805d65f23c452F72eE27fC037E
9743,15627897,23300,9931982387,23300,0,2,1,0xA9D1e08C7793af67e9d92fe308d5697FB81d3E43,0xb082A4F1D6f9dB905B492569Ad8840AB959309c4
9744,15627897,23300,9931982387,23300,0,2,12879,0xA9D1e08C7793af67e9d92fe308d5697FB81d3E43,0x6c8dd0e9cC58c07429e065178d88444B60e60b80
9745,15627897,23300,9931982387,23300,0,2,18,0xA9D1e08C7793af67e9d92fe308d5697FB81d3E43,0xF845d0f22aF9453DB855dF6D135a41c6A0Bf6195
9746,15627897,21000,9931982387,21000,0,2,4,0x3cD751E6b0078Be393132286c442345e5DC49699,0x7d88a51fC63cFc4eB9492996439E1E820Ef41604
9747,15627897,23300,9931982387,23300,0,2,9,0xA9D1e08C7793af67e9d92fe308d5697FB81d3E43,0x62d857F6cE8414A9484f1019988d711a5a65AF2C
9748,15627897,23300,9931982387,23300,0,2,1,0xA9D1e08C7793af67e9d92fe308d5697FB81d3E43,0x7Bd496a6e7e414200af7508FA4d47E12E438729E
9749,15627897,23300,9931982387,23300,0,2,16527,0xA9D1e08C7793af67e9d92fe308d5697FB81d3E43,0x4B23d52eFf7C67F5992C2aB6D3f69b13a6a33561
9750,15627897,23300,9931982387,23300,0,2,0,0xA9D1e08C7793af67e9d92fe308d5697FB81d3E43,0xdc515BdFF7Cf6Ac01c663d1A0Db4a939EcCEdf83
9751,15627897,23300,9931982387,23300,0,2,0,0xA9D1e08C7793af67e9d92fe308d5697FB81d3E43,0x85843953Dea245eF1f7dF28710A37D7FCf748854
9752,15627897,21000,9931982387,21000,0,2,3,0x7C6A9bd531c772c7CDa3BA841f790B74e6bC41E3,0x4045Fb0571B7e73f7c2DE41086B4C5722ce5D6b5
9753,15627897,23300,9931982387,23300,0,2,56,0xA9D1e08C7793af67e9d92fe308d5697FB81d3E43,0x672E2d575a28CCD4Df20BC435Ee10a5B67DdeFFf
9754,15627897,23300,9931982387,23300,0,2,40,0xA9D1e08C7793af67e9d92fe308d5697FB81d3E43,0x1299f169C0D42d7812A5FAE65feD007984C64c88
9755,15627897,23300,9931982387,23300,0,2,0,0xA9D1e08C7793af67e9d92fe308d5697FB81d3E43,0x5aB084Ec99f7D62a5d61c3e20777F9be73196B8e
9756,15627897,23300,9931982387,23300,0,2,0,0xA9D1e08C7793af67e9d92fe308d5697FB81d3E43,0x62DC6b9a48a00a2c78183F60975cD7486E39Db0D
9757,15627897,23300,9931982387,23300,0,2,0,0xA9D1e08C7793af67e9d92fe308d5697FB81d3E43,0x5A3049830c8bD59316FEB53399695Fc4f0D7FfA7
9758,15627897,166071,9931982387,159431,6640,1810,472,0x00000000006c3852cbEf3e08E8dF289169EdE581,0x593d9aF48a7B195d7A5d215A70459b19F0334AF6
9759,15627897,21000,9931982387,21000,0,2,221,0x8AfA51A90C6968E98eFb0C7F02A3D988bcb19865,0xEab7CD40143bDF4B1bF360E6717914Ca022b8ea6
9760,15627897,21000,9931982387,21000,0,2,1257,0x134A3E1274B23dD937bb66390da4C51b4339DDB0,0x712E6BBa75b1C1415018f53C455e20B9a5B8D4C9
9761,15627897,8000000,9234709796,7999936,64,10,15108,0x88266E58a66cB5b1880814F6BFe5E12b68832B9D,0xb2AA4a5DF3641D42e72D7F07a40292794dfD07a0
9762,15627897,21000,9432982387,21000,0,2,57307,0x285329ED4f5941D39BB886889d52E241695cA42f,0xCfC0F98f30742B6d880f90155d4EbB885e55aB33
9763,15627897,174209,9431982387,167381,6828,1802,122,0x00000000006c3852cbEf3e08E8dF289169EdE581,0xfdDb0Bb81aee00D8E8D8d8dE1d9858C40405355f
9764,15627897,689824,9431982387,686148,3676,1162,592,0x68b3465833fb72A70ecDF485E0e4C7bD8665Fc45,0x2f0525A6Da1cd2D7730FC59A7302450Bc43b8846
9765,15627897,148234,9431982387,142214,6020,1674,960,0x00000000006c3852cbEf3e08E8dF289169EdE581,0xb30307f5a60E70F63dD348aa5b37F8342dcb339c
9766,15627897,535442,9431982387,531826,3616,1162,101,0x68b3465833fb72A70ecDF485E0e4C7bD8665Fc45,0xB35bCc2a72e69D4a5AB3b08FFe3bdDAED2ce5151
9767,15627897,55525,9431982387,54857,668,138,445,0xdab396cCF3d84Cf2D07C4454e10C8A6F5b008D2b,0x9d2BeEa6625c1991C796c498B93842d9E09cb6d6
9768,15627897,306261,9431982387,303889,2372,522,27,0x283Af0B28c62C092C9727F1Ee09c02CA627EB7F5,0x95781e4a0982Fb7e05785d16bDd8b7f7a45C4B72
9769,15627897,261601,9431982387,255681,5920,1738,296,0x68b3465833fb72A70ecDF485E0e4C7bD8665Fc45,0xd8d415806d20a7D1d28758C6BD73285ef2657888
9770,15627897,308679,9431982387,306259,2420,522,30,0x283Af0B28c62C092C9727F1Ee09c02CA627EB7F5,0xDEB3882D3029018448F9E533d750337166D42101
9771,15627897,105086,9431982387,104530,556,202,104,0xcDA72070E455bb31C7690a170224Ce43623d0B6f,0xfBbC953b46AE6aE37392999707F996A868d40F20
9772,15627897,213701,9431982387,207289,6412,1738,468,0x00000000006c3852cbEf3e08E8dF289169EdE581,0x03a3FE85b051f428Cf1e1b836F2b906568148483
9773,15627897,74392,9431982387,72440,1952,330,79,0x00000000000C2E074eC69A0dFb2997BA6C7d2e1e,0x815De869FC800Ab53A5BCcBb8dF94E15C0F7e8cA
9774,15627897,62007,9431982387,59507,2500,586,629,0x4976fb03C32e5B8cfe2b6cCB31c09Ba78EBaBa41,0x596A2B27BfC6862C2fFB53A2b1F4BF7F1a047342
9775,15627897,55941,9431982387,54997,944,138,252,0x95392f142Af1c12F6e39897Ff9B09c599666B50c,0x021946d496e19F6a8d7BBA9BC95BE255EbF684D3
9776,15627897,304212,9431982387,301888,2324,522,25,0x283Af0B28c62C092C9727F1Ee09c02CA627EB7F5,0x7F2b4c1E30570B7e36d8A814D5296d7Db032AA37
9777,15627897,272084,9431982387,266116,5968,1738,1,0x68b3465833fb72A70ecDF485E0e4C7bD8665Fc45,0x78a618B562AE0A781EA1b44BAF85108D7F5ac067
9778,15627897,181458,9431982387,179906,1552,394,428,0x1Fa8559e873f698292766790AeCf8080A66433F6,0xF8001B3B01cf566982F5135174657e7959f3A64b
9779,15627897,366979,9431982387,364487,2492,714,119,0x000000000000509081d6FCD3ee63e791aD1db763,0x866B719D3b7D79838492426b6C35fA14eb94f955
9780,15627897,21000,9431982387,21000,0,2,1,0xB3Ca2d678D16E587fF3e1508fC5A7357CD81238e,0x190656F955c32eB4d886b5Fe66aa5e575aE8d3ea
9781,15627897,159921,9431982387,153393,6528,1610,1012,0x00000000006c3852cbEf3e08E8dF289169EdE581,0x5b441f7Ccf29ef51494008CBab224ffd45E153b2
9782,15627897,46160,9431982387,45588,572,138,3,0x57f1887a8BF19b14fC0dF6Fd9B2acc9Af147eA85,0xfD2AaA940c941510EC373e5e2F5c0451304dE258
9783,15627897,45038,9431982387,44974,64,10,22,0xC02aaA39b223FE8D0A0e5C4F27eAD9083C756Cc2,0x307CdEd925E24F85eeEbB01f42Ba607755004369
9784,15627897,288992,9431982387,286632,2360,522,230,0x283Af0B28c62C092C9727F1Ee09c02CA627EB7F5,0x57679F905F9618d50a638cc1fe272003A831cec1
9785,15627897,305775,9431982387,303415,2360,522,27,0x283Af0B28c62C092C9727F1Ee09c02CA627EB7F5,0x510abE34817E14D26FD8DE589190Cfa676B9b42B
9786,15627897,21000,9431982387,21000,0,2,171,0x9fB8ABc0A4776e89319F64Ac13B457A18C50f618,0x8887E9ED44B3e19C16B3c2C59c7f68195D28BB0d
9787,15627897,97222,9431982387,82690,14532,4874,1432,0x00000000006c3852cbEf3e08E8dF289169EdE581,0x2cdc001EA87149210328d292cC84c250b4995DC2
9788,15627897,27938,9431982387,27874,64,10,964,0xC02aaA39b223FE8D0A0e5C4F27eAD9083C756Cc2,0x08c3d4a4fE4e28F4ea0402fcCF35D5B81E8f1EC8
9789,15627897,60767,9431982387,53271,7496,2514,74,0x00000000006c3852cbEf3e08E8dF289169EdE581,0x8A38158a8a3146116F7eb65787c541dFD6295c47
9790,15627897,21000,9431982387,21000,0,2,5,0x7a1aeb3C920417ab3a47B18bE0C662e5e44c4B27,0xC679F875351eFfdd3d35E6d18A52c1F45663841c
9791,15627897,195000,8764000000,189080,5920,1738,302800,0x9D58779365B067D5D3fCc6e92d237aCd06F1e6a1,0xF27696C8BCa7D54D696189085Ae1283f59342fA6
9792,15627897,181458,8931982387,179906,1552,394,30,0x1Fa8559e873f698292766790AeCf8080A66433F6,0xF5ca89D5d79Bee75f40fe74bAda1239Ac44B0032
9793,15627897,120000,8931982387,119380,620,138,631,0xdAC17F958D2ee523a2206206994597C13D831ec7,0xA01AA2196724a39290f465b3925E5dCaFe7F2256
9794,15627897,181476,8931982387,179912,1564,394,1417,0x1Fa8559e873f698292766790AeCf8080A66433F6,0xE7de2fF245bcf840d0d20C04c00fEc2779861f36
9795,15627897,181476,8931982387,179912,1564,394,455,0x1Fa8559e873f698292766790AeCf8080A66433F6,0x0B5e6603f02D4213Dd890335D04716752Ab60d07
9796,15627897,181476,8931982387,179912,1564,394,57,0x1Fa8559e873f698292766790AeCf8080A66433F6,0xA273d108AE3F45b558Cd5D79F941713a32A78DA9
9797,15627897,181476,8931982387,179912,1564,394,117,0x1Fa8559e873f698292766790AeCf8080A66433F6,0x8b5ED04b1305bB4784801899Aa83C05C749174De
9798,15627897,181476,8931982387,179912,1564,394,363,0x1Fa8559e873f698292766790AeCf8080A66433F6,0xCcF08C3959440736a4EBbE384eE8A0925137dDA0
9799,15627897,181476,8931982387,179912,1564,394,891,0x1Fa8559e873f698292766790AeCf8080A66433F6,0xE0450e07C8645F87617D256C479630FD304F225c
9800,15627897,270046,8931982387,266238,3808,970,111463,0xa57Bd00134B2850B2a1c55860c9e9ea100fDd6CF,0x065e3DbaFCb2C26A978720f9eB4Bce6aD9D644a1
9801,15627897,268332,8931982387,266064,2268,650,131299,0xA69babEF1cA67A37Ffaf7a485DfFF3382056e78C,0x60b86AF869f23aEb552fB7F3CaBD11B829f6Ab2F
9802,15627897,175110,8931982387,173546,1564,394,44,0x1Fa8559e873f698292766790AeCf8080A66433F6,0xA5727CaD1cB82f589FAe9D75Fb3130cf0f6b0D1c
9803,15627897,181476,8931982387,179912,1564,394,60,0x1Fa8559e873f698292766790AeCf8080A66433F6,0x6284D6d7853F2FBeC8E6A21EdeA747e476DF5591
9804,15627897,181476,8931982387,179912,1564,394,5029,0x1Fa8559e873f698292766790AeCf8080A66433F6,0x369615Bc57975B06C418f42d3FDA3754A385B97b
9805,15627897,181476,8931982387,179912,1564,394,74,0x1Fa8559e873f698292766790AeCf8080A66433F6,0xcCb4910F296E88dd98eE35D7a6dAbFB57634f5e8
9806,15627897,113310,8931982387,113106,204,74,380,0x5D004ddB5D92938dAF8448b9eac1CaA593cd26Ca,0x26DC5D39Bd7A8bc2d792dcAAAC55FE6DCef25593
9807,15627897,113310,8931982387,113106,204,74,381,0x5D004ddB5D92938dAF8448b9eac1CaA593cd26Ca,0x26DC5D39Bd7A8bc2d792dcAAAC55FE6DCef25593
9808,15627897,113310,8931982387,113106,204,74,382,0x5D004ddB5D92938dAF8448b9eac1CaA593cd26Ca,0x26DC5D39Bd7A8bc2d792dcAAAC55FE6DCef25593
9809,15627897,113310,8931982387,113106,204,74,383,0x5D004ddB5D92938dAF8448b9eac1CaA593cd26Ca,0x26DC5D39Bd7A8bc2d792dcAAAC55FE6DCef25593
9810,15627897,113310,8931982387,113106,204,74,384,0x5D004ddB5D92938dAF8448b9eac1CaA593cd26Ca,0x26DC5D39Bd7A8bc2d792dcAAAC55FE6DCef25593
9811,15627897,181476,8931982387,179912,1564,394,62,0x1Fa8559e873f698292766790AeCf8080A66433F6,0x60815BE0E9F0AcfE6372Cd3dD65e2F34f627B5cB
9812,15627897,181476,8931982387,179912,1564,394,2,0x1Fa8559e873f698292766790AeCf8080A66433F6,0xF66b7D5FeEBeDA821eA073D05D8b53e03A847F84
9813,15627898,69938,58706096672,68994,944,138,1055,0x6097004C68F7B350d72226003226Ac089597D579,0xA1CC352bC94caDdFddaA4D095762F37B2b9bc57A
9814,15627898,21000,50000000000,21000,0,2,29069,0x16c9dd1EDD52630e79156239a1a2D4F6fa590EA0,0x8b8a4abc707F16dA24B795e3e46ed22975A9D329
9815,15627898,21000,45000000000,21000,0,2,28,0x069Acf904f610Cbf8ef1540349092852e46b4E95,0x5A33dF83Ff3BcDEA8080a7FC8CE096985579d365
9816,15627898,21000,45000000000,21000,0,2,41,0x069Acf904f610Cbf8ef1540349092852e46b4E95,0x013689a92c130Eb3fE5Ad052211AE2C71000FE3E
9817,15627898,94813,45000000000,94205,608,138,9,0xdAC17F958D2ee523a2206206994597C13D831ec7,0xC4f95F4b71446365ceE70D7E56215a35C80D23fb
9818,15627898,21000,45000000000,21000,0,2,4,0x2F892cf20a122F5BB954751a6d06495a19a8C4be,0x705901aB032755a790d2F5aAA893bFb489A42425
9819,15627898,21000,45000000000,21000,0,2,1,0x2F892cf20a122F5BB954751a6d06495a19a8C4be,0x19FB4AC3E0B31d02eB1314C59ae46A4a8ACeC71E
9820,15627898,21000,45000000000,21000,0,2,0,0x2F892cf20a122F5BB954751a6d06495a19a8C4be,0x560DF75BF3fF3f3f774E34513cfdBf96F628DF4f
9821,15627898,21000,45000000000,21000,0,2,6,0x2F892cf20a122F5BB954751a6d06495a19a8C4be,0x69587a80B58283357D820b1277130C6396779F96
9822,15627898,21000,45000000000,21000,0,2,0,0x2F892cf20a122F5BB954751a6d06495a19a8C4be,0x57Db78926f476be248f1dE5Cadf09dF897A89D14
9823,15627898,21000,45000000000,21000,0,2,0,0x2F892cf20a122F5BB954751a6d06495a19a8C4be,0x9362Ed2Da8CE1b9FdA8291b671519ac4F39Eda59
9824,15627898,21000,45000000000,21000,0,2,8,0x2F892cf20a122F5BB954751a6d06495a19a8C4be,0xeBF8DDEfB46a5DfC7fa2BAC93eeb7e7c11468787
9825,15627898,21000,45000000000,21000,0,2,0,0x2F892cf20a122F5BB954751a6d06495a19a8C4be,0x68537cFD554deA2e7Eec94257dDA830B40Ec9990
9826,15627898,21000,45000000000,21000,0,2,0,0x2F892cf20a122F5BB954751a6d06495a19a8C4be,0x3f8A84952F4Aea361e87b27D0ba4A7CC0257F1Cd
9827,15627898,21000,45000000000,21000,0,2,28,0x2F892cf20a122F5BB954751a6d06495a19a8C4be,0x616caC894251e57Cca8D62371b4C56965c62ca7d
9828,15627898,21000,45000000000,21000,0,2,8,0x2F892cf20a122F5BB954751a6d06495a19a8C4be,0xA384aaA3f3fD9690a7dE508cB8FA6Edb1513a215
9829,15627898,21000,45000000000,21000,0,2,4,0x2F892cf20a122F5BB954751a6d06495a19a8C4be,0xbd5647697FC6E31F95A9FF03b37f7bc7ad284D25
9830,15627898,21000,45000000000,21000,0,2,4,0x2F892cf20a122F5BB954751a6d06495a19a8C4be,0xCE305cd7090c3C1e61E61240F267394a490ca0a5
9831,15627898,21000,45000000000,21000,0,2,1,0x2F892cf20a122F5BB954751a6d06495a19a8C4be,0x5411a91E9342D27CEa115B1674F065cC4dD3Cad6
9832,15627898,21000,45000000000,21000,0,2,1,0x2F892cf20a122F5BB954751a6d06495a19a8C4be,0x50a37D99F6AEa99216e509C80D035C9eA658EFBC
9833,15627898,21000,45000000000,21000,0,2,9,0x2F892cf20a122F5BB954751a6d06495a19a8C4be,0x9A643e364b825523B4a0502ddf860eAf68Bcf466
9834,15627898,21000,45000000000,21000,0,2,0,0x2F892cf20a122F5BB954751a6d06495a19a8C4be,0xe28B6441089DDCABaDF5A34228A3e2e7De778A0F
9835,15627898,21000,45000000000,21000,0,2,3,0x2F892cf20a122F5BB954751a6d06495a19a8C4be,0xF0bb5418fED75a63CBD0Edf7896E3bCE518B0267
9836,15627898,304677,28706096672,302829,1848,458,618,0x7a250d5630B4cF539739dF2C5dAcb4c659F2488D,0xdf70756c8De93fa8446EE903842BB28A3eecb983
9837,15627898,286437,26000000000,284565,1872,458,34,0x25553828F22bDD19a20e4F12F052903Cb474a335,0x764f48e06D72f7754DC8a7Db443E001c80aEF74c
9838,15627898,181476,21706096672,179912,1564,394,346,0x1Fa8559e873f698292766790AeCf8080A66433F6,0x6e5f7D43D6D9168942A2807a8F14787611E4449b
9839,15627898,181476,21706096672,179912,1564,394,324,0x1Fa8559e873f698292766790AeCf8080A66433F6,0x65a96890Fc5631F996B86693040d5C02c32FB786
9840,15627898,181476,21706096672,179912,1564,394,242,0x1Fa8559e873f698292766790AeCf8080A66433F6,0x2fb68D64e6927FE93a413f8EeAEb4987F9680B86
9841,15627898,181476,21706096672,179912,1564,394,335,0x1Fa8559e873f698292766790AeCf8080A66433F6,0x4e329aEA978D2D2BdFDb812F0f2b4217ED13bB37
9842,15627898,181476,21706096672,179912,1564,394,338,0x1Fa8559e873f698292766790AeCf8080A66433F6,0xaE14e99cdf6C4c9E2278b2368ccFF39F658B97fE
9843,15627898,181476,21706096672,179912,1564,394,317,0x1Fa8559e873f698292766790AeCf8080A66433F6,0xeB0248f4F1bf7564955f4B6924158F2909Af9bc6
9844,15627898,181476,18706096672,179912,1564,394,2742,0x1Fa8559e873f698292766790AeCf8080A66433F6,0xFe05EE50bd3646f27Cd5C6957bfd561B8335B0E8
9845,15627898,90684,15879305761,90076,608,138,1,0xdAC17F958D2ee523a2206206994597C13D831ec7,0x20d5201d671EC838d700867ab8e1629276A4518A
9846,15627898,77356,15000000000,76748,608,138,2188248,0x467719aD09025FcC6cF6F8311755809d45a5E5f3,0x75e89d5979E4f6Fba9F97c104c2F0AFB3F1dcB88
9847,15627898,77356,15000000000,76748,608,138,2188249,0x467719aD09025FcC6cF6F8311755809d45a5E5f3,0x75e89d5979E4f6Fba9F97c104c2F0AFB3F1dcB88
9848,15627898,21000,14000000000,21000,0,2,1,0x500A746c9a44f68Fe6AA86a92e7B3AF4F322Ae66,0xB5b64FE5F6997DE0f5a8a24d6b672e340A24D33E
9849,15627898,21000,14000000000,21000,0,2,2,0x500A746c9a44f68Fe6AA86a92e7B3AF4F322Ae66,0x35f187775db4bEB4747560480D2587F02381Ab8c
9850,15627898,69939,13706096672,68995,944,138,156,0xeE3FC268418f54cFEb7817cc52C642489A5DF098,0x5c7bfC47a62beB16f11c3881D437c59B0d08b84C
9851,15627898,93850,12464311547,93242,608,138,4709941,0xdAC17F958D2ee523a2206206994597C13D831ec7,0x2FAF487A4414Fe77e2327F0bf4AE2a264a776AD2
9852,15627898,350000,11788333479,349404,596,138,6925068,0xdAC17F958D2ee523a2206206994597C13D831ec7,0x46340b20830761efd32832A74d7169B29FEB9758
9853,15627898,350000,11788333479,350000,0,2,6925069,0x2687Ef59900D46CcbC4DA0A426CA3e3B1e69Ed80,0x46340b20830761efd32832A74d7169B29FEB9758
9854,15627898,160000,11500000000,159380,620,138,6594,0xdAC17F958D2ee523a2206206994597C13D831ec7,0x3DE0cFe6985A95Cc9CB69c056b9d210418a1E1F4
9855,15627898,21000,11206096672,21000,0,2,54,0xe1bc9c291E6F3d1966E6D7dd2493D1793F143f27,0x71b81cDA7eA6ab3CA51a0F5200BBb56FfC259AC0
9856,15627898,146784,11206096672,146580,204,74,7,0x7F9306FC1978938d5C1C57Bf6044dc67E07eeB8a,0xa46ffe2D0df875ecaC445dA552E172f6B68EDc65
9857,15627898,55504,11206096672,54812,692,138,458,0x62B9c7356A2Dc64a1969e19C23e4f579F9810Aa7,0x9a679F16A53a7b353c4879E40Cf50082d6ebc5ab
9858,15627898,305896,11206096672,298932,6964,970,234,0x9b3B6974531d8AA15A87908FFd821A64863Ede5B,0xcb031C306800283FD29aB7912c5E8F11BB9683B8
9859,15627898,21000,11000000000,21000,0,2,508312,0x18E34baC974b5703a646BFc31A2d6d918f3fd4C4,0x39F6a6C85d39d5ABAd8A398310c52E7c374F2bA3
9860,15627898,28000,11000000000,27996,4,4,120,0x000000000000000000000000000000000000dEaD,0x4487a9eD1AeF5Fb6e66c6c39d310C212f66AA3e0
9861,15627898,46239,10706096672,45607,632,138,121,0xA67b8e40111A0EDD30C3210b77aadb86AD234c43,0x4487a9eD1AeF5Fb6e66c6c39d310C212f66AA3e0
9862,15627898,140088,10706096672,138524,1564,394,4,0x1Fa8559e873f698292766790AeCf8080A66433F6,0x0db2602534b85759107DeDf0392367f4342F9D9B
9863,15627898,39630,10706096672,39354,276,74,2142,0xC02aaA39b223FE8D0A0e5C4F27eAD9083C756Cc2,0x9C51532Ef51ab720514b5acAf97Fe6C600FbFb54
9864,15627898,21000,10706096672,21000,0,2,15,0x2b4D95B73d5809B55728ab762B1005af926f8f7e,0x1f41509DC6F3777EF62b20645a0dc58D77c3dB51
9865,15627898,181458,10706096672,179906,1552,394,164,0x1Fa8559e873f698292766790AeCf8080A66433F6,0x787c98821Aa8a31002c60d7E5DB0d12bdB355B76
9866,15627898,166355,10706096672,159691,6664,1810,11,0x00000000006c3852cbEf3e08E8dF289169EdE581,0x7BC685B03c089Ac0e8467219c2F9065BadDd1366
9867,15627898,140088,10706096672,138524,1564,394,642,0x1Fa8559e873f698292766790AeCf8080A66433F6,0x3D79e08f56ed3EFDF5FdFdC82938524b502A4161
9868,15627898,140073,10706096672,138521,1552,394,103,0x1Fa8559e873f698292766790AeCf8080A66433F6,0x99D00Ff1A0325bdAefC6e17f3Cf0852C980D0fAe
9869,15627898,140088,10706096672,138524,1564,394,46,0x1Fa8559e873f698292766790AeCf8080A66433F6,0x8E12779F91a6FE7D088d5DC9b6Db5a769EE80ba0
9870,15627898,140088,10706096672,138524,1564,394,47,0x1Fa8559e873f698292766790AeCf8080A66433F6,0xEd0c85AfA38762CfddD0780F206aedBbf9de4d17
9871,15627898,140088,10706096672,138524,1564,394,90,0x1Fa8559e873f698292766790AeCf8080A66433F6,0xa15D5B5738fBc71c0812F05f77CCCe2A1717D2F1
9872,15627898,140088,10706096672,138524,1564,394,47,0x1Fa8559e873f698292766790AeCf8080A66433F6,0x50FDB4e60a545422Ee726e0123E616A724eAB88b
9873,15627898,140088,10706096672,138524,1564,394,98,0x1Fa8559e873f698292766790AeCf8080A66433F6,0x3863Fd96Fa4F422F8366835C09b5bF790473231C
9874,15627898,140088,10706096672,138524,1564,394,55,0x1Fa8559e873f698292766790AeCf8080A66433F6,0xEeA93CDA6E0d3C73F699b839E15f75748945107c
9875,15627898,140088,10706096672,138524,1564,394,57,0x1Fa8559e873f698292766790AeCf8080A66433F6,0x43b5cbC2fd8D457F44010c4Ee0d40E35E42D5ba1
9876,15627898,140073,10706096672,138521,1552,394,49,0x1Fa8559e873f698292766790AeCf8080A66433F6,0xf89Be69f8bAa696B814BB26d91cADac81E683F68
9877,15627898,140088,10706096672,138524,1564,394,88,0x1Fa8559e873f698292766790AeCf8080A66433F6,0x9aFfee43567355874140bF139183adDF3278C0De
9878,15627898,140088,10706096672,138524,1564,394,67,0x1Fa8559e873f698292766790AeCf8080A66433F6,0x82B74f991513359FE522eDaFE39ce081E87c7226
9879,15627898,140073,10706096672,138521,1552,394,49,0x1Fa8559e873f698292766790AeCf8080A66433F6,0x9fcF15D79ab61a53A64A43607F109622bc7891Aa
9880,15627898,140088,10706096672,138524,1564,394,98,0x1Fa8559e873f698292766790AeCf8080A66433F6,0x79b1a5052301832b80dDD93aB63A51949a928e91
9881,15627898,140088,10706096672,138524,1564,394,49,0x1Fa8559e873f698292766790AeCf8080A66433F6,0xF7d2f284DA6891E35E145146768734603d8d5249
9882,15627898,140088,10706096672,138524,1564,394,94,0x1Fa8559e873f698292766790AeCf8080A66433F6,0x3CC9Cd7c9559ad9c292dEFBC7d326bBcd17C4a04
9883,15627898,140088,10706096672,138524,1564,394,55,0x1Fa8559e873f698292766790AeCf8080A66433F6,0x98E3677302E2C7c8Be72AE250a148DD44736dF21
9884,15627898,140073,10706096672,138521,1552,394,18,0x1Fa8559e873f698292766790AeCf8080A66433F6,0xb5a0c6e12960d7B4a9633ad2ecE88C54C856A100
9885,15627898,140088,10706096672,138524,1564,394,13,0x1Fa8559e873f698292766790AeCf8080A66433F6,0x31c87354d04E5e2E03600F62A4dC443466d415A8
9886,15627898,140073,10706096672,138521,1552,394,49,0x1Fa8559e873f698292766790AeCf8080A66433F6,0x8fBBDfbF58940cda330dd80fC72e74687e4909BC
9887,15627898,140088,10706096672,138524,1564,394,14,0x1Fa8559e873f698292766790AeCf8080A66433F6,0xdB1Df4c77A3d9fEBcf4A7c82448F73CC14BFE867
9888,15627898,140073,10706096672,138521,1552,394,100,0x1Fa8559e873f698292766790AeCf8080A66433F6,0x376eb113e9210EE82019Bb830816BBa600294785
9889,15627898,140088,10706096672,138524,1564,394,13,0x1Fa8559e873f698292766790AeCf8080A66433F6,0x678CFDEDe5eCc7f4Db91fcc2EB6d78d7731Aa01d
9890,15627898,140088,10706096672,138524,1564,394,46,0x1Fa8559e873f698292766790AeCf8080A66433F6,0x4B3F6C4B071d077C64bD6b68485674EF37e5cA2A
9891,15627898,140073,10706096672,138521,1552,394,16,0x1Fa8559e873f698292766790AeCf8080A66433F6,0xf31E3d2AA6911D1dCe959E1C336F0FB07fAa59b7
9892,15627898,140088,10706096672,138524,1564,394,17,0x1Fa8559e873f698292766790AeCf8080A66433F6,0x2087f1D9E75c42569d77b61eFb1c0D9F487aecdE
9893,15627898,140088,10706096672,138524,1564,394,81,0x1Fa8559e873f698292766790AeCf8080A66433F6,0x8876A6775A628CAECA3f4660B6922007C72528f3
9894,15627898,140088,10706096672,138524,1564,394,13,0x1Fa8559e873f698292766790AeCf8080A66433F6,0xD3FEf3Cf94952BEC9652591552e9d239B0377E81
9895,15627898,140073,10706096672,138521,1552,394,75,0x1Fa8559e873f698292766790AeCf8080A66433F6,0x4F83018fdc91A3f7EBA8a5c96c94fa3b34F0DB9b
9896,15627898,140088,10706096672,138524,1564,394,14,0x1Fa8559e873f698292766790AeCf8080A66433F6,0x90785045dc4c7eD1e6AB67590D5DbeE7C205250f
9897,15627898,140088,10706096672,138524,1564,394,15,0x1Fa8559e873f698292766790AeCf8080A66433F6,0x2269663aed60c3F581d1A3F503205505704BC649
9898,15627898,140088,10706096672,138524,1564,394,18,0x1Fa8559e873f698292766790AeCf8080A66433F6,0x71829BB87D92bc065733C3a6D9dFb0Ab69BbA34B
9899,15627898,140088,10706096672,138524,1564,394,44,0x1Fa8559e873f698292766790AeCf8080A66433F6,0x3e83e85767FA2eB29d480D01df5Ca482ef8FBc14
9900,15627898,140088,10706096672,138524,1564,394,16,0x1Fa8559e873f698292766790AeCf8080A66433F6,0x05c2F36d0774DfBBE03eB9FC620f945D64E6e63B
9901,15627898,140088,10706096672,138524,1564,394,48,0x1Fa8559e873f698292766790AeCf8080A66433F6,0x049f74c8eCeD9A3E7f302b28121c4b96D51dA46E
9902,15627898,140059,10706096672,138519,1540,394,43,0x1Fa8559e873f698292766790AeCf8080A66433F6,0xB62D9cF617897bcF738054924D5C6e84b148ddd2
9903,15627898,140088,10706096672,138524,1564,394,43,0x1Fa8559e873f698292766790AeCf8080A66433F6,0xac9512EB443D647Cb07227a33d92ef70e8797a73
9904,15627898,140088,10706096672,138524,1564,394,15,0x1Fa8559e873f698292766790AeCf8080A66433F6,0x50eB9a8192FeB1f796c7E11316aB6832F023B0d2
9905,15627898,140088,10706096672,138524,1564,394,46,0x1Fa8559e873f698292766790AeCf8080A66433F6,0x113d859dcD62996D119bf089877181d3A26E0aa1
9906,15627898,140073,10706096672,138521,1552,394,47,0x1Fa8559e873f698292766790AeCf8080A66433F6,0xF006fA4A3F58Cc941D8E916D646C36ABA2d57E80
9907,15627898,140088,10706096672,138524,1564,394,44,0x1Fa8559e873f698292766790AeCf8080A66433F6,0x87167ed2182d10D1a43429DA9421334919B670c5
9908,15627898,140088,10706096672,138524,1564,394,17,0x1Fa8559e873f698292766790AeCf8080A66433F6,0x290bB2ca0D2c9CD40aB9075a544B86e9147678E1
9909,15627898,140088,10706096672,138524,1564,394,46,0x1Fa8559e873f698292766790AeCf8080A66433F6,0x5851730c1F0e3047660a99666EE0342a0AF0790f
9910,15627898,140088,10706096672,138524,1564,394,17,0x1Fa8559e873f698292766790AeCf8080A66433F6,0xee9F51d3B3B39AA384b9c11750fd41285D1Ded45
9911,15627898,140088,10706096672,138524,1564,394,46,0x1Fa8559e873f698292766790AeCf8080A66433F6,0x23E53fa979BE1a7BB3f21965EdE011b33Cfb2069
9912,15627898,140073,10706096672,138521,1552,394,47,0x1Fa8559e873f698292766790AeCf8080A66433F6,0x1Ea4936A02d8Fb092FecCfc9d74122c1F40c9308
9913,15627898,140088,10706096672,138524,1564,394,15,0x1Fa8559e873f698292766790AeCf8080A66433F6,0xC639C816e42Ca6B822289Bc8bdA6B0c5Ea378601
9914,15627898,140073,10706096672,138521,1552,394,13,0x1Fa8559e873f698292766790AeCf8080A66433F6,0x9e9Ed22942DBee7859e63002b928E3bD00baC9cF
9915,15627898,140088,10706096672,138524,1564,394,13,0x1Fa8559e873f698292766790AeCf8080A66433F6,0xd826591198469F161734045B19433c9995890ec1
9916,15627898,140088,10706096672,138524,1564,394,17,0x1Fa8559e873f698292766790AeCf8080A66433F6,0xe2Af1D14737c793455249e5f0D48fE75C86dC221
9917,15627898,140088,10706096672,138524,1564,394,16,0x1Fa8559e873f698292766790AeCf8080A66433F6,0x1337e4E93489A1F7b92FFf8c45Ee4E30AF92C64a
9918,15627898,140088,10706096672,138524,1564,394,15,0x1Fa8559e873f698292766790AeCf8080A66433F6,0xdb8B1b127c74C4C97Cc4E023CADa3e8f28B696Ab
9919,15627898,140088,10706096672,138524,1564,394,44,0x1Fa8559e873f698292766790AeCf8080A66433F6,0x3d6c638C990BBF2b70B1b73e0CD25E8B4e41759C
9920,15627898,140088,10706096672,138524,1564,394,13,0x1Fa8559e873f698292766790AeCf8080A66433F6,0x7630eE827274Bca82efA6E7A2426b0b034D68B54
9921,15627898,140088,10706096672,138524,1564,394,18,0x1Fa8559e873f698292766790AeCf8080A66433F6,0xa322890ff0c5624702054038b41FCA349eD24F7d
9922,15627898,140088,10706096672,138524,1564,394,16,0x1Fa8559e873f698292766790AeCf8080A66433F6,0xB969800BAF61A58dd57CF0e85206D87A18d4736C
9923,15627898,140088,10706096672,138524,1564,394,44,0x1Fa8559e873f698292766790AeCf8080A66433F6,0x6B4bdf65Fd7ac44E62bD0728b8de4476F2B95757
9924,15627898,140088,10706096672,138524,1564,394,17,0x1Fa8559e873f698292766790AeCf8080A66433F6,0xBc06e7305EAF4cb190e7104E286e5bAd6A8c4dB4
9925,15627898,140088,10706096672,138524,1564,394,12,0x1Fa8559e873f698292766790AeCf8080A66433F6,0x5d13BaB7b7c6a1Ca8f9640D1269183258b21aEB6
9926,15627898,140073,10706096672,138521,1552,394,16,0x1Fa8559e873f698292766790AeCf8080A66433F6,0xc8aa9c55b6ad44C2B164c22ccA9a9DE90096E81e
9927,15627898,140088,10706096672,138524,1564,394,13,0x1Fa8559e873f698292766790AeCf8080A66433F6,0x895A5b51e5E96798C2546EDD9726325b1E957845
9928,15627898,140088,10706096672,138524,1564,394,17,0x1Fa8559e873f698292766790AeCf8080A66433F6,0xa42a31cdc7187d4aAD2D2DdfB56EfaE56fe04bB6
9929,15627898,140073,10706096672,138521,1552,394,14,0x1Fa8559e873f698292766790AeCf8080A66433F6,0x1Ad9617113d0dB4fa4886c8e43D38d4D27bBDd9E
9930,15627898,140088,10706096672,138524,1564,394,14,0x1Fa8559e873f698292766790AeCf8080A66433F6,0x341698aAbB723c042795959Df62A48e0790D804F
9931,15627898,140088,10706096672,138524,1564,394,15,0x1Fa8559e873f698292766790AeCf8080A66433F6,0xaA1582905465C5DF1E2d09d809cE159D22F1D655
9932,15627898,77338,10706096672,76730,608,138,129,0x467719aD09025FcC6cF6F8311755809d45a5E5f3,0x2Ed34A1bE0D751A55052cbB796E901f36833E2d2
9933,15627898,140073,10706096672,138521,1552,394,14,0x1Fa8559e873f698292766790AeCf8080A66433F6,0xfD388dcfb699cB6B4308f334ECb47ee533b56eAE
9934,15627898,140088,10706096672,138524,1564,394,13,0x1Fa8559e873f698292766790AeCf8080A66433F6,0x21F4CA02F22ef87575cBfEcE3cf8DFC8D3A16d25
9935,15627898,140088,10706096672,138524,1564,394,16,0x1Fa8559e873f698292766790AeCf8080A66433F6,0x1b1020eac604A45be9bCc7b8830d31A82b951d27
9936,15627898,140088,10706096672,138524,1564,394,16,0x1Fa8559e873f698292766790AeCf8080A66433F6,0x2ccB0c4035299C9b06c3AB0dE4E24E79f881C642
9937,15627898,140088,10706096672,138524,1564,394,49,0x1Fa8559e873f698292766790AeCf8080A66433F6,0x72e49824939087284761266b48CAa4d31BC604FC
9938,15627898,140088,10706096672,138524,1564,394,16,0x1Fa8559e873f698292766790AeCf8080A66433F6,0x3b56a1D29454285477151A9846ab111A54bc4fe6
9939,15627898,140088,10706096672,138524,1564,394,16,0x1Fa8559e873f698292766790AeCf8080A66433F6,0x72172DD5030a61dAa15a7C911787185eA1598956
9940,15627898,140088,10706096672,138524,1564,394,13,0x1Fa8559e873f698292766790AeCf8080A66433F6,0xb1Bbb08508427885058E67301C8eBD37e05b03E1
9941,15627898,140088,10706096672,138524,1564,394,14,0x1Fa8559e873f698292766790AeCf8080A66433F6,0x6ddC9d597b91a77C396b516df5988a7af9171930
9942,15627898,140088,10706096672,138524,1564,394,12,0x1Fa8559e873f698292766790AeCf8080A66433F6,0xb09163B3DAd930041fa279C9f09cAAa37fE86D63
9943,15627898,140088,10706096672,138524,1564,394,14,0x1Fa8559e873f698292766790AeCf8080A66433F6,0xB9819EAeaE8116C1F86da16Bdb463336D23875B2
9944,15627898,140088,10706096672,138524,1564,394,18,0x1Fa8559e873f698292766790AeCf8080A66433F6,0x56611346799f63038941F04F779D32F9ff32AA46
9945,15627898,140088,10706096672,138524,1564,394,15,0x1Fa8559e873f698292766790AeCf8080A66433F6,0xbd57CB897Fb5dF3Cc42d627069EBf2199A68d3C0
9946,15627898,140088,10706096672,138524,1564,394,13,0x1Fa8559e873f698292766790AeCf8080A66433F6,0xb931b6c56814Cf1211481435d0069b92Dd4A0713
9947,15627898,140088,10706096672,138524,1564,394,12,0x1Fa8559e873f698292766790AeCf8080A66433F6,0x2205C779A50BaD0c8cf8D35a9D84FCB667965F63
9948,15627898,140088,10706096672,138524,1564,394,16,0x1Fa8559e873f698292766790AeCf8080A66433F6,0x9F3bb996f1372D1453a1359fFCe6b034B1aFe0c4
9949,15627898,140088,10706096672,138524,1564,394,13,0x1Fa8559e873f698292766790AeCf8080A66433F6,0xcDAe3e803808E51b94C876D03B4F0535D719bECe
9950,15627898,140088,10706096672,138524,1564,394,14,0x1Fa8559e873f698292766790AeCf8080A66433F6,0x962854AdA6096FE242225ac0868729D48e0a3bD9
9951,15627898,140073,10706096672,138521,1552,394,13,0x1Fa8559e873f698292766790AeCf8080A66433F6,0x4A6A12cB6D366f294d32471c1d72f6BcDE4D0B00
9952,15627898,763860,10706096672,759796,4064,1290,1138,0x000000000000509081d6FCD3ee63e791aD1db763,0xE0C9B6BeD7ecA8F9bCAaeC1763f73606967283c8
9953,15627898,140088,10706096672,138524,1564,394,44,0x1Fa8559e873f698292766790AeCf8080A66433F6,0x8Dc8158478769c709f1a0B64Ee224001D948074b
9954,15627898,55834,10706096672,54890,944,138,209,0x785f2fB6072Fb74a488496D3561B3Cd57Db09661,0xD4854c4EdEC0a3e5b160b1e10b45192cE1E96e01
9955,15627898,295024,10706096672,289276,5748,1676,58,0x881D40237659C251811CEC9c364ef91dC08D300C,0x6862E6a70830d8961195f6C7532B08Aac91ff205
9956,15627898,21000,10706096672,21000,0,2,8265759,0x76d05090Be5285a9aE892a7220741FdFe21b25f3,0xb5d85CBf7cB3EE0D56b3bB207D5Fc4B82f43F511
9957,15627898,2000000,10706096672,1997776,2224,586,171056,0xA9D1e08C7793af67e9d92fe308d5697FB81d3E43,0x7830c87C02e56AFf27FA8Ab1241711331FA86F43
9958,15627898,21000,10706096672,21000,0,2,7100806,0x346001f21eb8994B410d84Dc4f6d22f797B4E2D4,0xddfAbCdc4D8FfC6d5beaf154f18B778f892A0740
9959,15627898,21000,10706096672,21000,0,2,469170,0x0410FF06a078106c9DBB91465539f2E8494397c4,0xb739D0895772DBB71A89A3754A160269068f0D45
9960,15627898,21000,10706096672,21000,0,2,1783212,0x5DA2e997A5b2FEAe883eE93e080cF6F99501b887,0x503828976D22510aad0201ac7EC88293211D23Da
9961,15627898,2000000,10706096672,1989136,10864,2314,171057,0xA9D1e08C7793af67e9d92fe308d5697FB81d3E43,0x7830c87C02e56AFf27FA8Ab1241711331FA86F43
9962,15627898,21000,10706096672,21000,0,2,1211351,0x0e8a980B1cD83163C64412bFB0C083A65eA050C0,0x95A9bd206aE52C4BA8EecFc93d18EACDd41C88CC
9963,15627898,21000,10706096672,21000,0,2,8265760,0xa885bd5b1cfA24FE955A9206Df713D0FD3Bbe179,0xb5d85CBf7cB3EE0D56b3bB207D5Fc4B82f43F511
9964,15627898,181476,10706096672,179912,1564,394,128,0x1Fa8559e873f698292766790AeCf8080A66433F6,0xaa3d4A8169dEdA887d54906DDD7d19C5654bC950
9965,15627898,77878,10706096672,77186,692,138,1,0x95aD61b0a150d79219dCF64E1E6Cc01f0B64C4cE,0x6b07ed45a377b998503182D852ED1dD93717Aa78
9966,15627898,21000,10706096672,21000,0,2,8804468,0x88B0259B5998C21F820af1c8EE49C7b4F28B7138,0x3cD751E6b0078Be393132286c442345e5DC49699
9967,15627898,46551,10706096672,45607,944,138,7,0x95aD61b0a150d79219dCF64E1E6Cc01f0B64C4cE,0x5ca22dbA4a6661562E97Cc9C42b63D20147672a5
9968,15627898,250126,10706096672,244762,5364,1484,8,0x881D40237659C251811CEC9c364ef91dC08D300C,0x5ca22dbA4a6661562E97Cc9C42b63D20147672a5
9969,15627898,42000,10706096672,42000,0,2,329554,0x0C4103D38eA25C607A67FEFD4b3cB114D5df654D,0x9430801EBAf509Ad49202aaBC5F5Bc6fd8A3dAf8
9970,15627898,500000,10706096672,499392,608,138,542323,0xA0b86991c6218b36c1d19D4a2e9Eb0cE3606eB48,0xAe2D4617c862309A3d75A0fFB358c7a5009c673F
9971,15627898,238963,10706096672,236167,2796,842,954,0x68b3465833fb72A70ecDF485E0e4C7bD8665Fc45,0x28f4De1417252Ed727b228A94A8Cc5eB1652ad22
9972,15627898,60667,10706096672,53271,7396,2506,718,0x00000000006c3852cbEf3e08E8dF289169EdE581,0x9BD31De8Ac61C4394826A6A910cFC8D920Bd2FE7
9973,15627898,64833,10500274163,64177,656,138,2,0x7D1AfA7B718fb893dB30A3aBc0Cfc608AaCfeBB0,0x53F5Ee5409e24e298aa61A87F2a120C52901E970
9974,15627898,250000,10500000000,249392,608,138,10955,0xdAC17F958D2ee523a2206206994597C13D831ec7,0x53Eb3Ea47643E87e8f25dd997A37B3b5260e7336
9975,15627898,78538,10256096672,77894,644,138,2,0x12b6893cE26Ea6341919FE289212ef77e51688c8,0x2c770990300f5bE567CA03416D48B25f8C97D1CC
9976,15627898,179426,10206096672,176174,3252,1034,23,0x68b3465833fb72A70ecDF485E0e4C7bD8665Fc45,0x4eFA2bF4276156033520bba0c62e9D71356a85Ba
9977,15627898,21000,10206096672,21000,0,2,6,0x169128a6fCe2a1C50b13fd54831e4E80974d4835,0x0E638C186C9cF41cfaBbc7E8024E0D1987b2011f
9978,15627898,46547,10206096672,46059,488,138,21,0xaE351b8Ae55B69A5007618E598dDe89d0a092c37,0x55eFf5ca4979a5C3a265c8c2f0806C7b98e148b1
9979,15627898,200133,10206096672,189541,10592,3402,3066,0x00000000006c3852cbEf3e08E8dF289169EdE581,0xe3f663418251186888935dC1C4979FA3A3dA1bAC
9980,15627898,46663,10206096672,46175,488,138,34,0x14F6f80aa18860214cE94B2B57808348D975F2ff,0xA0b1852234aA69c7377077Bf541304ae2b2Afa68
9981,15627898,21000,10206096672,21000,0,2,610,0x135f0AA5df0D8D929A4bAcB7F85Bcb2F8C7864f8,0x31F9A30FF5C8Ec029ACB5E5BacCabd76C611fc08
9982,15627898,308205,10206096672,305785,2420,522,25,0x283Af0B28c62C092C9727F1Ee09c02CA627EB7F5,0x30357c162AD9EDF99092dB6281Be36e0E452d82e
9983,15627898,418904,10206096672,417280,1624,292,26585,0xC8046263d5B5544F6413a98B4693488499195A46,0xEf5a3745F822f8F83693564c54904d7FF156CFb2
9984,15627898,46141,10206096672,45653,488,138,2,0x0E5598308BF8A2Dced4546C249BD267870F6A646,0x500A23B6DbC9125D6d2158899D6A2d7D23a6C496
9985,15627898,307719,10206096672,305311,2408,522,27,0x283Af0B28c62C092C9727F1Ee09c02CA627EB7F5,0xDc27bc1bC595d7eeE2084D502Fb975bd36539E5a
9986,15627898,667447,10206096672,662791,4656,1226,97,0xC36442b4a4522E871399CD717aBDD847Ab11FE88,0xC9F77e99E83d93ed1E7E07Cb431E56F10ad1458C
9987,15627898,505197,10206096672,502189,3008,906,311,0x000000000000509081d6FCD3ee63e791aD1db763,0x8F1ce698746D93B06152066ED8DBE359245AbA65
9988,15627898,49175,10206096672,48687,488,138,320,0x8B576c79767791f83613bEd5095ef22E04245F3E,0xc20b23462377bea7A7C1253057F8Ce1a74406Fcf
9989,15627898,242090,10206096672,240266,1824,458,2,0x7a250d5630B4cF539739dF2C5dAcb4c659F2488D,0xC6Fc3f59b26e057D965730B7d3758e646568c6A8
9990,15627898,99149,10206096672,98173,976,202,429,0x85F0e02cb992aa1F9F47112F815F519EF1A59E2D,0x216A023E0c19382D895a66A76dd92E898c9BE3a7
9991,15627898,21000,10206096672,21000,0,2,247,0xb46d81875005228e1da4eDB50e229683972a8375,0x43485A7ED2AffeD70ad1B053aAD98348513D1682
9992,15627898,306261,10206096672,303889,2372,522,25,0x283Af0B28c62C092C9727F1Ee09c02CA627EB7F5,0x39e90B221fA6520bc1d0120e11BB7DfcAFf95Fd7
9993,15627898,49175,10206096672,48687,488,138,2586,0xD27dcbcC8778a8AB33AAc529Df36a634567Be325,0x4a87D1b71937F06Db976631BdFacC82A5cdd076A
9994,15627898,138835,10206096672,126675,12160,2314,240,0xA581eA2537F67eBe9f43D751e819Bd918E809397,0xAbbcf7b0735e4Eb152fD13fa02691Cc046FAC0bD
9995,15627898,160033,10206096672,153349,6684,1682,514,0x00000000006c3852cbEf3e08E8dF289169EdE581,0x647e04f1d1Cb2fF2BbCEEb85aB4d8AF5f6EeC135
9996,15627898,244592,10206096672,240964,3628,1162,14,0x68b3465833fb72A70ecDF485E0e4C7bD8665Fc45,0x95b8D8cCB5c36dF8579216b8B617A006Cb332b7f
9997,15627898,306261,10206096672,303889,2372,522,25,0x283Af0B28c62C092C9727F1Ee09c02CA627EB7F5,0xDdEB7799A65f0F56f6C7C5F7d6247D7F54A29fc9
9998,15627898,235987,10206096672,233239,2748,842,610,0x68b3465833fb72A70ecDF485E0e4C7bD8665Fc45,0x0254b349c49D1c3375453140Be3674C028C81251
9999,15627898,136009,10206096672,129433,6576,1802,24,0x00000000006c3852cbEf3e08E8dF289169EdE581,0x3023DEfC65e97b85f6f6415769de3419119aE45F
10000,15627898,21000,10206096672,21000,0,2,2414,0xE9d08991c77a99CEb79b54e94eD76B849b9FA3db,0xfCF5B7d05bae6a12b02Dfb297EF8EB97EDDC8f52
10001,15627898,21000,10206096672,21000,0,2,41,0x97bdBB712F093BD73988c562cab7F82Ea208b3Af,0x450423ddFf2125B52EC524c8ec35B46552054aBc
10002,15627898,148116,10206096672,145020,3096,650,13,0x4976fb03C32e5B8cfe2b6cCB31c09Ba78EBaBa41,0x707856C0089Fd59d9e686A47784d5DAd7c0784c4
10003,15627898,204904,10206096672,202132,2772,842,4,0x68b3465833fb72A70ecDF485E0e4C7bD8665Fc45,0x960F560D882e89e783F2a5Ece445F8441dD96eC1
10004,15627898,96200,10206096672,95248,952,202,866,0x6322834FE489003512A61662044BcFb5Eeb2A035,0x7d38Cfba886BC11828d5c6A5ECdd49550E8a57a0
10005,15627898,122830,10206096672,122402,428,138,706,0xf5AE3C2375e0d3bfD57274f5A3913eFc6B616e70,0x7355cA5613e3c943F6df3652E7fc4e4A8b800976
10006,15627898,181476,10206096672,179912,1564,394,1007,0x1Fa8559e873f698292766790AeCf8080A66433F6,0x28A97280875b16ea73a4e21f3e119Bcd77fA0E9a
10007,15627898,21000,10206096672,21000,0,2,66,0xEa080Aaa1784c753Ee1Eaf5bdA57E240bB5c356D,0x5dDb5244acaaaaB3275b2731c981A49cd5F68CEE
10008,15627898,252925,10206096672,251065,1860,458,247,0x7a250d5630B4cF539739dF2C5dAcb4c659F2488D,0xABC95732309927A91c6ba4D10cAe97A29C67090f
10009,15627898,181476,10206096672,179912,1564,394,647,0x1Fa8559e873f698292766790AeCf8080A66433F6,0x5aA4A96D6511d172b4ADBecFA9e3e8CA7307D588
10010,15627898,260365,10206096672,254457,5908,1738,3740,0x68b3465833fb72A70ecDF485E0e4C7bD8665Fc45,0x11286A8D9AB6C307Ce0681Ad66C1b588Ad85a03a
10011,15627898,716845,10206096672,678257,38588,13386,653,0x83C8F28c26bF6aaca652Df1DbBE0e1b56F8baBa2,0xFB40898DD91e59A49529793f300F74834bebA224
10012,15627898,209709,10206096672,202509,7200,1034,745,0x3a1d32F39F901BB396eE877fD3A7C9Dbd0288D87,0x14F64b652948Ed2FEBde2517858644d5C15a6d7f
10013,15627898,45399,10206096672,44447,952,202,403,0xC86664e7d2608f881f796ee8E24FA9d4d7598406,0x7D3E5dD617EAF4A3d42EA550C41097086605c4aF
10014,15627898,200444,10206096672,180928,19516,4690,262,0x00000000006c3852cbEf3e08E8dF289169EdE581,0xf7303F4944A25237cDB7D0efb306afB5649Fad97
10015,15627898,111243,10206096672,110511,732,266,84,0x283Af0B28c62C092C9727F1Ee09c02CA627EB7F5,0xC60eA1e0DCc3E0a672304fd28F61591D9A914DA3
10016,15627898,522986,10206096672,519334,3652,1162,25,0x68b3465833fb72A70ecDF485E0e4C7bD8665Fc45,0x8001E22B2b3948E8B2cEDCa34e0c1eAF24a7B648
10017,15627898,181476,10206096672,179912,1564,394,22,0x1Fa8559e873f698292766790AeCf8080A66433F6,0xF59e0c77bEc4463f1DbD8C117c4A97A0813047d7
10018,15627898,92151,10206096672,92087,64,10,182,0x4Dbd4fc535Ac27206064B68FfCf827b0A60BAB3f,0x83f68939de5b679299De9d72B40A6E4688b6c587
10019,15627898,102124,10206096672,102060,64,10,13,0xf7db4205032153a81BCB6ed0561c00E65Ac55a06,0xaaFA6b898A43b61F576bc71513A0ac23Ca0220b7
10020,15627898,311887,10206096672,305475,6412,1738,3102,0x00000000006c3852cbEf3e08E8dF289169EdE581,0xD498420B5fFe2093FA078C800b41e6782DF7a83A
10021,15627898,191041,10000000000,190165,876,266,1401,0xd588b586D61C826A0e87919b3D1a239206d58bf2,0xC22d03e13B888Dabb33A1575e4F6542f0e996622
10022,15627898,94795,9951603606,94199,596,138,0,0xdAC17F958D2ee523a2206206994597C13D831ec7,0x282f3914471189B20A1D80FFE70411829aF95baB
10023,15627898,21000,9798220598,21000,0,2,48,0x3751Ea80DB12A930fE182A9e11c35E32b6a87758,0x2D552FD645F0D366041ECfe6F4e801D59746f245
10024,15627898,255762,9706096672,252954,2808,842,120,0x68b3465833fb72A70ecDF485E0e4C7bD8665Fc45,0x7b719f9518F4DDCd341D28838a06A78395A7d5fC
10025,15627898,181476,9706096672,179912,1564,394,5,0x1Fa8559e873f698292766790AeCf8080A66433F6,0x8c3EB8BC3676a2138965c2bE5e5106Fc2678B7ca
10026,15627898,181476,9706096672,179912,1564,394,772,0x1Fa8559e873f698292766790AeCf8080A66433F6,0x8101D517d48672392c99dDBE6A5422369C9904A7
10027,15627898,181476,9706096672,179912,1564,394,860,0x1Fa8559e873f698292766790AeCf8080A66433F6,0x02DfdA535B4d3668AcEF3Fa98F8a8f40d7acf6F4
10028,15627898,113310,9706096672,113106,204,74,385,0x5D004ddB5D92938dAF8448b9eac1CaA593cd26Ca,0x26DC5D39Bd7A8bc2d792dcAAAC55FE6DCef25593
10029,15627898,181476,9706096672,179912,1564,394,213,0x1Fa8559e873f698292766790AeCf8080A66433F6,0x7CAc9D6F806B2aC307b4a69aD27E305b40298338
10030,15627898,181476,9706096672,179912,1564,394,32,0x1Fa8559e873f698292766790AeCf8080A66433F6,0x9406705F595d154B92fa8c2C827499511e2C1a6e
10031,15627898,181458,9706096672,179906,1552,394,550,0x1Fa8559e873f698292766790AeCf8080A66433F6,0x2b8dd6db293dd5e88eE856f5DF5682416e760D04
10032,15627898,181458,9706096672,179906,1552,394,1717,0x1Fa8559e873f698292766790AeCf8080A66433F6,0x2dB2053E75Bcd9e448E171086935A263E0f8D32E
10033,15627898,181476,9706096672,179912,1564,394,4508,0x1Fa8559e873f698292766790AeCf8080A66433F6,0x5F6D3d4F90aB31064E90046745F72E89eB38FF79
10034,15627898,181458,9706096672,179906,1552,394,183,0x1Fa8559e873f698292766790AeCf8080A66433F6,0x6Fcc6A63d5A88d11DB950Dd030E78a20969eF28e
10035,15627898,181458,9706096672,179906,1552,394,62,0x1Fa8559e873f698292766790AeCf8080A66433F6,0x1DF13C3Aaf6C872c10534c0E7fA083b776C500Ae
10036,15627898,181458,9706096672,179906,1552,394,64,0x1Fa8559e873f698292766790AeCf8080A66433F6,0x8C8ab1520F615700D6ef60584996Bed58f096047
10037,15627898,472020,9706096672,471768,252,74,175,0x39AA39c021dfbaE8faC545936693aC917d5E7563,0x94aEc6a2Fd64b63cd501960E920A4D5562d35d40
10038,15627898,181476,9706096672,179912,1564,394,7,0x1Fa8559e873f698292766790AeCf8080A66433F6,0x8538233282f926F96E8bb9438DA89472a52899dB
10039,15627898,181476,9706096672,179912,1564,394,2319,0x1Fa8559e873f698292766790AeCf8080A66433F6,0x87CEF391361A4168148333332fBd5D2C621D3252
10040,15627898,181476,9706096672,179912,1564,394,226,0x1Fa8559e873f698292766790AeCf8080A66433F6,0xE9026FA5622e85662f93a23a11b552d176dd78c3
10041,15627898,181458,9706096672,179906,1552,394,23,0x1Fa8559e873f698292766790AeCf8080A66433F6,0x8400f0a6B05DA567D4cA23c8521C8c75E0eb968e
10042,15627898,181440,9706096672,179900,1540,394,374,0x1Fa8559e873f698292766790AeCf8080A66433F6,0x1Dd789345C1bAd32Ea2C3DD8989F38E5362f4f31
10043,15627898,238948,9706096672,236164,2784,842,591,0x68b3465833fb72A70ecDF485E0e4C7bD8665Fc45,0xc52CdB4821427B719b176765447578293e4CF9cb
10044,15627898,181476,9706096672,179912,1564,394,2598,0x1Fa8559e873f698292766790AeCf8080A66433F6,0x7672a2Cf4fD67FEC537776aa48EEB2Bf7ea60969
10045,15627898,21000,9628601387,21000,0,2,69,0xCBD6832Ebc203e49E2B771897067fce3c58575ac,0xd20C2eb211990D13aa2eeBc94Fb69686f0E99a07
10046,15627898,48506,9234709796,47530,976,202,10797,0xdAC17F958D2ee523a2206206994597C13D831ec7,0xF0C5eD9e061E49B69e410d94D8C9328111AC624A
10047,15627898,253555,9200000000,251695,1860,458,648,0x7a250d5630B4cF539739dF2C5dAcb4c659F2488D,0x6684Bec180207B8f3896C93e31663CD9C5b4f1e2
10048,15627898,800000,9000000000,797828,2172,458,1476,0xf1049aeD858C4eAd6df1de4dbE63EF607CfF3262,0xB81473F20818225302b8FfFB905B53D58a793D84
10049,15627898,21000,9000000000,21000,0,2,127,0x80A60C62Ec41AAEb1D496F2C10D0b3D4Dd5C046E,0x9ee2858Dc8Ab90fBB707eaDd1591620E31F8a94B
10050,15627898,1408968,9000000000,1388476,20492,6474,398,0x59828FdF7ee634AaaD3f58B19fDBa3b03E2D9d80,0x4dCbB1fE5983ad5b44DC661273a4f11CA812f8B8
10051,15627898,322533,8942018497,161009,161524,20416,183254,0x5E4e65926BA27467555EB562121fac00D24E9dD2,0x6887246668a3b87F54DeB3b94Ba47a6f63F32985
10052,15627898,21000,8760000000,21000,0,2,14,0x14b6e8df446E81c7F2C69bA1573197CCebaB1d61,0xa636a88102a7821b7e42292a4A3920A25a5d49b5
10053,15627898,21000,8743782015,21000,0,2,21,0x8261aDb8D8F49b7475FB38DfE7B3F75b9dD802A6,0xbEE6a4e0e3Fe0C228E14941396878C32556ED1E6
10054,15627899,212247,81131479299,211195,1052,186,3392,0xc7EE7c66636f407586afa431C19A916e04928942,0xFE9B945621dD512E17DbaF3bd15EEde0FA00b627
10055,15627899,295920,9611402020,294492,1428,266,43600,0x000000000035B5e5ad9019092C665357240f594e,0x7aA0426F10C7603BBFb8CEB8AFb8d8c329ccfE8b
10056,15627899,1000000,10611402020,997988,2012,522,6337,0xE592427A0AEce92De3Edee1F18E0157C05861564,0x329aFA43F8c89F65Fb6b22397c1A098EA4210D7E
10057,15627899,293634,67593493762,292146,1488,266,43601,0x000000000035B5e5ad9019092C665357240f594e,0x7aA0426F10C7603BBFb8CEB8AFb8d8c329ccfE8b
10058,15627899,2000003,9611402020,1998283,1720,346,15389,0x00000000003b3cc22aF3aE1EAc0440BcEe416B40,0xb7aB1DE5b259a880c4BB5451bDbE6f80F3798538
10059,15627899,322947,11111402020,318083,4864,1546,5549,0x68b3465833fb72A70ecDF485E0e4C7bD8665Fc45,0x26663DF4bdB9983466FC83cDF527c973F92428e7
10060,15627899,412713,13996356237,410613,2100,386,15390,0x00000000003b3cc22aF3aE1EAc0440BcEe416B40,0xb7aB1DE5b259a880c4BB5451bDbE6f80F3798538
10061,15627899,129122,49611402020,127346,1776,458,238,0xCe91aece6dcA3aA562d72F2304BFE9d9944e432c,0x24Cd1634b8d55547244935b5f94c5Fe0ce01C3e8
10062,15627899,200000,31020000000,199392,608,138,1205083,0xdAC17F958D2ee523a2206206994597C13D831ec7,0xFfec0067F5a79CFf07527f63D83dD5462cCf8BA4
10063,15627899,700000,30572423485,698128,1872,458,102,0x7a250d5630B4cF539739dF2C5dAcb4c659F2488D,0x3B5e05c1470B6907aF37Ec8C86E0fD86dbED6Ce2
10064,15627899,210000,30000000000,210000,0,2,843595,0xA8262Cfe3f8944df99B5c515dCb00CF03Bd70ac0,0xA7EFAe728D2936e78BDA97dc267687568dD593f3
10065,15627899,69938,29611402020,68994,944,138,619,0x6097004C68F7B350d72226003226Ac089597D579,0xdf70756c8De93fa8446EE903842BB28A3eecb983
10066,15627899,298951,29000000000,297067,1884,458,455,0x25553828F22bDD19a20e4F12F052903Cb474a335,0x5717cdf4bE7BdAed7fE58d12718969dde6211592
10067,15627899,215711,25881409198,213627,2084,522,352,0x7a250d5630B4cF539739dF2C5dAcb4c659F2488D,0x788296BAb7c874416c34BB5d7Bc0eb2170c97334
10068,15627899,700000,25247215693,698140,1860,458,98,0x7a250d5630B4cF539739dF2C5dAcb4c659F2488D,0xa72775d7359422BB9292C9FC3FC8758eC0D28940
10069,15627899,850000,24392317637,848128,1872,458,877,0x7a250d5630B4cF539739dF2C5dAcb4c659F2488D,0xdea76156e7ADC43a942931a90d55a573583a760d
10070,15627899,850000,24392317637,848128,1872,458,102,0x7a250d5630B4cF539739dF2C5dAcb4c659F2488D,0x18de54c850C959eDa854017De199e27c437635DF
10071,15627899,700000,24353144958,698116,1884,458,17,0x7a250d5630B4cF539739dF2C5dAcb4c659F2488D,0x5053f790cb9cFa016268eDaBdefAFc498b6d59Ce
10072,15627899,700000,27326731929,698116,1884,458,18,0x7a250d5630B4cF539739dF2C5dAcb4c659F2488D,0x5053f790cb9cFa016268eDaBdefAFc498b6d59Ce
10073,15627899,700000,23722938757,698128,1872,458,99,0x7a250d5630B4cF539739dF2C5dAcb4c659F2488D,0x56157B796BEf83dA422860Dde69cd0921A3CA95d
10074,15627899,5049432,17000000000,5042320,7112,1098,298,0x0a39DA505DfB5E0BBc6bd84428281A8ba1bC7753,0x495E889d1A6cEB447a57dcc1C68410299392380c
10075,15627899,21000,16800000000,21000,0,2,1,0x500A746c9a44f68Fe6AA86a92e7B3AF4F322Ae66,0x5879bAd4C805645823C8E6b10fD41FFD3e6d6E0F
10076,15627899,625158,16174031994,623086,2072,522,97,0x7a250d5630B4cF539739dF2C5dAcb4c659F2488D,0x24B97B003D4BffFd8d05B907582DA2E283a84389
10077,15627899,700000,24649537530,698140,1860,458,98,0x7a250d5630B4cF539739dF2C5dAcb4c659F2488D,0x24B97B003D4BffFd8d05B907582DA2E283a84389
10078,15627899,625194,16142463597,623110,2084,522,100,0x7a250d5630B4cF539739dF2C5dAcb4c659F2488D,0x0151D1D77Fb539C8c9E19B87e6008Cf1E0f5F66a
10079,15627899,90684,15879305761,90076,608,138,1,0xdAC17F958D2ee523a2206206994597C13D831ec7,0xA44ECB72484c12588c8b7fFFa61f365005e1334d
10080,15627899,21000,15400000000,21000,0,2,1,0x500A746c9a44f68Fe6AA86a92e7B3AF4F322Ae66,0x6A019f9a8F7D84325bCA9A8a229D3377DB8Dd012
10081,15627899,90000,15000000000,89392,608,138,3,0xdAC17F958D2ee523a2206206994597C13D831ec7,0xe428B9d1F5F61Eb2aa920750B61391eF4C5Ef5A6
10082,15627899,313074,14611402020,311214,1860,458,981,0x7a250d5630B4cF539739dF2C5dAcb4c659F2488D,0x4b71039B78c052E6eC1166f72661E9166e048FaC
10083,15627899,175110,12611402020,173546,1564,394,5891,0x1Fa8559e873f698292766790AeCf8080A66433F6,0xbbDd1b3C87c211E482CdA98eA14fa8bF50022CA0
10084,15627899,2894786,12611402020,2894722,64,10,3,0xFDBf91A7F2d757A9815326af5E1e60319571984c,0x9A4140FFB57D5272ea009c37a18D2A88B54e6063
10085,15627899,3600000,12611402020,3595584,4416,1226,347,0xa87Fe22939E58E8618e9e8E2e6EDc6F1f78CfD84,0x6d0eAC7b3c985Fc2c3eA8f80a2f4B6Cd3894Eddd
10086,15627899,2000000,12611402020,1998248,1752,458,232,0x7a250d5630B4cF539739dF2C5dAcb4c659F2488D,0x2f25e114eac2191Cb4e1d67A0b88ab93A11E27Ac
10087,15627899,1000000,12611402020,998164,1836,458,100,0x7a250d5630B4cF539739dF2C5dAcb4c659F2488D,0x43F0BAF4d39468C654d07Ee46a10B9c0285F1bFE
10088,15627899,600000,12611402020,598012,1988,522,7017,0x7a250d5630B4cF539739dF2C5dAcb4c659F2488D,0x8FFdD83b2C1541e661c2437B1887844654E050c9
10089,15627899,600000,12611402020,598024,1976,522,7605,0x7a250d5630B4cF539739dF2C5dAcb4c659F2488D,0x7D29c4f95c009CE4B158f68f06D56f02f460c9Bb
10090,15627899,600000,12611402020,598012,1988,522,5786,0x7a250d5630B4cF539739dF2C5dAcb4c659F2488D,0xf65760f5088902333FCDC50352781F8F82FB6F07
10091,15627899,2500000,12611402020,2495572,4428,1226,2043,0x4be08a61594D74f870b92998369122d8f6a58B78,0x19F98944322036F391E5842c8b973473bC00a760
10092,15627899,600000,12611402020,598236,1764,458,932,0x7a250d5630B4cF539739dF2C5dAcb4c659F2488D,0x6D8E9842D102d652b6eA333B028458f1Ef945C7F
10093,15627899,600000,12611402020,598236,1764,458,3374,0x7a250d5630B4cF539739dF2C5dAcb4c659F2488D,0x2Dfd7946a6D8cA71ae48c307518ACC7aF5407dd5
10094,15627899,600000,12611402020,597856,2144,522,583,0x61ccc13104B547d79fC554CFF9479ecb1AcEDA50,0x3249614aD399BBFcC4aC9eF19a6d408abe5aAE36
10095,15627899,1800000,12611402020,1798212,1788,458,223,0x7a250d5630B4cF539739dF2C5dAcb4c659F2488D,0xceB7Bc1098138e850195698F4Ff2726031CDe545
10096,15627899,600000,12611402020,597856,2144,522,973,0x61ccc13104B547d79fC554CFF9479ecb1AcEDA50,0xE72Ca43063EE8271B681C55fFb760Fa39F676e01
10097,15627899,600000,12611402020,597868,2132,522,1161,0x61ccc13104B547d79fC554CFF9479ecb1AcEDA50,0xb3004D6d3258A417542A3d43e3444ca17d0B0274
10098,15627899,600000,12611402020,598036,1964,522,291,0x7a250d5630B4cF539739dF2C5dAcb4c659F2488D,0xA4F52138B57D3F3225D917dEF563300e35e81198
10099,15627899,600000,12611402020,598236,1764,458,246,0x7a250d5630B4cF539739dF2C5dAcb4c659F2488D,0xe715d5FaDD5E475F3d3a629c3056F49a4a2ECB14
10100,15627899,600000,12611402020,597856,2144,522,529,0x61ccc13104B547d79fC554CFF9479ecb1AcEDA50,0x2709C2C583b06E98b7A8d81288AEA32aA00462db
10101,15627899,181458,12611402020,179906,1552,394,50,0x1Fa8559e873f698292766790AeCf8080A66433F6,0xd2E6A11ad8C392f7Bf28c6Ce565261974B57f41F
10102,15627899,379053,12151732348,348369,30684,5450,15,0xA0c68C638235ee32657e8f720a23ceC1bFc77C77,0x07dEc12df9073f5f34Bc79d3FBf31Bb9D4C6F8A3
10103,15627899,150756,12111402020,150692,64,10,8,0x65c2e54a4c75ff6da7b6B32369c1677250075fb2,0xcbFd68eA71cf9af23933964F33b11654a7eBa6ed
10104,15627899,143796,12111402020,143592,204,74,13,0x7F9306FC1978938d5C1C57Bf6044dc67E07eeB8a,0x146C11014Edec5705e08568Ea90734F1076db3C6
10105,15627899,21000,12000000000,21000,0,2,454,0x2D3F40Db7fA8b75bE90EAED4E1C769c9DFf7064A,0x063614796180ECC5FD2DAAbF43d8A8aE885d144a
10106,15627899,46121,11792781920,45501,620,138,0,0xdAC17F958D2ee523a2206206994597C13D831ec7,0xfDA7c14C6fD4aF8EFA3822B642e6c94E22E8ff7D
10107,15627899,21000,11757873902,21000,0,2,3911,0xd2bF01ba9c9Fe1b3e70F23596680EA3cb1D0C997,0xF8956f7c427Ea6f2dc4B022e6b4a6B6EFEBcc4be
10108,15627899,120000,11612402020,119392,608,138,23489,0xdAC17F958D2ee523a2206206994597C13D831ec7,0xD42f958E1C3e2a10e5d66343c4c9a57726E5b4b6
10109,15627899,300000,11611402020,299392,608,138,62463,0xdAC17F958D2ee523a2206206994597C13D831ec7,0xD65E0Cbd31977B2E0e23c8330C8B5f020818Fc91
10110,15627899,289164,11611402020,283428,5736,1676,63,0x881D40237659C251811CEC9c364ef91dC08D300C,0x4449b8e2B2068D71EA27735115aa11B4870cCA38
10111,15627899,231882,11611402020,229122,2760,842,73,0x68b3465833fb72A70ecDF485E0e4C7bD8665Fc45,0x8029d68833a1788340e016fB25b10F6F169985Aa
10112,15627899,21000,11611402020,21000,0,2,1,0xB893AbdD4BdED17940Fa8c55e1507A0DC2F8B3fd,0x1A644dFABF4A3ca29E0fC476770fA3CE9eE9248C
10113,15627899,181458,11611402020,179906,1552,394,169,0x1Fa8559e873f698292766790AeCf8080A66433F6,0xcb30A8456D7AebE76cDacb12A4ddA17b6fdc6BBD
10114,15627899,188548,11611402020,184884,3664,1162,37,0x68b3465833fb72A70ecDF485E0e4C7bD8665Fc45,0xC42542925B540371708e319df9f093D1Ef49eE2f
10115,15627899,42000,11611402020,42000,0,2,329555,0xF57aD14A509E455bD29335D2a3034791a45bbD5B,0x9430801EBAf509Ad49202aaBC5F5Bc6fd8A3dAf8
10116,15627899,106767,11611402020,106563,204,74,119,0x6E6cFb804D87242B5C138BCB9640f7F1Ed0b92FA,0x90A7a560c4bc9792DB5E297e5cC268c54816fF94
10117,15627899,340774,11611402020,336790,3984,1226,1654,0x68b3465833fb72A70ecDF485E0e4C7bD8665Fc45,0x3d26b43dD2181471b46cF484dd8c06C47c050d4C
10118,15627899,238934,11611402020,236162,2772,842,1479,0x68b3465833fb72A70ecDF485E0e4C7bD8665Fc45,0xa12B0Fa4104569906c018Eb3541e6605ffe8e54b
10119,15627899,175092,11611402020,173540,1552,394,3154,0x1Fa8559e873f698292766790AeCf8080A66433F6,0x86fFf6af1614bc18c72840ff8e6C033DD43BEd8A
10120,15627899,56659,11611402020,55715,944,138,4279,0xAD13C2a8d418d01F3236F4d8b9d724575a4e9d24,0xd38182442b0Dfb93278e8c74c62F3f11bbdEEb33
10121,15627899,2000000,11611402020,1998248,1752,458,831,0x7a250d5630B4cF539739dF2C5dAcb4c659F2488D,0xb19AD65C65C6c12C6dCe444F740449714A488A7F
10122,15627899,100000,11611402020,99024,976,202,88943,0xdAC17F958D2ee523a2206206994597C13D831ec7,0x3018018c44338B9728d02be12d632C6691E020d1
10123,15627899,238963,11611402020,236167,2796,842,153,0x68b3465833fb72A70ecDF485E0e4C7bD8665Fc45,0x4d7618a7a2A8CE5155986841ad09cb1e003D87Ef
10124,15627899,31582,11611402020,31582,0,2,1,0x2f03e6A59f615e2B974cF0FfcaC89Dfa0e1C3890,0x700A27bB8F5DE9d604642b23022E084d272A85E6
10125,15627899,207128,11611402020,206496,632,138,1312160,0xF57e7e7C23978C3cAEC3C3548E3D615c346e79fF,0xf60c2Ea62EDBfE808163751DD0d8693DCb30019c
10126,15627899,247945,11611402020,242881,5064,1292,134,0x881D40237659C251811CEC9c364ef91dC08D300C,0x5bF2eb73b153ec29b52018b90a2f9074bDdE70CF
10127,15627899,595940,11555759906,586608,9332,1908,83033,0x0000000000007F150Bd6f54c40A34d7C3d5e9f56,0x0336E78E4D09b8A6A84D34d0fD103452dE57A7A3
10128,15627899,75851,11435065897,75243,608,138,3820,0xdAC17F958D2ee523a2206206994597C13D831ec7,0x0090E10302a3dDeff920BA96a023423F306dc0a8
10129,15627899,21000,11293932998,21000,0,2,149,0x1F007a8F96e0B224EFa0BFC990BD01Eb0cc351A9,0x84c88874f0269A8584437fc12F0Ea5775edf493a
10130,15627899,21000,11293932998,21000,0,2,80,0x08d25fBdf0e793Bb6C3aaa21786c0069C71BC79b,0x285329ED4f5941D39BB886889d52E241695cA42f
10131,15627899,21000,11293932998,21000,0,2,80,0x8A627c5258f70387a1Dc3B17C6be3Fa0E1551183,0x1012965993555526b16EEAD82A0d46F68Ce037ae
10132,15627899,21000,11161402020,21000,0,2,1,0xEC0BCa75d3659FA662CC79Eb39433C84cecCE151,0x10Ec59fE8bBb5C889822Fa67BdCf449F11e8DA0B
10133,15627899,198504,11144893882,197340,1164,338,11,0x1111111254fb6c44bAC0beD2854e76F90643097d,0x72BC2DeE3ed241930C593B65A4a55d4D6bb0B093
10134,15627899,247006,11144893882,243754,3252,1034,130,0x68b3465833fb72A70ecDF485E0e4C7bD8665Fc45,0x9AFB1ADbE8c1aD00a92A2E3A76D3149a1e3A0c53
10135,15627899,21000,11112402020,21000,0,2,102642,0x377222a4F0F1fe251E643398CAc23F4819A2d157,0x2Db1D8CdF1Abe8C70b531a790CDf2FF38aecF652
10136,15627899,21000,11111402020,21000,0,2,10,0x04A6989E986CeD1483b9A4B5665FAB20E404035A,0x6eF314FE7C08Cb78D58Df1995dE6CdF2060435F9
10137,15627899,54326,11111402020,53838,488,138,4,0x8ffb9b504d497e4000967391e70D542b8cC6748A,0x05AFc8485cB9675185d2986ca66bF2fdD9933B31
10138,15627899,289161,11111402020,286789,2372,522,566,0x283Af0B28c62C092C9727F1Ee09c02CA627EB7F5,0x9a6798BBB486AD11583f2f46f7dE0D6bB960c6EA
10139,15627899,21000,11111402020,21000,0,2,255,0x23d8646672cDca0b3261adc46aA2d5A44B0A56EB,0x524506DE26B5D706FeaaF97A34552CDac6645C34
10140,15627899,234739,11111402020,231919,2820,842,48,0x68b3465833fb72A70ecDF485E0e4C7bD8665Fc45,0x428550b0C017f3EE82474b481231938fedc7Ab5B
10141,15627899,210237,11111402020,207465,2772,842,632,0x68b3465833fb72A70ecDF485E0e4C7bD8665Fc45,0x944A75Fdeec101544978A8A37EFF27d075F1242b
10142,15627899,49284,11111402020,48616,668,138,341,0xd084944d3c05CD115C09d072B9F44bA3E0E45921,0xc8312f842c20BFC59301cb6fE0e7683A9107FDED
10143,15627899,175110,11111402020,173546,1564,394,376,0x1Fa8559e873f698292766790AeCf8080A66433F6,0x092AC7F06be7e2a4Dd1Bc49D0F6F44a08CAC12f1
10144,15627899,46859,11111402020,46371,488,138,14,0x197492CCB4B1acaAAcd43432657A17832E36AB49,0xba43776ed93B647C9FD2070B745acBBdFDC3250D
10145,15627899,187606,11111402020,182014,5592,842,1,0x42A387bD674a8AC2b8A7613bb6E50Eb9CFd982Bf,0xB88E5Ccd8e1d5D437AB130df4b28bF05824e8F88
10146,15627899,161706,11111402020,154490,7216,1930,29,0x00000000006c3852cbEf3e08E8dF289169EdE581,0x19443b60F0047551b16491a65e0A01486a2Cd9a0
10147,15627899,233151,11111402020,230231,2920,1162,171,0x34c3f58058E2ad098ef437Ee5Ea1ff1fE2fe4214,0xfAfd2cAf198738955759b1F8796b028362788218
10148,15627899,178822,11111402020,171590,7232,1938,62,0x00000000006c3852cbEf3e08E8dF289169EdE581,0xBeEa584B3F032D0cA801202832E731d6F53C1A79
10149,15627899,78712,11111402020,78056,656,138,392,0x1Fd19DBDC459422d88Cf83CcBE9d8142bD8b7A53,0xf54c88731fe2553BfEBFB676Bb1f987360986aFd
10150,15627899,329032,11111402020,324688,4344,1034,43,0x197492CCB4B1acaAAcd43432657A17832E36AB49,0xc73E29BFE25985399f3183909009B02297E4a576
10151,15627899,123782,11111402020,122814,968,330,156,0x4e32004D8b81847A670b4a1778ACe4dCF2bBA01E,0x7b5AF6790381F932AbAe790e8b0d0ff50E287f8e
10152,15627899,401959,11111402020,398343,3616,1162,243,0x68b3465833fb72A70ecDF485E0e4C7bD8665Fc45,0x51E027b0e07dA949945641Fb592195997aB8b8AF
10153,15627899,72878,11111402020,71006,1872,458,30,0xFbdDaDD80fe7bda00B901FbAf73803F2238Ae655,0x2959EF031fF4a358867433002ede7Cb24B2C7Def
10154,15627899,21000,11111402020,21000,0,2,1,0x9bC7795209442B5f8A08d36BC47F02967A7A0494,0xfc7ec79c814ff15e2Ab1301EE21dEAB8a1e76eC8
10155,15627899,21000,11111402020,21000,0,2,113815,0x4c382ba132016e335aD1FD98b2DD883aa03B20de,0xd5FBDa4C79F38920159fE5f22DF9655FDe292d47
10156,15627899,79564,11111402020,79172,392,138,36,0x2b591e99afE9f32eAA6214f7B7629768c40Eeb39,0xCd20418Fc29288Ff61eEC92bfe49Ef8A655Db373
10157,15627899,21000,11111402020,21000,0,2,538,0x8bC01c3A784398993D7351a9c415f2aF76d494DC,0xaD5efb0A72254eCe67BAfdB22F18E439c42Bb02C
10158,15627899,166733,11111402020,160145,6588,1802,254,0x00000000006c3852cbEf3e08E8dF289169EdE581,0x4eA7804A705bb210FeeE0Ffb87c65D578E7B0782
10159,15627899,577768,11111402020,577468,300,74,151,0x3ab16Af1315dc6C95F83Cbf522fecF98D00fd9ba,0xe51d591ca021ce6406B006CA1D40377Ca5992A64
10160,15627899,55833,11111402020,54889,944,138,1123,0xD23367155B55d67492DFDC0FC7f8bB1dF7114fD9,0xd17eF8f1cc4ee78EFA9E292235e0aa968D47DDc1
10161,15627899,278821,11111402020,278617,204,74,478,0x55f1C36Bb7aE0d7D6caE97902E30A2306686Ec73,0x36151eF8bF252eB963235fd76245B98580D595F0
10162,15627899,237815,11111402020,220835,16980,4370,402,0x00000000006c3852cbEf3e08E8dF289169EdE581,0x7cFBfE6a6C5a1089a542534C0c7F69e749f6b80f
10163,15627899,181476,11111402020,179912,1564,394,18,0x1Fa8559e873f698292766790AeCf8080A66433F6,0xD3188d6d82BC964417EE8d249Cf4481B5cF6862F
10164,15627899,214626,11111402020,211842,2784,650,1509406,0x1522900B6daFac587d499a862861C0869Be6E428,0x00BDb5699745f5b860228c8f939ABF1b9Ae374eD
10165,15627899,202055,11111402020,199295,2760,650,1893239,0xD1669Ac6044269b59Fa12c5822439F609Ca54F41,0xD2C82F2e5FA236E114A81173e375a73664610998
10166,15627899,223544,11111402020,221484,2060,522,400,0x000000000000509081d6FCD3ee63e791aD1db763,0x4C16c40AeBb9c7d3d755AF80b15E843b5A058E00
10167,15627899,21000,11111402020,21000,0,2,523,0xb802FB0F2E4c3d96e6b55686a8a617F28847f5FD,0xBa98130C362431039e34638508c9EB57623D433E
10168,15627899,200000,11111402020,199356,644,138,1,0xe28b3B32B6c345A34Ff64674606124Dd5Aceca30,0xAa24F837A2d39aE5Ebe24043407cDcDc4Bd40B97
10169,15627899,400000,11111402020,399796,204,74,45,0x6AE0D3b09f87319807cf1AF13C8eE41832075CB5,0x2b479E2aA0e0b2CbD01881711d1845BA276b0564
10170,15627899,102061,11111402020,101857,204,74,44,0x55f1C36Bb7aE0d7D6caE97902E30A2306686Ec73,0xBfFEa57972fc6BD0498992CE29FFb8c14B904327
10171,15627899,21000,11111402020,21000,0,2,13,0xF81104d66bE8b2D7bDeadA73FC64BC8d909A0333,0x108cBA33c66bdc0Bf34B4D5d1397c83a0a3e33df
10172,15627899,649128,11111402020,641716,7412,1524,105725,0x0000000000007F150Bd6f54c40A34d7C3d5e9f56,0x60530f5Ca4CB9907e0FBE67cA3AFCbFE56D19A5c
10173,15627899,26344,11111402020,25768,576,74,49,0x17e4aF31838C470B350559C6369A609Ba638BeEe,0xf8Df47772a7FDEd068a44e5c0e292840211Dd590
10174,15627899,211361,11111402020,199437,11924,3786,321,0x00000000006c3852cbEf3e08E8dF289169EdE581,0xc20b23462377bea7A7C1253057F8Ce1a74406Fcf
10175,15627899,21000,11111402020,21000,0,2,1234,0x279802D50543Dd6C15a419aC7d2431C5423b8E59,0xb396D5EdcbFaB009cBF4602329371F908118d115
10176,15627899,272558,11111402020,268894,3664,1162,61,0x68b3465833fb72A70ecDF485E0e4C7bD8665Fc45,0x1c38D94aCf47c1E1BE139C335b3B682968821BC8
10177,15627899,58838,11111402020,52558,6280,2122,1364,0x00000000006c3852cbEf3e08E8dF289169EdE581,0x259E4BD1F1f803Db79ee71aB19Ad49E43C0E1B0B
10178,15627899,150756,11111402020,150692,64,10,1,0x65c2e54a4c75ff6da7b6B32369c1677250075fb2,0xe3AC7F83e815526817F8147Fd367b13de63b2413
10179,15627899,24316,11111402020,24100,216,74,61,0xdF2eeBaa127019dc84d0725EFD84b77616276D99,0x501706768C114388d089F8067668a793C8087b5f
10180,15627899,202055,11111402020,199295,2760,650,1893240,0xD1669Ac6044269b59Fa12c5822439F609Ca54F41,0xD2C82F2e5FA236E114A81173e375a73664610998
10181,15627899,191594,11111402020,172094,19500,4682,1159,0x00000000006c3852cbEf3e08E8dF289169EdE581,0xEd04eff2e061f1FFF5F04bfd97E3B9A07B698855
10182,15627899,21000,11111402020,21000,0,2,267,0xbd6Be4cfB2Ca109c50600625a5E24C7F5962bD50,0x62646fF35f803ADa7510D4a0011ac2FFE1Ef7DC6
10183,15627899,251325,11111402020,248085,3240,1034,662,0x68b3465833fb72A70ecDF485E0e4C7bD8665Fc45,0x6d06b71fdCcF7FA874b300efD9A30E9df66f8475
10184,15627899,49175,11111402020,48687,488,138,164,0x7f738Ad7072187909384B2ffBaEEdC3C1DA1b686,0x2BaF623bdff8b5a80b39Ebada5B3a05EC7DD747c
10185,15627899,149191,11111402020,142591,6600,1802,51,0x00000000006c3852cbEf3e08E8dF289169EdE581,0xcE7aa7f1f57cE772eDB0af0B5193dEe0Cc2C10B0
10186,15627899,178861,11111402020,175233,3628,1162,253,0x68b3465833fb72A70ecDF485E0e4C7bD8665Fc45,0x021946d496e19F6a8d7BBA9BC95BE255EbF684D3
10187,15627899,55950,11111402020,55006,944,138,2059,0x6097004C68F7B350d72226003226Ac089597D579,0x3461F903D434CCf3684D6f82d9F8833799Da177c
10188,15627899,151493,11111402020,145057,6436,1738,4,0x00000000006c3852cbEf3e08E8dF289169EdE581,0xabB4fBCA13d27AA3c369763815FE61BDDf5a9376
10189,15627899,1132988,11111402020,1070152,62836,21898,2824,0x83C8F28c26bF6aaca652Df1DbBE0e1b56F8baBa2,0x8bF79BAbf23256874BD04621D0aD2934DcdDB443
10190,15627899,21000,11111402020,21000,0,2,41,0xd3864619f41126760A213da2499cc55A25020683,0xa8e8b43406E85dc0836A62b08F03Fc99788dC03F
10191,15627899,291105,11111402020,288685,2420,522,231,0x283Af0B28c62C092C9727F1Ee09c02CA627EB7F5,0x57679F905F9618d50a638cc1fe272003A831cec1
10192,15627899,55950,11111402020,55006,944,138,75,0x6097004C68F7B350d72226003226Ac089597D579,0x5e52EBD5763465d808984E428e599D7e7876e91A
10193,15627899,147772,11111402020,141196,6576,1802,228,0x00000000006c3852cbEf3e08E8dF289169EdE581,0x8ACa1662a0d84309E5afbD935e10d909A4187bc8
10194,15627899,71717,11111402020,69533,2184,458,37,0x74312363e45DCaBA76c59ec49a7Aa8A65a67EeD3,0xA277285F83692a960A3fa1805DD5f699E819CC07
10195,15627899,56652,11111402020,55708,944,138,4213,0x892ED660Ba89BEAb93E35dF7fFa909048c3bB115,0x4Ed952edDB2DF5EcB924Cab763cC926f10F3F070
10196,15627899,67544,11111402020,66068,1476,458,16,0x5BABc381C7E9EdCF02654a9C30d384dFE54dd4A1,0x030ce9d143332f6D9c287414f08e22c145c43c58
10197,15627899,21000,11000000000,21000,0,2,460,0x18C6f86ee9f099DeFe10b4201e48B2eF53BeAbd0,0x3fB840c9F362407Eeb62b221f712D78fECCfC80B
10198,15627899,181458,10611402020,179906,1552,394,64,0x1Fa8559e873f698292766790AeCf8080A66433F6,0x6511dda031496AAc17eC8fd1bCD468eEbF18D627
10199,15627899,181476,10611402020,179912,1564,394,5978,0x1Fa8559e873f698292766790AeCf8080A66433F6,0x2d3162890E0a81bB0F4A1F65E8878D20853f6216
10200,15627899,181476,10611402020,179912,1564,394,235,0x1Fa8559e873f698292766790AeCf8080A66433F6,0xc0FfB6f125ACC49B7D5ACcd4cF2108a44c031E05
10201,15627899,181476,10611402020,179912,1564,394,420,0x1Fa8559e873f698292766790AeCf8080A66433F6,0xa8238d516f15Ddb468eae4D05a20B93A138e7b51
10202,15627899,181476,10611402020,179912,1564,394,8,0x1Fa8559e873f698292766790AeCf8080A66433F6,0x8f48C1ff8d3Fe32F035DD2e52FF8Fabc620a76C6
10203,15627899,181476,10611402020,179912,1564,394,347,0x1Fa8559e873f698292766790AeCf8080A66433F6,0x9a07F8c9D019d47e3EF4F9aDB9C21B0b5324A7D6
10204,15627899,181458,10611402020,179906,1552,394,65,0x1Fa8559e873f698292766790AeCf8080A66433F6,0x8C8ab1520F615700D6ef60584996Bed58f096047
10205,15627899,181476,10611402020,179912,1564,394,3676,0x1Fa8559e873f698292766790AeCf8080A66433F6,0xDb8d8F0f8E33799DBB4C555ce86AF60D44A907e6
10206,15627899,181476,10611402020,179912,1564,394,1253,0x1Fa8559e873f698292766790AeCf8080A66433F6,0x0E935a1b9a53Ef68e54b8AF90F8A0b1DbffC9aA1
10207,15627899,43092,10611402020,42840,252,74,207,0x55f1C36Bb7aE0d7D6caE97902E30A2306686Ec73,0x5bAB06Aab8aEcD0E60c8287391233F2285ad7071
10208,15627899,181476,10611402020,179912,1564,394,224,0x1Fa8559e873f698292766790AeCf8080A66433F6,0xA2a8f59d5d7b7AD6eD33E15c9D09220bcE5E1930
10209,15627899,250000,10611402020,250000,0,2,45337159,0xa9d529AFC6D6Fd37e4D93Be2a77fd1d009A208Fb,0xEA674fdDe714fd979de3EdF0F56AA9716B898ec8
10210,15627899,250000,10611402020,250000,0,2,45337160,0xc566fd58EEbFDD1779f393D5673989A755d6B286,0xEA674fdDe714fd979de3EdF0F56AA9716B898ec8
10211,15627899,250000,10611402020,250000,0,2,45337161,0xc55dEb7fc5875Bb4Ac8B67E87F05f9dB20576e37,0xEA674fdDe714fd979de3EdF0F56AA9716B898ec8
10212,15627899,250000,10611402020,250000,0,2,45337162,0x662fA297A16d201A0dBC8A9D0e3fe85426416A7a,0xEA674fdDe714fd979de3EdF0F56AA9716B898ec8
10213,15627899,250000,10611402020,250000,0,2,45337163,0x38C7D99B59f36D313D872b3b136fcAF1ff0F261a,0xEA674fdDe714fd979de3EdF0F56AA9716B898ec8
10214,15627899,250000,10611402020,250000,0,2,45337164,0xC38AF0F010113f787A6775fe34A120b7600Ed0cF,0xEA674fdDe714fd979de3EdF0F56AA9716B898ec8
10215,15627899,250000,10611402020,250000,0,2,45337165,0x7ea4dBCDA52Ee18618b0482Ddf9411069B258267,0xEA674fdDe714fd979de3EdF0F56AA9716B898ec8
10216,15627899,250000,10611402020,250000,0,2,45337166,0xFEFd4cda510De327e17F1497b0799ad45be30a0E,0xEA674fdDe714fd979de3EdF0F56AA9716B898ec8
10217,15627899,250000,10611402020,250000,0,2,45337167,0x87b303bF35F104CA24Bb5eD9b58da1EAC9458D57,0xEA674fdDe714fd979de3EdF0F56AA9716B898ec8
10218,15627899,250000,10611402020,250000,0,2,45337168,0x8DEAD8e6eB469FA4Bf1afb733a79c522401b4541,0xEA674fdDe714fd979de3EdF0F56AA9716B898ec8
10219,15627899,181476,10611402020,179912,1564,394,759,0x1Fa8559e873f698292766790AeCf8080A66433F6,0x993d31AF3811d82A4427F074710c25A66144e50C
10220,15627899,181476,10611402020,179912,1564,394,885,0x1Fa8559e873f698292766790AeCf8080A66433F6,0xaCCE4bcABFde92502B55de25e38986Bc40e58E56
10221,15627899,341249,10611402020,327337,13912,4618,610,0x83C8F28c26bF6aaca652Df1DbBE0e1b56F8baBa2,0xa7c3f481810149f3853993abC4E85C49023CD2B6
10222,15627899,181476,10611402020,179912,1564,394,361,0x1Fa8559e873f698292766790AeCf8080A66433F6,0x9379b69E5889FbE4F979A5079c571f4B74647914
10223,15627899,181476,10611402020,179912,1564,394,369,0x1Fa8559e873f698292766790AeCf8080A66433F6,0xC341D836c96E31e136aCf08A49DF9bD5e5aaE0D0
10224,15627899,130432,10611402020,130228,204,74,350,0x5D004ddB5D92938dAF8448b9eac1CaA593cd26Ca,0x08bF3B91CDF8Bc4e8c49742dCA9B0E00239267A7
10225,15627899,130432,10611402020,130228,204,74,351,0x5D004ddB5D92938dAF8448b9eac1CaA593cd26Ca,0x6E1Dab9cA972d537B31dAf4591b3ae910567223F
10226,15627899,130432,10611402020,130228,204,74,245,0x5D004ddB5D92938dAF8448b9eac1CaA593cd26Ca,0x009e266375a700eC1077D46B51206b64D10eF106
10227,15627899,130432,10611402020,130228,204,74,288,0x5D004ddB5D92938dAF8448b9eac1CaA593cd26Ca,0xc4b61cC4D30608A27f8701c4A8f26E0841D6f7e0
10228,15627899,181476,10611402020,179912,1564,394,595,0x1Fa8559e873f698292766790AeCf8080A66433F6,0x4528Cd221d9a259840b3E68f17870a8B9b4c0a9b
10229,15627899,62167,10560000000,61535,632,138,425,0x6B175474E89094C44Da98b954EedeAC495271d0F,0x4D03e3c186b4C92fb6b89dfce917f997b41cB873
10230,15627899,216991,10339691037,216291,700,94,289,0xdb7A53E6AE058E1Dcf4502341E2ADFA522E2B29F,0xa23cABeCa2145Ce4e6fdD81a45be8fB53A4F9535
10231,15627899,50000,10000000000,50000,0,2,0,0x077D360f11D220E4d5D831430c81C26c9be7C4A4,0x06C9E7aC0a73A418c5f004B6d948C8569103A130
10232,15627899,248783,10000000000,247359,1424,402,259,0x1111111254fb6c44bAC0beD2854e76F90643097d,0x5D505A5A3b12e998Cd45C7Dee4d692d8Ea322e81
10233,15627899,151538,9870916027,149850,1688,330,8815,0xe95fD76CF16008c12FF3b3a937CB16Cd9Cc20284,0xF39FeE2FDfe7DB022591F4a82e3537fA0B55fb9c
10234,15627899,300000,9836220346,299024,976,202,7729,0x92e929d8B2c8430BcAF4cD87654789578BB2b786,0xf725304D19bbA30F0F975827c234B77327b1667B
10235,15627899,50719,9635933197,50111,608,138,4,0xdAC17F958D2ee523a2206206994597C13D831ec7,0x79491902D911C16d8837be98DB8aB39Cb764a41e
10236,15627899,21000,9623151472,21000,0,2,479,0xCBD6832Ebc203e49E2B771897067fce3c58575ac,0x007d172F80c5B5909D9C7728b41465c9d9Ec6423
10237,15627899,30000,9611402020,30000,0,2,3675,0x388C818CA8B9251b393131C08a736A67ccB19297,0xF2f5C73fa04406b1995e397B55c24aB1f3eA726C
10238,15627900,500000,100000000000,498116,1884,458,7510,0x7a250d5630B4cF539739dF2C5dAcb4c659F2488D,0xC5C018EDb7Ec3e4217728C1e1F608b28057Dd507
10239,15627900,600000,57355059341,599056,944,138,1158,0xFDBf91A7F2d757A9815326af5E1e60319571984c,0x5b59fe5AC0C5e108c2f3ECD78B27c9847F4391Ae
10240,15627900,600000,57355059341,599056,944,138,2044,0xFDBf91A7F2d757A9815326af5E1e60319571984c,0x19F98944322036F391E5842c8b973473bC00a760
10241,15627900,600000,57355059341,599056,944,138,1057,0xFDBf91A7F2d757A9815326af5E1e60319571984c,0x0C517c1DE86b49C2535236f181a220c0b55b7423
10242,15627900,600000,57355059341,599056,944,138,695,0xFDBf91A7F2d757A9815326af5E1e60319571984c,0x69b63ce04dBf9Bb21a3089b354a5d4f0c379536B
10243,15627900,2000000,50000000000,1998176,1824,458,292,0x7a250d5630B4cF539739dF2C5dAcb4c659F2488D,0x65DD5D81a9934e90A2Ea8e5EfdC3669E041D6675
10244,15627900,2000000,50000000000,1998176,1824,458,214,0x7a250d5630B4cF539739dF2C5dAcb4c659F2488D,0x0A3494d8f09A367814571f3380703c326b603890
10245,15627900,2000000,50000000000,1998176,1824,458,217,0x7a250d5630B4cF539739dF2C5dAcb4c659F2488D,0x90d316Bd4144d5A6f5f704edF4C6c2ec77398416
10246,15627900,2000000,50000000000,1998176,1824,458,248,0x7a250d5630B4cF539739dF2C5dAcb4c659F2488D,0x499C4E7a24dD3d06B25eFC2B66aE8e258A329720
10247,15627900,2000000,50000000000,1998176,1824,458,265,0x7a250d5630B4cF539739dF2C5dAcb4c659F2488D,0xDAec3bd88706A615189cC4250e2b0872225Ea9C4
10248,15627900,21000,37223051731,21000,0,2,1,0x71F28449e6D7B8D2c52641aDF928E6a64401e990,0xe3A27465e6c966B8D91Bb3815A764Fa414231E24
10249,15627900,51590,37223051731,50910,680,138,31,0xE66b3AA360bB78468c00Bebe163630269DB3324F,0x71F28449e6D7B8D2c52641aDF928E6a64401e990
10250,15627900,5000000,32500000000,4982068,17932,5578,219,0xFc99f58A8974A4bc36e60E2d490Bb8D72899ee9f,0xA28062Bd708Ce49e9311d6293dEf7DF63f2b0816
10251,15627900,800000,30000000000,799056,944,138,293,0xFDBf91A7F2d757A9815326af5E1e60319571984c,0x65DD5D81a9934e90A2Ea8e5EfdC3669E041D6675
10252,15627900,800000,30000000000,799056,944,138,215,0xFDBf91A7F2d757A9815326af5E1e60319571984c,0x0A3494d8f09A367814571f3380703c326b603890
10253,15627900,800000,30000000000,799056,944,138,218,0xFDBf91A7F2d757A9815326af5E1e60319571984c,0x90d316Bd4144d5A6f5f704edF4C6c2ec77398416
10254,15627900,800000,30000000000,799056,944,138,249,0xFDBf91A7F2d757A9815326af5E1e60319571984c,0x499C4E7a24dD3d06B25eFC2B66aE8e258A329720
10255,15627900,800000,30000000000,799056,944,138,266,0xFDBf91A7F2d757A9815326af5E1e60319571984c,0xDAec3bd88706A615189cC4250e2b0872225Ea9C4
10256,15627900,250000,20355059341,249056,944,138,233,0xFDBf91A7F2d757A9815326af5E1e60319571984c,0x2f25e114eac2191Cb4e1d67A0b88ab93A11E27Ac
10257,15627900,212163,20355059341,210811,1352,402,2199,0x1111111254fb6c44bAC0beD2854e76F90643097d,0x1A63CD1aaF13e424DFA370D8D4dD326b5Fb4014a
10258,15627900,181476,18000000000,179912,1564,394,2729,0x1Fa8559e873f698292766790AeCf8080A66433F6,0x1243D01e42eEF90C72d88e665647dd50b0f49f6D
10259,15627900,61353,15879305761,60745,608,138,1,0xdAC17F958D2ee523a2206206994597C13D831ec7,0x5aBa5A5A157C9F491500126235edA88653828d35
10260,15627900,100000,15484370058,99392,608,138,33038,0xdAC17F958D2ee523a2206206994597C13D831ec7,0xBd9B34cCbb8db0FDECb532B1EAF5D46f5b673fE8
10261,15627900,262476,15400000000,260476,2000,522,407,0x7a250d5630B4cF539739dF2C5dAcb4c659F2488D,0xdFb56a3F1B910522C3366c04Db1D629f631FFAA0
10262,15627900,500000,15375059341,499056,944,138,353,0x6097004C68F7B350d72226003226Ac089597D579,0x788296BAb7c874416c34BB5d7Bc0eb2170c97334
10263,15627900,319320,15355059341,317412,1908,458,216,0x7a250d5630B4cF539739dF2C5dAcb4c659F2488D,0x11cE31192602A36f4203b264da3132D2a5A9BF17
10264,15627900,1000000,15355059341,999056,944,138,101,0xFDBf91A7F2d757A9815326af5E1e60319571984c,0x43F0BAF4d39468C654d07Ee46a10B9c0285F1bFE
10265,15627900,69938,15355059341,68994,944,138,982,0x6097004C68F7B350d72226003226Ac089597D579,0x4b71039B78c052E6eC1166f72661E9166e048FaC
10266,15627900,181476,15355059341,179912,1564,394,210,0x1Fa8559e873f698292766790AeCf8080A66433F6,0x1D31524b33E531e85F6bA50EaaAa173b37a6CC37
10267,15627900,800000,15355059341,798188,1812,458,129,0x7a250d5630B4cF539739dF2C5dAcb4c659F2488D,0xe001b672D7e2E779fDc34D0E69bB223994621403
10268,15627900,181476,15000000000,179912,1564,394,24,0x1Fa8559e873f698292766790AeCf8080A66433F6,0xF5e3bA06c9D6544fA596630Ba5d5280FDD1ab1e4
10269,15627900,21000,14000000000,21000,0,2,3,0x500A746c9a44f68Fe6AA86a92e7B3AF4F322Ae66,0x8cdB636fd26D2448a2cb2A59F98b23efF9dd71F1
10270,15627900,111570,14000000000,109630,1940,330,11,0x00000000000C2E074eC69A0dFb2997BA6C7d2e1e,0x03cc71FBe5E1620f5a3D9aC2135642260ADC82bb
10271,15627900,1400000,13955059341,1399236,764,138,224,0xFDBf91A7F2d757A9815326af5E1e60319571984c,0xceB7Bc1098138e850195698F4Ff2726031CDe545
10272,15627900,345601,13648962669,311857,33744,5834,9,0xA0c68C638235ee32657e8f720a23ceC1bFc77C77,0xc611774d5EA36a861bb1747f3D975EFF9873A2F1
10273,15627900,350000,13402464645,350000,0,2,6925070,0x0516E71c2171535aC86eaC2D6B0fFd94aC2fA8bd,0x46340b20830761efd32832A74d7169B29FEB9758
10274,15627900,350000,13402464645,350000,0,2,6925071,0x27C02c2F93c42741B061e82C8379dc0065e2B408,0x46340b20830761efd32832A74d7169B29FEB9758
10275,15627900,350000,13402464645,349368,632,138,6925072,0x4a220E6096B25EADb88358cb44068A3248254675,0x46340b20830761efd32832A74d7169B29FEB9758
10276,15627900,600000,13355059341,598012,1988,522,2100,0x7a250d5630B4cF539739dF2C5dAcb4c659F2488D,0x81E805660B2b43d582372BECc06Ae504f788E8Ce
10277,15627900,275547,13355059341,273723,1824,458,950,0x7a250d5630B4cF539739dF2C5dAcb4c659F2488D,0x5E32dc9E56CFa0Ec2AAd724Bb564d8D9F9364382
10278,15627900,800000,13355059341,799056,944,138,174,0xFDBf91A7F2d757A9815326af5E1e60319571984c,0xdd4502085fcD4450f28947C0Bf389874e24355cd
10279,15627900,800000,13355059341,799056,944,138,198,0xFDBf91A7F2d757A9815326af5E1e60319571984c,0xb17FBECC70004c298A6b69a06C9ba3ce9cb4Bd11
10280,15627900,800000,13355059341,799056,944,138,348,0xFDBf91A7F2d757A9815326af5E1e60319571984c,0x6d0eAC7b3c985Fc2c3eA8f80a2f4B6Cd3894Eddd
10281,15627900,800000,13355059341,799056,944,138,136,0xFDBf91A7F2d757A9815326af5E1e60319571984c,0x897e70DC362c62428fc039d3E245E710c9bB47d5
10282,15627900,70000,12855059341,69380,620,138,5,0xA0b86991c6218b36c1d19D4a2e9Eb0cE3606eB48,0x8a48f1C89E0e99b61a5f9ed93EfA7d04901aED19
10283,15627900,210000,12801520998,209320,680,138,99,0x6097004C68F7B350d72226003226Ac089597D579,0xa72775d7359422BB9292C9FC3FC8758eC0D28940
10284,15627900,210000,12801520998,209320,680,138,100,0x6097004C68F7B350d72226003226Ac089597D579,0x56157B796BEf83dA422860Dde69cd0921A3CA95d
10285,15627900,210000,12801520998,209320,680,138,103,0x6097004C68F7B350d72226003226Ac089597D579,0x3B5e05c1470B6907aF37Ec8C86E0fD86dbED6Ce2
10286,15627900,210000,12801520998,209320,680,138,99,0x6097004C68F7B350d72226003226Ac089597D579,0x24B97B003D4BffFd8d05B907582DA2E283a84389
10287,15627900,210000,12801520998,209056,944,138,19,0x6097004C68F7B350d72226003226Ac089597D579,0x5053f790cb9cFa016268eDaBdefAFc498b6d59Ce
10288,15627900,69000,12755059341,68512,488,138,152,0xF3a1befc9643F94551c24A766Afb87383ef64dD4,0x7860513A441D1E0F7e83A1A2B053142e12f46706
10289,15627900,69000,12755059341,68512,488,138,171,0xF3a1befc9643F94551c24A766Afb87383ef64dD4,0x6B446b4727eD073828D028E0e763ddC340645BB0
10290,15627900,69000,12755059341,68512,488,138,180,0xF3a1befc9643F94551c24A766Afb87383ef64dD4,0x0F86d4bfDb39c2a64f60242c6824ce9343Bd080b
10291,15627900,69000,12755059341,68512,488,138,160,0xF3a1befc9643F94551c24A766Afb87383ef64dD4,0x6EF73971e55bD2189BAce6Ac4DCE82Bcd09bd9CF
10292,15627900,69000,12755059341,68512,488,138,170,0xF3a1befc9643F94551c24A766Afb87383ef64dD4,0x178D1754B72510356833f40D528AAA1192eaB2Ce
10293,15627900,69000,12755059341,68512,488,138,155,0xF3a1befc9643F94551c24A766Afb87383ef64dD4,0x182bc62A64675dEdFBEb6c5C939839DE06e9D467
10294,15627900,333105,12741189116,331697,1408,214,27896,0x0eae044f00B0aF300500F090eA00027097d03000,0x05429D641a61eB2C6093905784D2e8C9b5A193C8
10295,15627900,210000,12604574521,209320,680,138,103,0x6097004C68F7B350d72226003226Ac089597D579,0x18de54c850C959eDa854017De199e27c437635DF
10296,15627900,210000,12604574521,209320,680,138,878,0x6097004C68F7B350d72226003226Ac089597D579,0xdea76156e7ADC43a942931a90d55a573583a760d
10297,15627900,100000,12555059341,99056,944,138,5787,0xFDBf91A7F2d757A9815326af5E1e60319571984c,0xf65760f5088902333FCDC50352781F8F82FB6F07
10298,15627900,100000,12555059341,99056,944,138,7018,0xFDBf91A7F2d757A9815326af5E1e60319571984c,0x8FFdD83b2C1541e661c2437B1887844654E050c9
10299,15627900,100000,12555059341,99056,944,138,7606,0xFDBf91A7F2d757A9815326af5E1e60319571984c,0x7D29c4f95c009CE4B158f68f06D56f02f460c9Bb
10300,15627900,181476,12355059341,179912,1564,394,27,0x1Fa8559e873f698292766790AeCf8080A66433F6,0x10c699e993857eB0430d5c63AF0d9E74Bc5637bb
10301,15627900,181476,12355059341,179912,1564,394,1549,0x1Fa8559e873f698292766790AeCf8080A66433F6,0x84684bFE7788707CA1ECfE9e6818b8A276C58D4f
10302,15627900,80755,12355059341,80075,680,138,186,0x4cfF49d0A19ed6Ff845a9122fa912AbcFB1F68A6,0x53791e597554d09Ff8816B366dD0a44eA11652DF
10303,15627900,49542,12355059341,49478,64,10,50,0xC02aaA39b223FE8D0A0e5C4F27eAD9083C756Cc2,0x11f71B7fB4eB8f2605e6ED4768226c898965B48b
10304,15627900,42000,12355059341,42000,0,2,329556,0x6b0858DC32efcFd78018679674d8B91Aa1896C16,0x9430801EBAf509Ad49202aaBC5F5Bc6fd8A3dAf8
10305,15627900,181458,12355059341,179906,1552,394,420,0x1Fa8559e873f698292766790AeCf8080A66433F6,0x4d1f8a903E2C4949caa5453fBD0Fb6E851943094
10306,15627900,46103,12355059341,45615,488,138,103,0xe0c9BfC391cEE9e840825239aE9910C77064b356,0x0Ceee55dABF3763566EFb7Af24A1Bfab699A3853
10307,15627900,122577,12355059341,121013,1564,394,143,0x1Fa8559e873f698292766790AeCf8080A66433F6,0x2024544401BcC5eC34123308b05d3f195F58f8C2
10308,15627900,195882,12355059341,189134,6748,1738,108,0x00000000006c3852cbEf3e08E8dF289169EdE581,0x2BD29af09c6743C7B1CD3358C2ecE9582e20eF09
10309,15627900,210705,12355059341,207945,2760,842,68,0x68b3465833fb72A70ecDF485E0e4C7bD8665Fc45,0xdB37324b99585aaeeeaba036ce15f5d2696f0a2e
10310,15627900,181476,12355059341,179912,1564,394,1200,0x1Fa8559e873f698292766790AeCf8080A66433F6,0xBDd4F4d83f67A09A3BF7d57638E1Dcd32387E331
10311,15627900,21000,12355059341,21000,0,2,335,0x16f4Ce7905c23A3D8F86791827Cf4550c7f2C0Fc,0x134A3E1274B23dD937bb66390da4C51b4339DDB0
10312,15627900,229376,12355059341,224540,4836,1292,1,0x881D40237659C251811CEC9c364ef91dC08D300C,0x743B5Abd27886FACB79DaFbCc90637fB11871f7b
10313,15627900,149771,12355059341,143327,6444,1802,203,0x00000000006c3852cbEf3e08E8dF289169EdE581,0xF9E229b3323Bd3f87d80fd578b93d91fE0cFf0Ca
10314,15627900,36027,12355059341,35751,276,74,2341,0xC02aaA39b223FE8D0A0e5C4F27eAD9083C756Cc2,0xc44C70fBFEf750862fbCf73F5197a28bCAA11253
10315,15627900,21000,12310000000,21000,0,2,0,0x6dfc34609a05bC22319fA4Cce1d1E2929548c0D7,0xDE80345ba00f8FA98658613BbA837141E8C6a591
10316,15627900,21000,12310000000,21000,0,2,0,0x6dfc34609a05bC22319fA4Cce1d1E2929548c0D7,0x0D062Dc6C569a7C5F4f8B1F9260dc44c3a26e7E8
10317,15627900,63286,12303788841,63034,252,74,97,0xC02aaA39b223FE8D0A0e5C4F27eAD9083C756Cc2,0x79Ab085A8ec194Ad154B24c2C0aA392dDc64e4FC
10318,15627900,21000,12000000000,21000,0,2,0,0x1065F22C4d040A070A3146Bdb8eFC2067c2F78a9,0xd4D9F95052B9CdE8ba706DDa720D0706d409C45f
10319,15627900,247006,11888551203,243754,3252,1034,131,0x68b3465833fb72A70ecDF485E0e4C7bD8665Fc45,0x9AFB1ADbE8c1aD00a92A2E3A76D3149a1e3A0c53
10320,15627900,21000,11855059341,21000,0,2,152,0x6C420B45dCFfAadAa2baA3B4D13A81ddedb4c126,0x983116fab27a029409D23AB62fC93e37e4FaC8F2
10321,15627900,46114,11855059341,45626,488,138,13,0x07EF3e0085d4fe407044fbeEFEf2533b1aaF1Bdb,0xF7c99a6FA9f9E9d2817FC9DE69e15434f7Ad5f2a
10322,15627900,21000,11855059341,21000,0,2,3,0xc4f6865d0ce53c780B1Ba4fb7C83DD106ec49cE3,0x6585Ef58B6e6C5217794Be782c521C489CD76f24
10323,15627900,27938,11855059341,27874,64,10,975,0xC02aaA39b223FE8D0A0e5C4F27eAD9083C756Cc2,0xC77E83b862A7C1527C23B04834f694d17Fd0637C
10324,15627900,46160,11855059341,45588,572,138,4,0x57f1887a8BF19b14fC0dF6Fd9B2acc9Af147eA85,0xfD2AaA940c941510EC373e5e2F5c0451304dE258
10325,15627900,21000,11855059341,21000,0,2,177,0x6152A727332467178e2bc154b5cc041aC3BFa8Dc,0x49f8E57BEDb123ee186235169B5f351611C64DE4
10326,15627900,155869,11855059341,148685,7184,1938,147,0x00000000006c3852cbEf3e08E8dF289169EdE581,0x3E61DFfa0bC323Eaa16F4C982F96FEB89ab89E8a
10327,15627900,341161,11855059341,327261,13900,4618,1377,0xaE9C73fd0Fd237c1c6f66FE009d24ce969e98704,0xA2B0E6cF670740e0c0DF7bfcAf6B79684988a6F3
10328,15627900,46280,11855059341,45420,860,138,291,0xC02aaA39b223FE8D0A0e5C4F27eAD9083C756Cc2,0xA346C2615F70607F1973Caf6d45A26aF51089fe6
10329,15627900,98983,11855059341,97691,1292,330,76,0xA0c68C638235ee32657e8f720a23ceC1bFc77C77,0xe147122Ae0092357960945e3b56aC8debF0458cf
10330,15627900,49175,11855059341,48687,488,138,1460,0xf442459c8bB4b891B789E816775232b812Eb2ccD,0xc5C096a642bAB3a435485F4E1864dF179670D4cA
10331,15627900,21000,11855059341,21000,0,2,49,0x4171CEEC95B9b4B9CE14998cDFACBc80A09b4e55,0x5Ff75C46EcAe73599adbb277FF6FC162Fe6C8996
10332,15627900,71729,11855059341,69533,2196,458,117,0x74312363e45DCaBA76c59ec49a7Aa8A65a67EeD3,0x8c8363EE1D5AE7E3931D8EfD302ea1bB39Ef0488
10333,15627900,290776,11855059341,288368,2408,522,214,0x283Af0B28c62C092C9727F1Ee09c02CA627EB7F5,0x1f854Ee78e4d4f5AACeC5004CBaDE1b0525321Ab
10334,15627900,21000,11855059341,21000,0,2,24,0x8f4f597e38e93084ecdc60878fdaE3767836A91E,0x57CC697b2C0Cf266177083E25403fd85cCe4f1E8
10335,15627900,148234,11855059341,142214,6020,1674,207,0x00000000006c3852cbEf3e08E8dF289169EdE581,0x4BCd497e45949f7A7B89A2B297e71A396f39c471
10336,15627900,21000,11855059341,21000,0,2,539,0x3AdE18A5119A4689881379FD31Fce01685b74EE8,0xaD5efb0A72254eCe67BAfdB22F18E439c42Bb02C
10337,15627900,95493,11855059341,94541,952,202,260,0xB716600Ed99B4710152582a124C697A7Fe78ADBF,0x3A6D4c682E5f23c5782a5a8444Bc6f716e91b528
10338,15627900,48747,11855059341,47815,932,138,67,0x767FE9EDC9E0dF98E07454847909b5E959D7ca0E,0x9FFFfDdC25A5144707C58017EA77c3D0dBf65BfB
10339,15627900,248916,11855059341,246168,2748,842,0,0x68b3465833fb72A70ecDF485E0e4C7bD8665Fc45,0x135f0AA5df0D8D929A4bAcB7F85Bcb2F8C7864f8
10340,15627900,199360,11855059341,196612,2748,650,1893241,0xD1669Ac6044269b59Fa12c5822439F609Ca54F41,0xD2C82F2e5FA236E114A81173e375a73664610998
10341,15627900,199360,11855059341,196612,2748,650,1893242,0xD1669Ac6044269b59Fa12c5822439F609Ca54F41,0xD2C82F2e5FA236E114A81173e375a73664610998
10342,15627900,49259,11855059341,48687,572,138,1461,0xf442459c8bB4b891B789E816775232b812Eb2ccD,0xc5C096a642bAB3a435485F4E1864dF179670D4cA
10343,15627900,289318,11855059341,286946,2372,522,734,0x283Af0B28c62C092C9727F1Ee09c02CA627EB7F5,0x1425C88ce0780E5bcE5f405333C81f9336dC52eA
10344,15627900,181458,11855059341,179906,1552,394,172,0x1Fa8559e873f698292766790AeCf8080A66433F6,0xAB7f0FA41e41D1957FEC04120F24Af3644D600e9
10345,15627900,181476,11855059341,179912,1564,394,1070,0x1Fa8559e873f698292766790AeCf8080A66433F6,0xF4D631fa4CB9322366bD5eBC25eA94dFCe1DDf09
10346,15627900,94813,11855059341,94205,608,138,13,0xdAC17F958D2ee523a2206206994597C13D831ec7,0x668265bfCaC477eb6c9caaE54ADa1675FcD70241
10347,15627900,181476,11855059341,179912,1564,394,2191,0x1Fa8559e873f698292766790AeCf8080A66433F6,0x16C992e55b4F0D8ebF5973DaEc2cEb882C86Fd17
10348,15627900,181476,11355059341,179912,1564,394,695,0x1Fa8559e873f698292766790AeCf8080A66433F6,0x3548E8C4B4bB1f60b5B4E508Bdd3E996E93A5F64
10349,15627900,181476,11355059341,179912,1564,394,46,0x1Fa8559e873f698292766790AeCf8080A66433F6,0x83D449Ca935Ad5Fbee8CE5568dfca54E6Bd6f3eA
10350,15627900,181476,11355059341,179912,1564,394,91,0x1Fa8559e873f698292766790AeCf8080A66433F6,0xc94465fa30887c682fbF764A0Fd150Dec4917EAA
10351,15627900,181476,11355059341,179912,1564,394,1180,0x1Fa8559e873f698292766790AeCf8080A66433F6,0x8473e7450e77518dD85F7b15A54E1144DF85AAD9
10352,15627900,181476,11355059341,179912,1564,394,1677,0x1Fa8559e873f698292766790AeCf8080A66433F6,0xbC1eB4359ab755Af079F6EF77E3FaAc465e53EDA
10353,15627900,181476,11355059341,179912,1564,394,829,0x1Fa8559e873f698292766790AeCf8080A66433F6,0x800369f4eFBB886717D3cFF984446494C90146A4
10354,15627900,181422,11355059341,179894,1528,394,1248,0x1Fa8559e873f698292766790AeCf8080A66433F6,0x6F28Ca76A3499f882B2f57C0B4fCFC0034fa5AD6
10355,15627900,127866,11355059341,127262,604,202,8,0x084b1c3C81545d370f3634392De611CaaBFf8148,0x456F7A537DB9D10A2EFE1888015023F7AC7565C0
10356,15627900,229641,11355059341,229437,204,74,42,0x5DAC20CEabd1cfC989Ab4C48AF95e563631556c9,0x425E5c03ba731806191404359A5402A96A22745f
10357,15627900,181476,11355059341,179912,1564,394,23,0x1Fa8559e873f698292766790AeCf8080A66433F6,0x6705E582716b0cFf433f1a568623B6FBA41ebB82
10358,15627900,181476,11355059341,179912,1564,394,252,0x1Fa8559e873f698292766790AeCf8080A66433F6,0x356e92663875aF45bf85eF664d188F5eb089382D
10359,15627900,181476,11355059341,179912,1564,394,348,0x1Fa8559e873f698292766790AeCf8080A66433F6,0xF93d1397F2f245F6d602fa199D5E5C1cE17026bf
10360,15627900,113310,11355059341,113106,204,74,386,0x5D004ddB5D92938dAF8448b9eac1CaA593cd26Ca,0x26DC5D39Bd7A8bc2d792dcAAAC55FE6DCef25593
10361,15627900,181476,11355059341,179912,1564,394,140,0x1Fa8559e873f698292766790AeCf8080A66433F6,0x9cd8D7D750c5B566Af60f5c684Cbb39B7790c2BD
10362,15627900,297068,11355059341,293296,3772,970,106635,0xa57Bd00134B2850B2a1c55860c9e9ea100fDd6CF,0x9AAb3F81604c683a1a0D14019FBfe15bef7aA1ee
10363,15627900,112884,11355059341,112820,64,10,30,0xb55e1442EDA37d31249f97b3fCA6DEF588346FeF,0xbFD0496bDF244105b7C35313BACfdDD0C2d14900
10364,15627900,181458,11355059341,179906,1552,394,381,0x1Fa8559e873f698292766790AeCf8080A66433F6,0x63a560E2929DD0D6f72d342700959AE41B34D004
10365,15627900,113310,11355059341,113106,204,74,387,0x5D004ddB5D92938dAF8448b9eac1CaA593cd26Ca,0x26DC5D39Bd7A8bc2d792dcAAAC55FE6DCef25593
10366,15627900,121018,11355059341,120446,572,138,43,0x1748B24faf9780B74E5A9f3Feb41553E712E94aa,0x6819eA7792CC89394fEEE84FC70d54a67cD0B765
10367,15627900,113310,11355059341,113106,204,74,388,0x5D004ddB5D92938dAF8448b9eac1CaA593cd26Ca,0x26DC5D39Bd7A8bc2d792dcAAAC55FE6DCef25593
10368,15627900,181476,11355059341,179912,1564,394,40,0x1Fa8559e873f698292766790AeCf8080A66433F6,0x9283f9d6e70522B9f7800bB0a916F9F6643079CB
10369,15627900,181476,11355059341,179912,1564,394,4565,0x1Fa8559e873f698292766790AeCf8080A66433F6,0x6E5c200A784ba062ab770E6d317637F2fC82E53d
10370,15627900,181476,11355059341,179912,1564,394,3,0x1Fa8559e873f698292766790AeCf8080A66433F6,0x4f814b4ED5f19DAF5B52A43748DdbDc3FdC70236
10371,15627900,181476,11355059341,179912,1564,394,587,0x1Fa8559e873f698292766790AeCf8080A66433F6,0x65A5Dae5EF5a6b4715960ac59baf04c596Ef0106
10372,15627900,269209,11355059341,265189,4020,1226,162,0x68b3465833fb72A70ecDF485E0e4C7bD8665Fc45,0xb46474ED447403367b6fB561B353C1C5995f059F
10373,15627900,51288,11201676333,50344,944,138,637,0xeE3FC268418f54cFEb7817cc52C642489A5DF098,0xbB16B9DD8d06231A4Fd7403cA2BD38EaB20C062B
10374,15627900,70000,11185833622,69392,608,138,99,0xdAC17F958D2ee523a2206206994597C13D831ec7,0x728bA9158AF8de8157C6480840d287b872908238
10375,15627900,55965,11000000000,55021,944,138,8,0xAc8cC32Fab2368a1A095722AAf760C45f578E17B,0xF05E2Cc9393f53C7b0bd9909027E52b47CcFd20E
10376,15627900,305446,11000000000,303098,2348,522,4,0x283Af0B28c62C092C9727F1Ee09c02CA627EB7F5,0xEb6daC872b9afdAE8B5c655b710C230A2f8CFf35
10377,15627900,90000,10590981166,90000,0,2,154378,0x4A196Dea7D3ea9eE7Fec185f4d9d356ad65cDB8d,0xCBD6832Ebc203e49E2B771897067fce3c58575ac
10378,15627900,46581,10590981166,45637,944,138,292,0xFDBf91A7F2d757A9815326af5E1e60319571984c,0xA4F52138B57D3F3225D917dEF563300e35e81198
10379,15627900,79021,10590981166,75973,3048,650,131318,0x1531b6e3d51BF80f634957dF81A990B92dA4b154,0xCb6Ed7E78d27FDff28127F9CbD61d861F09a2324
10380,15627900,90000,10590981166,90000,0,2,154379,0x1664aF12A701D2D49d28c1D56F0facc8d68bb4B0,0xCBD6832Ebc203e49E2B771897067fce3c58575ac
10381,15627900,26000,10355059341,26000,0,2,12032,0xdDf4C5025D1A5742cF12F74eEC246d4432c295e4,0xDAFEA492D9c6733ae3d56b7Ed1ADB60692c98Bc5
10382,15627901,650000,31157094596,649056,944,138,247,0xFDBf91A7F2d757A9815326af5E1e60319571984c,0xe715d5FaDD5E475F3d3a629c3056F49a4a2ECB14
10383,15627901,79999,13861235762,79331,668,138,355160,0xc944E90C64B2c07662A292be6244BDf05Cda44a7,0x7abE0cE388281d2aCF297Cb089caef3819b13448
10384,15627901,21000,12310000000,21000,0,2,0,0x6dfc34609a05bC22319fA4Cce1d1E2929548c0D7,0xA80A38c11a5319e44752a879EBA889880F75d42F
10385,15627901,193036,12157094596,186460,6576,1802,3371,0x00000000006c3852cbEf3e08E8dF289169EdE581,0xAD950bABed19971577dac5A7eb662923Da771EED
10386,15627901,181476,12000000000,179912,1564,394,140,0x1Fa8559e873f698292766790AeCf8080A66433F6,0x9f132b503f9c89c2161090e67874d1a989fafE55
10387,15627901,204919,11657094596,202135,2784,842,264,0x68b3465833fb72A70ecDF485E0e4C7bD8665Fc45,0x26e35CDb264614d6843B57D444082EA62709c4f9
10388,15627901,58862,11657094596,52558,6304,2122,15,0x00000000006c3852cbEf3e08E8dF289169EdE581,0xc6F708C3335c7792753135b0B7C4dB0Ef3b33afC
10389,15627901,21000,11657094596,21000,0,2,2320,0x52579f87Cc8565E5AA3766328eEF015aa8797D15,0x87CEF391361A4168148333332fBd5D2C621D3252
10390,15627901,21000,11657094596,21000,0,2,11,0x430e48e58B91E35135a6066D6D6591f1dE9Eec61,0xb2B81051EBECf4de4fa2BC3dff2014198551F051
10391,15627901,248067,11657094596,247635,432,74,2,0x6e9B4c2f6Bd57b7b924d29b5dcfCa1273Ecc94A2,0xEF7050EDC2a1F26f4996acF8aEA6ACb11a5e1113
10392,15627901,181476,11657094596,179912,1564,394,66,0x1Fa8559e873f698292766790AeCf8080A66433F6,0x97b5Facb73baC72888aCC59b9d5c36A62a5a26D9
10393,15627901,52872,11657094596,51920,952,202,30,0x83565d91809Ab9c0D4d4d5a74610095264aBa4Ce,0x7542eB9FA33Cd07EFf75D20F0dC4015321546F85
10394,15627901,238934,11657094596,236162,2772,842,1138,0x68b3465833fb72A70ecDF485E0e4C7bD8665Fc45,0x6d01af8711133DEE2B2edfC54DC6Ce38223f8396
10395,15627901,46267,11657094596,45691,576,74,11,0x283Af0B28c62C092C9727F1Ee09c02CA627EB7F5,0xb1c8E569b88eF7813a13862873FB9EBCb7E9B8Bd
10396,15627901,160196,11657094596,153580,6616,1810,454,0x00000000006c3852cbEf3e08E8dF289169EdE581,0xcd1fAA80b3292E16347F31590018446552C6708f
10397,15627901,113310,11157094596,113106,204,74,389,0x5D004ddB5D92938dAF8448b9eac1CaA593cd26Ca,0x26DC5D39Bd7A8bc2d792dcAAAC55FE6DCef25593
10398,15627901,238963,11157094596,236167,2796,842,26,0x68b3465833fb72A70ecDF485E0e4C7bD8665Fc45,0x2fA0B9742959a087C4B2451442725bd251E10dE7
10399,15627902,500000,100000000000,499056,944,138,7511,0x6097004C68F7B350d72226003226Ac089597D579,0xC5C018EDb7Ec3e4217728C1e1F608b28057Dd507
10400,15627902,342689,97034203750,340725,1964,522,14,0x7a250d5630B4cF539739dF2C5dAcb4c659F2488D,0x05Dbd7D3806b27eeAf809C7fFCe8E5711a193354
10401,15627902,70000,90000000000,69404,596,138,1,0xdAC17F958D2ee523a2206206994597C13D831ec7,0xB93791a16E69750d1A989Dd15C4c2eC099bF14a8
10402,15627902,328185,39034203750,326125,2060,522,110,0x7a250d5630B4cF539739dF2C5dAcb4c659F2488D,0xA7201CDA5d825ffc74360E8CBe8Ee04D52a0f6F6
10403,15627902,800000,34034203750,798036,1964,522,7873,0x7a250d5630B4cF539739dF2C5dAcb4c659F2488D,0xbCb05a3F85d34f0194C70d5914d5C4E28f11Cc02
10404,15627902,650000,30034203750,649056,944,138,933,0xFDBf91A7F2d757A9815326af5E1e60319571984c,0x6D8E9842D102d652b6eA333B028458f1Ef945C7F
10405,15627902,650000,30034203750,649056,944,138,3375,0xFDBf91A7F2d757A9815326af5E1e60319571984c,0x2Dfd7946a6D8cA71ae48c307518ACC7aF5407dd5
10406,15627902,56130,20000000000,54770,1360,394,112,0xc36cF0cFcb5d905B8B513860dB0CFE63F6Cf9F5c,0xbFec193FA1824f2E54867353b1580B0b1C7CEf21
10407,15627902,21000,18200000000,21000,0,2,1,0x500A746c9a44f68Fe6AA86a92e7B3AF4F322Ae66,0xf73970DFAbb60267ebd236535075037Ef4922678
10408,15627902,5049560,17000000000,5042424,7136,1098,299,0x0a39DA505DfB5E0BBc6bd84428281A8ba1bC7753,0x495E889d1A6cEB447a57dcc1C68410299392380c
10409,15627902,100000,15589524631,99356,644,138,2101,0xFDBf91A7F2d757A9815326af5E1e60319571984c,0x81E805660B2b43d582372BECc06Ae504f788E8Ce
10410,15627902,92997,15484370058,92389,608,138,0,0xdAC17F958D2ee523a2206206994597C13D831ec7,0xb2F6965cfF1e63f1319E9D7AC0A2c28B0AAeEDce
10411,15627902,750000,14034203750,749056,944,138,283,0x6097004C68F7B350d72226003226Ac089597D579,0xA02468fF43E56dcE88Ce5a55E560b7812bBf82C4
10412,15627902,21000,14000000000,21000,0,2,1,0x500A746c9a44f68Fe6AA86a92e7B3AF4F322Ae66,0x5E8c8c17802a9472b75892A7Cdd665842C61cE88
10413,15627902,21000,14000000000,21000,0,2,2730,0x37Bf54A1bAA1C555B1F89c12A66EA25f898CC8aC,0x1243D01e42eEF90C72d88e665647dd50b0f49f6D
10414,15627902,50000,13768275515,50000,0,2,476123,0xdBCa2AA02BC73d7D681c013d7c34391d07eaFD39,0x4d846dA8257BB0Ebd164EFf513DfF0F0c2C3c0ba
10415,15627902,80000,13500000000,80000,0,2,6595,0x4e7C7724C49BFE1229027D86006737398bdF48Ed,0x3DE0cFe6985A95Cc9CB69c056b9d210418a1E1F4
10416,15627902,300014,13034203750,297558,2456,714,224459,0x98C3d3183C4b8A650614ad179A1a98be0a8d6B8E,0x91aaE0aAfd9D2d730111b395c6871f248d7Bd728
10417,15627902,300014,13034203750,297546,2468,714,134157,0x98C3d3183C4b8A650614ad179A1a98be0a8d6B8E,0x8e8f818d3371F797A2Db7eDB32803607c8b3c6A9
10418,15627902,181476,13000000000,179912,1564,394,490,0x1Fa8559e873f698292766790AeCf8080A66433F6,0xF05610F7AFE458dDc5ee955F0291f50D4A6f9A78
10419,15627902,21000,13000000000,21000,0,2,705893,0xCdDE392A0c86a9eFc82d190723d75F1E36a6DEBe,0x6dfc34609a05bC22319fA4Cce1d1E2929548c0D7
10420,15627902,84522,12792418625,83486,1036,202,4709942,0x016ee7373248a80BDe1fD6bAA001311d233b3CFa,0x2FAF487A4414Fe77e2327F0bf4AE2a264a776AD2
10421,15627902,84276,12792418625,83300,976,202,4709943,0xA0b86991c6218b36c1d19D4a2e9Eb0cE3606eB48,0x2FAF487A4414Fe77e2327F0bf4AE2a264a776AD2
10422,15627902,69084,12792418625,68060,1024,202,4709944,0xdBdb4d16EdA451D0503b854CF79D55697F90c8DF,0x2FAF487A4414Fe77e2327F0bf4AE2a264a776AD2
10423,15627902,63000,12792418625,63000,0,2,2710064,0x9dEB8BfD9e74004a4c57926d4DF70ffeBB42d205,0xC098B2a3Aa256D2140208C3de6543aAEf5cd3A94
10424,15627902,21000,12533682424,21000,0,2,0,0x4e237AB9fE2b5801Be6DD90ce33ef523f6046029,0x76ad7898b34AD7F85D8f79E162821810Bae9F241
10425,15627902,21000,12317465307,21000,0,2,5,0xB3f6657C46AD806B4f5095c8d6A0566a8B156F7D,0x9ba6992A94D0618ab9b307AF1A2C388f530693c5
10426,15627902,21000,12162164692,21000,0,2,2,0x25eAff5B179f209Cf186B1cdCbFa463A69Df4C45,0xDFE78941ec18C55f1061e49A9C4d71F20266f2Cc
10427,15627902,181476,12034203750,179912,1564,394,148,0x1Fa8559e873f698292766790AeCf8080A66433F6,0x95441aE2bb3D7a7f8bea0c62b61866e07ce8e28c
10428,15627902,297247,12034203750,295679,1568,402,1361,0x1111111254fb6c44bAC0beD2854e76F90643097d,0xb615928b8545ED42F5699CA049fee81FE991CC2A
10429,15627902,21000,11656357708,21000,0,2,19,0xc581481E5c1958855b5C5FacC103cFF8d110585A,0x84CFc25eA3E078BED03F09DbAE222C1E9356c1a7
10430,15627902,70824,11534203750,69880,944,138,30,0x12b6893cE26Ea6341919FE289212ef77e51688c8,0xC8A1768652cFD807a252Cc94DA60EDeB3B04b5d5
10431,15627902,143796,11534203750,143592,204,74,133,0x7F9306FC1978938d5C1C57Bf6044dc67E07eeB8a,0x79431D179b7e278860D2C3cef725A087c4d9be26
10432,15627902,800000,11534203750,798188,1812,458,374,0x7a250d5630B4cF539739dF2C5dAcb4c659F2488D,0x6B485D535E2e6116F82576024B6fEa09b9E1D693
10433,15627902,800000,11534203750,799056,944,138,130,0xFDBf91A7F2d757A9815326af5E1e60319571984c,0xe001b672D7e2E779fDc34D0E69bB223994621403
10434,15627902,305884,11534203750,298908,6976,970,569,0x9b3B6974531d8AA15A87908FFd821A64863Ede5B,0xD4AEd5d2b12B65489B9890B53bB4a87cef602eF3
10435,15627902,21000,11532824145,21000,0,2,1569070,0xb8bE8f2d7Bb8a309A3C85ca2474CA2a07018A52a,0xAe45a8240147E6179ec7c9f92c5A18F9a97B3fCA
10436,15627902,21000,11532824145,21000,0,2,1569071,0xBAd0880CaA4421E104BC09F2057405d8b792DA44,0xAe45a8240147E6179ec7c9f92c5A18F9a97B3fCA
10437,15627902,21000,11532824145,21000,0,2,1569072,0xd1C3a47798f84aAA3DFB4c021EFf7df83f6D1F2d,0xAe45a8240147E6179ec7c9f92c5A18F9a97B3fCA
10438,15627902,21000,11532824145,21000,0,2,1569073,0x8F2B3A434B746c55c5dba065d58C69c4dE35b161,0xAe45a8240147E6179ec7c9f92c5A18F9a97B3fCA
10439,15627902,28920,11034203750,28668,252,74,72,0x17C8F5aE96487967CE72E78a2A52E0711A87772E,0xBa412D28e82D6f087C7D155c5875A46C97a82442
10440,15627902,207128,11034203750,207128,0,2,1312161,0x3CC7DE063Ce2734469A3dc12E1a2379324ed107f,0xf60c2Ea62EDBfE808163751DD0d8693DCb30019c
10441,15627902,207128,11034203750,206484,644,138,1312162,0x95aD61b0a150d79219dCF64E1E6Cc01f0B64C4cE,0xf60c2Ea62EDBfE808163751DD0d8693DCb30019c
10442,15627902,221731,11034203750,217039,4692,1484,220,0x881D40237659C251811CEC9c364ef91dC08D300C,0x6c7C127EDfccb1288936b2df71293DB41DD021A0
10443,15627902,21000,11034203750,21000,0,2,72348,0xEfD2A7811a4e1239ff36Cca576ddDadC1D684C45,0xab97925eB84fe0260779F58B7cb08d77dcB1ee2B
10444,15627902,39617,11034203750,39353,264,74,694,0xC02aaA39b223FE8D0A0e5C4F27eAD9083C756Cc2,0xdBfd836c989E1FE9586cB0D1BFB35E7849Be23a5
10445,15627902,181476,11034203750,179912,1564,394,296,0x1Fa8559e873f698292766790AeCf8080A66433F6,0x528502Cfc640fdB4eC2349AB2A9645236b12b23B
10446,15627902,80000,11034203750,79392,608,138,568593,0xdAC17F958D2ee523a2206206994597C13D831ec7,0xB02f1329d6a6AcEF07a763258f8509c2847A0a3E
10447,15627902,207128,11034203750,207128,0,2,1679538,0x92965060E73B18ae94473CeC1b0CE8EA30E3FD6B,0x4976A4A02f38326660D17bf34b431dC6e2eb2327
10448,15627902,207128,11034203750,207128,0,2,4468967,0xce63fB7f032568057AaC5a37CD95642f5cFD967F,0x21a31Ee1afC51d94C2eFcCAa2092aD1028285549
10449,15627902,207128,11034203750,207128,0,2,3492290,0xDB5fC9080e87eA7C79fED93aB700a3f0DA094CF3,0x56Eddb7aa87536c09CCc2793473599fD21A8b17F
10450,15627902,207128,11034203750,206520,608,138,3199185,0xdAC17F958D2ee523a2206206994597C13D831ec7,0x9696f59E4d72E237BE84fFD425DCaD154Bf96976
10451,15627902,207128,11034203750,206544,584,138,4708716,0xA0b86991c6218b36c1d19D4a2e9Eb0cE3606eB48,0x28C6c06298d514Db089934071355E5743bf21d60
10452,15627902,42000,11034203750,42000,0,2,329557,0x06c7bb4B533131C08f95a1E7Cfb2f9812f7769bD,0x9430801EBAf509Ad49202aaBC5F5Bc6fd8A3dAf8
10453,15627902,181476,11034203750,179912,1564,394,1980,0x1Fa8559e873f698292766790AeCf8080A66433F6,0x07D7ad96fD130C88fFB995078fc82C5701c55cE3
10454,15627902,207128,11034203750,206520,608,138,3492291,0xdAC17F958D2ee523a2206206994597C13D831ec7,0x56Eddb7aa87536c09CCc2793473599fD21A8b17F
10455,15627902,207128,11034203750,206532,596,138,4708717,0x9BE89D2a4cd102D8Fecc6BF9dA793be995C22541,0x28C6c06298d514Db089934071355E5743bf21d60
10456,15627902,207128,11034203750,206532,596,138,4468968,0xdAC17F958D2ee523a2206206994597C13D831ec7,0x21a31Ee1afC51d94C2eFcCAa2092aD1028285549
10457,15627902,207128,11034203750,207128,0,2,3199186,0x469eb553FBC939Ce31ed044ce9E28b83b59bAe74,0x9696f59E4d72E237BE84fFD425DCaD154Bf96976
10458,15627902,238963,11034203750,236167,2796,842,1309,0x68b3465833fb72A70ecDF485E0e4C7bD8665Fc45,0xBB14E70d0dBeE8B4BCf1b13A0a175075d4A274DB
10459,15627902,41814,11034203750,41182,632,138,21,0x4a220E6096B25EADb88358cb44068A3248254675,0xC1Cf310a78B480a9c013721833D5Bda95e8dfA62
10460,15627902,90000,11034203750,89392,608,138,5,0xdAC17F958D2ee523a2206206994597C13D831ec7,0xEfD2A7811a4e1239ff36Cca576ddDadC1D684C45
10461,15627902,240444,11034203750,237684,2760,842,14497,0x68b3465833fb72A70ecDF485E0e4C7bD8665Fc45,0x0caC9C3D7196f5BbD76FaDcd771fB69b772c0F9d
10462,15627902,140088,11034203750,138524,1564,394,51,0x1Fa8559e873f698292766790AeCf8080A66433F6,0x98888e0d53503159a6cbd6f5D81F752361Cf9ea6
10463,15627902,151762,11034203750,150198,1564,394,35,0x1Fa8559e873f698292766790AeCf8080A66433F6,0x06Ba29f1274eE84D2Fb286899aCdCA60b973A3F6
10464,15627902,151730,11034203750,150190,1540,394,32,0x1Fa8559e873f698292766790AeCf8080A66433F6,0x40004dbBFE8eA0f74A555E28C9485CF2a2e29391
10465,15627902,151762,11034203750,150198,1564,394,29,0x1Fa8559e873f698292766790AeCf8080A66433F6,0x7115FB075ca1b21455A960a781876896Da9afa6E
10466,15627902,151762,11034203750,150198,1564,394,34,0x1Fa8559e873f698292766790AeCf8080A66433F6,0x5c7D599930d3Af12c94f6eE64AC306A6bD75929c
10467,15627902,151762,11034203750,150198,1564,394,50,0x1Fa8559e873f698292766790AeCf8080A66433F6,0x2E64379e2DF8c7b4866221897ea43086609e259b
10468,15627902,151762,11034203750,150198,1564,394,53,0x1Fa8559e873f698292766790AeCf8080A66433F6,0x427e3b6B92047525fA57a9EBa4bcF3CFA7E93B76
10469,15627902,151762,11034203750,150198,1564,394,50,0x1Fa8559e873f698292766790AeCf8080A66433F6,0x1E038657Ea428884702a92fCF966C58e9BCF8Fea
10470,15627902,151762,11034203750,150198,1564,394,49,0x1Fa8559e873f698292766790AeCf8080A66433F6,0x17e48EfdF060E092439C9cf01E622a7cFA350C9A
10471,15627902,151762,11034203750,150198,1564,394,50,0x1Fa8559e873f698292766790AeCf8080A66433F6,0xb9A47d9ca323A85FaF2B0F93Ff66a30b54154Cb3
10472,15627902,151762,11034203750,150198,1564,394,47,0x1Fa8559e873f698292766790AeCf8080A66433F6,0xE8F55527EeE31e930f6a836905A652a7E85c5642
10473,15627902,151746,11034203750,150194,1552,394,61,0x1Fa8559e873f698292766790AeCf8080A66433F6,0xa417a2BAcC42c946b2B02df2D062C9dFB84F96db
10474,15627902,151746,11034203750,150194,1552,394,34,0x1Fa8559e873f698292766790AeCf8080A66433F6,0x42F8055aC0b35Ed219e88185c988d3265ec214a3
10475,15627902,151746,11034203750,150194,1552,394,30,0x1Fa8559e873f698292766790AeCf8080A66433F6,0xc807806c0Bc4a6D7658f15B837006e46809ddfe0
10476,15627902,151762,11034203750,150198,1564,394,33,0x1Fa8559e873f698292766790AeCf8080A66433F6,0x9401877a544F1D146D142bb972F4e21b4B40A443
10477,15627902,151762,11034203750,150198,1564,394,53,0x1Fa8559e873f698292766790AeCf8080A66433F6,0x63F3125e1cb34940Ef421Ac7024dfAE2Bae9eFfE
10478,15627902,151762,11034203750,150198,1564,394,34,0x1Fa8559e873f698292766790AeCf8080A66433F6,0x7886AEeFE5D83e4026A79e244E7397C7dC3AaCc9
10479,15627902,151762,11034203750,150198,1564,394,29,0x1Fa8559e873f698292766790AeCf8080A66433F6,0x291430f8118c6640950AcB24AD791Cfc3c2D2C2B
10480,15627902,151730,11034203750,150190,1540,394,34,0x1Fa8559e873f698292766790AeCf8080A66433F6,0xbd4942F80089C62Dc300E67107F57dF15Ef55f5f
10481,15627902,151730,11034203750,150190,1540,394,47,0x1Fa8559e873f698292766790AeCf8080A66433F6,0xA060569D45Ced2abb1667b76Ce2E5b76af8ECD54
10482,15627902,151746,11034203750,150194,1552,394,30,0x1Fa8559e873f698292766790AeCf8080A66433F6,0x1f2207Fbb70065f6E68122aAF3db6dBf20a84b01
10483,15627902,151746,11034203750,150194,1552,394,34,0x1Fa8559e873f698292766790AeCf8080A66433F6,0xBEA5738EA98fA40D1D99F35Ed9330C302D38695a
10484,15627902,151746,11034203750,150194,1552,394,32,0x1Fa8559e873f698292766790AeCf8080A66433F6,0xDFa917C2AD188362d62Ca0004DC20bd40b4960Bb
10485,15627902,151762,11034203750,150198,1564,394,30,0x1Fa8559e873f698292766790AeCf8080A66433F6,0xB1A4Ba051041c3914bda669aF67522428cB4b43f
10486,15627902,151762,11034203750,150198,1564,394,34,0x1Fa8559e873f698292766790AeCf8080A66433F6,0x3aCA95154805f1A13B8B22E465B26A1FEFf4bd67
10487,15627902,151762,11034203750,150198,1564,394,31,0x1Fa8559e873f698292766790AeCf8080A66433F6,0x33a8eccd396BefA2279d834253F4CDfe2583C30f
10488,15627902,151762,11034203750,150198,1564,394,57,0x1Fa8559e873f698292766790AeCf8080A66433F6,0x082b839446142De3e7A2cb10907Ff07562F72946
10489,15627902,151762,11034203750,150198,1564,394,28,0x1Fa8559e873f698292766790AeCf8080A66433F6,0x5A82e584747c958fd2F768E8B9Aa940A12909516
10490,15627902,151746,11034203750,150194,1552,394,59,0x1Fa8559e873f698292766790AeCf8080A66433F6,0x94D83eeF2a8b98dDF49270db8629303DbEEd6aF7
10491,15627902,151762,11034203750,150198,1564,394,52,0x1Fa8559e873f698292766790AeCf8080A66433F6,0xf7ae036d7a1f2C2783d260A54281DE7635ccf57a
10492,15627902,151746,11034203750,150194,1552,394,35,0x1Fa8559e873f698292766790AeCf8080A66433F6,0x452e71cbAD1738d51A18919B5f7543b5E1380096
10493,15627902,151762,11034203750,150198,1564,394,59,0x1Fa8559e873f698292766790AeCf8080A66433F6,0x1F0205A06ffF6e43Ce96a543667E8a1A7129604D
10494,15627902,151762,11034203750,150198,1564,394,63,0x1Fa8559e873f698292766790AeCf8080A66433F6,0xaDC0093f99f9bAD33A640Ac5FC9c4F6b2618403F
10495,15627902,151730,11034203750,150190,1540,394,30,0x1Fa8559e873f698292766790AeCf8080A66433F6,0xe6f0558C64D2564EDf12B3b308576300009069e0
10496,15627902,151762,11034203750,150198,1564,394,57,0x1Fa8559e873f698292766790AeCf8080A66433F6,0xCCA5EdE732cbd6d6744012Ed17Be092291fdf7c9
10497,15627902,151762,11034203750,150198,1564,394,35,0x1Fa8559e873f698292766790AeCf8080A66433F6,0xD553d1db29658B54CA98894fE349B5142c8526D4
10498,15627902,151762,11034203750,150198,1564,394,52,0x1Fa8559e873f698292766790AeCf8080A66433F6,0xa1FBdf56Ba5fB957045d790ec3d3DDe0e84E6af7
10499,15627902,151762,11034203750,150198,1564,394,62,0x1Fa8559e873f698292766790AeCf8080A66433F6,0xcCA2B180b980a6DF810fa49dc4AafC0E1BF7eeEf
10500,15627902,151762,11034203750,150198,1564,394,29,0x1Fa8559e873f698292766790AeCf8080A66433F6,0x42294A40B1Da05FFBbD251E5905F596A48B134B3
10501,15627902,151746,11034203750,150194,1552,394,28,0x1Fa8559e873f698292766790AeCf8080A66433F6,0x381BD7bfC6E851729ccF8eBF69B8e9CC77630024
10502,15627902,151762,11034203750,150198,1564,394,32,0x1Fa8559e873f698292766790AeCf8080A66433F6,0x3b030c18095272e2819Bfe2C62D7a988f5aD9129
10503,15627902,151762,11034203750,150198,1564,394,34,0x1Fa8559e873f698292766790AeCf8080A66433F6,0xBA11E791e735E7F75414af0Ad0D91f8aeDB6b394
10504,15627902,151762,11034203750,150198,1564,394,29,0x1Fa8559e873f698292766790AeCf8080A66433F6,0xF2c12E25dABFCb950AA153AEcbfaCDbCd360eAc1
10505,15627902,151762,11034203750,150198,1564,394,29,0x1Fa8559e873f698292766790AeCf8080A66433F6,0xeed6fdF8477944739aBb5B4eBCC43aF11c278468
10506,15627902,151762,11034203750,150198,1564,394,30,0x1Fa8559e873f698292766790AeCf8080A66433F6,0x20E9f5a902aef0c4b9A8853a1273955D28B428f8
10507,15627902,151762,11034203750,150198,1564,394,27,0x1Fa8559e873f698292766790AeCf8080A66433F6,0x95C6115c88e269953EF8E184bb18d13C056C4Df0
10508,15627902,151762,11034203750,150198,1564,394,32,0x1Fa8559e873f698292766790AeCf8080A66433F6,0x0D210Bbdfb8c128EACbEB92709373A0c0A65f779
10509,15627902,151762,11034203750,150198,1564,394,28,0x1Fa8559e873f698292766790AeCf8080A66433F6,0x7bED4023D91c033678e2d2F0d73178657d17F725
10510,15627902,151746,11034203750,150194,1552,394,30,0x1Fa8559e873f698292766790AeCf8080A66433F6,0x06c1e3839A10F18A1b30A58DF7AF63e85c02015E
10511,15627902,151762,11034203750,150198,1564,394,31,0x1Fa8559e873f698292766790AeCf8080A66433F6,0x16847b69331986948b1577242aca635C92092ACF
10512,15627902,151762,11034203750,150198,1564,394,30,0x1Fa8559e873f698292766790AeCf8080A66433F6,0x85EDA026677584945ac9c6d7268d82ae7A6FF75F
10513,15627902,151762,11034203750,150198,1564,394,28,0x1Fa8559e873f698292766790AeCf8080A66433F6,0x609b8Dded473209E09874fD61FE2D1AA3F25E2F3
10514,15627902,151762,11034203750,150198,1564,394,27,0x1Fa8559e873f698292766790AeCf8080A66433F6,0xe4d598E2aE62882C61E85876Dd0A13130c225d31
10515,15627902,151762,11034203750,150198,1564,394,35,0x1Fa8559e873f698292766790AeCf8080A66433F6,0xDcB787308da09E1f3d22c78f869216512DCD01a1
10516,15627902,151762,11034203750,150198,1564,394,27,0x1Fa8559e873f698292766790AeCf8080A66433F6,0x169b029A83621e9362524f3AE8f18C1dC192Dd2e
10517,15627902,151762,11034203750,150198,1564,394,60,0x1Fa8559e873f698292766790AeCf8080A66433F6,0x0F25e33EE66f806aBFBed68F7Eb48443a1A9fF1A
10518,15627902,151746,11034203750,150194,1552,394,35,0x1Fa8559e873f698292766790AeCf8080A66433F6,0xaf30C4586dA17D02012CF38700927fa6B763fbFa
10519,15627902,151762,11034203750,150198,1564,394,32,0x1Fa8559e873f698292766790AeCf8080A66433F6,0x3E153C20F01cB241Ed6fdc832486D4191ce0281F
10520,15627902,151762,11034203750,150198,1564,394,33,0x1Fa8559e873f698292766790AeCf8080A66433F6,0xA1078830f08Ff84f33eFF982f0743818a776808B
10521,15627902,151762,11034203750,150198,1564,394,28,0x1Fa8559e873f698292766790AeCf8080A66433F6,0xFDB4cC95141344Ba5a79032BC56F633c598B1f25
10522,15627902,689810,11034203750,686146,3664,1162,1609,0x68b3465833fb72A70ecDF485E0e4C7bD8665Fc45,0xA59b9ECE9262D547a13f46B8E4f74E56ACAB75Dc
10523,15627902,181476,11034203750,179912,1564,394,166,0x1Fa8559e873f698292766790AeCf8080A66433F6,0xE031ad49af943cd290cc39952Bf6a3Ce83C98bb5
10524,15627902,236566,11034203750,233326,3240,1034,34,0x68b3465833fb72A70ecDF485E0e4C7bD8665Fc45,0xFA8d34117DE3Ac22859CD22055fD9F7336CcE1F8
10525,15627902,238963,11034203750,236167,2796,842,154,0x68b3465833fb72A70ecDF485E0e4C7bD8665Fc45,0x4d7618a7a2A8CE5155986841ad09cb1e003D87Ef
10526,15627902,50000,11034203750,49056,944,138,0,0xdAC17F958D2ee523a2206206994597C13D831ec7,0x244Ee4dCd080d136107C0BD5b32d8Eea7d399392
10527,15627902,70000,11034203750,69056,944,138,9,0xdAC17F958D2ee523a2206206994597C13D831ec7,0x32c808b2dCB311C562C3fb549FE2fbEbc3383457
10528,15627902,181476,11034203750,179912,1564,394,173,0x1Fa8559e873f698292766790AeCf8080A66433F6,0x6a8a2749B1Cadb931fB06Bf4A48B15fa47Fb9CC8
10529,15627902,175074,11034203750,173534,1540,394,17634,0x1Fa8559e873f698292766790AeCf8080A66433F6,0x6EEf09B526d883F98762a7005FABD2c800DfCA44
10530,15627902,181476,11000000000,179912,1564,394,749,0x1Fa8559e873f698292766790AeCf8080A66433F6,0x40F9A1fDd1b2D09066a0B979C5f36f09c551AD42
10531,15627902,191041,11000000000,190165,876,266,1402,0xd588b586D61C826A0e87919b3D1a239206d58bf2,0xC22d03e13B888Dabb33A1575e4F6542f0e996622
10532,15627902,149081,11000000000,147117,1964,522,24,0x7a250d5630B4cF539739dF2C5dAcb4c659F2488D,0x20383b886B2B82C7Ba29a3c5dF85b0f47502e494
10533,15627902,283165,11000000000,280961,2204,522,1135,0x7a250d5630B4cF539739dF2C5dAcb4c659F2488D,0xecDA2c559aDE78ff0A3B1e5cF0ECd0d23143827b
10534,15627902,120000,10680203750,119404,596,138,14037,0xdAC17F958D2ee523a2206206994597C13D831ec7,0xE291cc3e5b9e0C9b37c9FBDd549aBf3B5c0ad342
10535,15627902,80000,10590981166,79056,944,138,0,0xA0b86991c6218b36c1d19D4a2e9Eb0cE3606eB48,0x1C37426b96C4B83CDfFa9CF2E2D3eF08d701164a
10536,15627902,80000,10590981166,79056,944,138,1,0xA0b86991c6218b36c1d19D4a2e9Eb0cE3606eB48,0x1C37426b96C4B83CDfFa9CF2E2D3eF08d701164a
10537,15627902,80000,10590981166,79056,944,138,0,0xdAC17F958D2ee523a2206206994597C13D831ec7,0x727F81a59Ca78Ddd7e8B812fd885bD261D95B709
10538,15627902,23100,10590981166,23100,0,2,3,0x1C1e0bF4bd8640a0173E6f0Ee7d419dCdaeAAD59,0x1AC60D03a6bc28607552a7f66bfd9C273600a562
10539,15627902,21000,10590981166,21000,0,2,9,0xA88902d6E93922893EE77234ED1C3ba4Bec90224,0x4270cd21614B026D7c6106d4E54893980da2BF7a
10540,15627902,216673,10567695612,215225,1448,402,273,0x1111111254fb6c44bAC0beD2854e76F90643097d,0x85b90a9Aad3EEF15CEA4a57cc8c7a055eF3f3721
10541,15627902,21000,10535203750,21000,0,2,102643,0xbf9c65c108c45d37465be4d67ab729C0CEBbA44C,0x2Db1D8CdF1Abe8C70b531a790CDf2FF38aecF652
10542,15627902,262682,10534203751,260414,2268,650,100939,0xA69babEF1cA67A37Ffaf7a485DfFF3382056e78C,0x431B5A84aCC1297Eda88259f300262F1bc3A74f3
10543,15627902,429489,10534203750,429261,228,74,72,0x6c3810649c140d2f43Ec4D88B2f733e1375E4C74,0x06926D6F3812E34890f37ABDcE0A10a80af46f39
10544,15627902,577219,10534203750,574115,3104,714,30,0xC36442b4a4522E871399CD717aBDD847Ab11FE88,0xc01f46f418B9D9BACDCaf9453E8F0f1ca818C925
10545,15627902,197872,10534203750,191480,6392,2058,36,0x0000000000c2d145a2526bD8C716263bFeBe1A72,0xB2362053e77ceb3bFE79a0EF12959E847AB7415a
10546,15627902,216915,10534203750,216851,64,10,478,0xBBe3B63484345148D32feabE0912c308a60c879a,0xFC538FFD2923ddDaED09c8aD1a51686275C56183
10547,15627902,167261,10534203750,160685,6576,1802,53,0x00000000006c3852cbEf3e08E8dF289169EdE581,0x423a056d9AA86d9F215EDc0D6f11491dc7429F95
10548,15627902,296718,10534203750,293102,3616,1162,431,0x68b3465833fb72A70ecDF485E0e4C7bD8665Fc45,0xf43aBBD4E692702F20B244a41d0D0063cF7Ce710
10549,15627902,21000,10534203750,21000,0,2,10898,0x6c02C4b61bF2472c386eE5F0a87ccf0D0aEe064E,0xf2659A2b2B928a0555Bf1596eBf2c30Aa4b34A31
10550,15627902,46267,10534203750,45691,576,74,83,0x283Af0B28c62C092C9727F1Ee09c02CA627EB7F5,0x5C310539802035c4b04B95822224f95E3f3dDCe8
10551,15627902,46155,10534203750,45667,488,138,292,0x880af717abBA38F31Ca21673843636A355Fb45f3,0xA346C2615F70607F1973Caf6d45A26aF51089fe6
10552,15627902,247072,10534203750,244300,2772,842,12,0x68b3465833fb72A70ecDF485E0e4C7bD8665Fc45,0xF162fC5D1174449137E0536923495F3bD9a1380c
10553,15627902,94463,10534203750,94031,432,74,26,0xA0c68C638235ee32657e8f720a23ceC1bFc77C77,0xa90Bf92babEAe0591Da49448d7Ea317Fc7B95c47
10554,15627902,183727,10534203750,180955,2772,842,5,0x68b3465833fb72A70ecDF485E0e4C7bD8665Fc45,0x960F560D882e89e783F2a5Ece445F8441dD96eC1
10555,15627902,46185,10534203750,45697,488,138,187,0x9b3B6974531d8AA15A87908FFd821A64863Ede5B,0x9b4B81dB683D125c5F560AeA1051950f57873067
10556,15627902,51559,10534203750,51071,488,138,56,0xE6408dD80eE4d7596151EAd35B37bDF84d2A3B0F,0x9ae6F872bD544Cd20b7086Aab5E965C1E219348a
10557,15627902,181476,10534203750,179912,1564,394,560,0x1Fa8559e873f698292766790AeCf8080A66433F6,0x19Be73De77eaddAFDE6a80edb57bB8B7eAc2F275
10558,15627902,69163,10534203750,68555,608,138,527,0xdAC17F958D2ee523a2206206994597C13D831ec7,0x03A4518Ff4872850d82Dc41450E153AB0c37e6bb
10559,15627902,198142,10534203750,192074,6068,1674,6,0x921Fd42f147B26b51AA3c7fa3F2E2Ce7704c2858,0x671083d072Fe5F8A8AEcd532438efC325CC7ea49
10560,15627902,21000,10534203750,21000,0,2,178,0xE08701df8a6799aEcDC00AcACF19188e6Ae9E561,0xA443320Cd991724D4BBAb64Ed08ba2D4904c9472
10561,15627902,46529,10534203750,45585,944,138,10,0x2b591e99afE9f32eAA6214f7B7629768c40Eeb39,0x3461D827fE4a6eA5fcFEcAa3F6fc941D892703cb
10562,15627902,33552,10534203750,33348,204,74,310,0x20F780A973856B93f63670377900C1d2a50a77c4,0x4485dEa633cA375B0bc07970F7e231Fa21439FAD
10563,15627902,203029,10534203750,196441,6588,1802,162,0x00000000006c3852cbEf3e08E8dF289169EdE581,0xd3864619f41126760A213da2499cc55A25020683
10564,15627902,21000,10534203750,21000,0,2,22,0x443418a88f1DC044B69F85247e3285A2Bf1AbCb3,0x407b5D55A95c63462d9fdC233e4924A189482637
10565,15627902,51706,10534203750,51086,620,138,441,0x467719aD09025FcC6cF6F8311755809d45a5E5f3,0x2d31d56EDe06aF21Fd6eac97242351EC192e178E
10566,15627902,21000,10534203750,21000,0,2,248,0x0c6e2031dbB9f5260dA6af4c92785ba49Ad77282,0xE00b016815091B91Cf70BaE066b277243fA94990
10567,15627902,119605,10534203750,118653,952,394,692,0xbB2582a6eA2eb271bF37Ac0371d4356EF99Cb5B5,0xc339C1B4AD0260EcBCa9c2928311675CA6de4bEa
10568,15627902,250285,10534203750,246597,3688,1162,485,0x68b3465833fb72A70ecDF485E0e4C7bD8665Fc45,0x9908fbCc403A4E09A5E3Cc1fD8e64e1974ff7008
10569,15627902,129265,10534203750,128861,404,138,746,0xa7D8C4bc2bbE20ff6272f52C1917b8A91B4518CA,0x14F64b652948Ed2FEBde2517858644d5C15a6d7f
10570,15627902,547494,10534203750,542862,4632,1226,21,0xC36442b4a4522E871399CD717aBDD847Ab11FE88,0xDEB1195c419C54bC6a4dD55bb0D4fe9B18FA21F9
10571,15627902,117533,10534203750,117341,192,74,37,0xfc33E8b6E160A81DdB442B07355D01DF711EFEee,0x4aEAe5191e43A4D693C5ccf626e28caDD7D27723
10572,15627902,46547,10534203750,46059,488,138,211,0xaE351b8Ae55B69A5007618E598dDe89d0a092c37,0xa579F766406d0e18d8c7ff81d6e2db1dc3063943
10573,15627902,94813,10534203750,94205,608,138,1163,0xdAC17F958D2ee523a2206206994597C13D831ec7,0x1892538761C9cE1860c6888Ad404df42f907f1CE
10574,15627902,51643,10534203750,51071,572,138,57,0xE6408dD80eE4d7596151EAd35B37bDF84d2A3B0F,0x9ae6F872bD544Cd20b7086Aab5E965C1E219348a
10575,15627902,84354,10534203750,84150,204,74,41,0x9b9D659D4f2cF68b6616Cc0a65683f1951Eb725C,0xa04159bd2521f6d7Cd48083daD6c6c4D7dabCb7a
10576,15627902,52903,10534203750,52319,584,138,434,0xED5464bd5c477b7F71739Ce1d741b43E932b97b0,0x2Fa39Ec3e8d1314a28E8360FE1A3DC50088153CC
10577,15627902,46135,10534203750,45647,488,138,183,0x1Fa8559e873f698292766790AeCf8080A66433F6,0xebdB40f3c45c19f060e9413D8c7b93209d0F289c
10578,15627902,51492,10534203750,51004,488,138,0,0x406C60C2e8038a0E90D2f28efF7260CC7Af84EE6,0x9bC7795209442B5f8A08d36BC47F02967A7A0494
10579,15627902,31791,10534203750,31315,476,138,451,0x7f738Ad7072187909384B2ffBaEEdC3C1DA1b686,0xA2ED0D7C779D1Be821cB1FC1865C80e8fBddAb43
10580,15627902,21000,10534203750,21000,0,2,540,0xf4b2D9b91Bd2B4770b189F54caCc21d1920d0f93,0xaD5efb0A72254eCe67BAfdB22F18E439c42Bb02C
10581,15627902,46100,10534203750,45528,572,138,189,0x495f947276749Ce646f68AC8c248420045cb7b5e,0x91cd3aE885C86B8d840282f637F8BBefe3565050
10582,15627902,21000,10534203750,21000,0,2,1235,0x913a5b9dD577B278cd12b49935D82A250616a19d,0xb396D5EdcbFaB009cBF4602329371F908118d115
10583,15627902,221942,10534203750,203442,18500,4554,189,0x00000000006c3852cbEf3e08E8dF289169EdE581,0x0e662b85D7Fd9F677758bC2fC11f668CDf05f33f
10584,15627902,49259,10534203750,48687,572,138,3103,0x7f738Ad7072187909384B2ffBaEEdC3C1DA1b686,0xD498420B5fFe2093FA078C800b41e6782DF7a83A
10585,15627902,142968,10534203750,136380,6588,1802,343,0x00000000006c3852cbEf3e08E8dF289169EdE581,0x9a8b3Cd3043c6B9bD90AfF51cF04D4442F550A99
10586,15627902,21000,10534203750,21000,0,2,500,0xcF690F05D9b3E88164371182F2eDa3E3349175D4,0x96A5b337646651dE31332744BA4265a7DBd12509
10587,15627902,99244,10534203750,98636,608,138,102,0xA0b86991c6218b36c1d19D4a2e9Eb0cE3606eB48,0x99dAC652a41b5DA29cCFD9Bdc631e555636a3B64
10588,15627902,58676,10534203750,57732,944,138,808,0xdAC17F958D2ee523a2206206994597C13D831ec7,0x5eFf1CE80B725C2850e103e3BF61B568A14E4465
10589,15627902,51643,10534203750,51071,572,138,58,0xE6408dD80eE4d7596151EAd35B37bDF84d2A3B0F,0x9ae6F872bD544Cd20b7086Aab5E965C1E219348a
10590,15627902,47556,10534203750,46080,1476,458,3,0x406C60C2e8038a0E90D2f28efF7260CC7Af84EE6,0x169128a6fCe2a1C50b13fd54831e4E80974d4835
10591,15627902,122414,10534203750,121574,840,266,64,0x65c25FADd9b88df5c8C101A3b99a5D614B708596,0x4449b8e2B2068D71EA27735115aa11B4870cCA38
10592,15627902,21000,10534203750,21000,0,2,224,0x0601f794CfD96C939d2F918f8a45a1Be1883ebDE,0x2b852DB04cEE866B47ddd105F86e66210eA8bD17
10593,15627902,479083,10534203750,476323,2760,842,344,0x68b3465833fb72A70ecDF485E0e4C7bD8665Fc45,0x40cA6bDc1b3Eb4AD28224Ca4B3811989d7eFbdB9
10594,15627902,53915,10534203750,53427,488,138,115,0x6de7aC835EC6841Af9b94fd1273dB83B8d69e3f7,0x1c4B48a5a48a978e621657dB5f8f8917942426fb
10595,15627902,481218,10534203750,463782,17436,5642,5,0x0000000000c2d145a2526bD8C716263bFeBe1A72,0x05AFc8485cB9675185d2986ca66bF2fdD9933B31
10596,15627902,278821,10534203750,278617,204,74,479,0x55f1C36Bb7aE0d7D6caE97902E30A2306686Ec73,0x36151eF8bF252eB963235fd76245B98580D595F0
10597,15627902,120637,10534203750,120573,64,10,14,0xf7db4205032153a81BCB6ed0561c00E65Ac55a06,0xaaFA6b898A43b61F576bc71513A0ac23Ca0220b7
10598,15627902,46135,10534203750,45647,488,138,21,0x1Fa8559e873f698292766790AeCf8080A66433F6,0x4b8D63964c326Fef0Ba29327257F2c25E8937422
10599,15627902,175110,10534203750,173546,1564,394,92,0x1Fa8559e873f698292766790AeCf8080A66433F6,0x3fE1515f84A90925F2407b6da5E7C998c5b32a9c
10600,15627902,67544,10534203750,66068,1476,458,17,0x5BABc381C7E9EdCF02654a9C30d384dFE54dd4A1,0x030ce9d143332f6D9c287414f08e22c145c43c58
10601,15627902,94813,10534203750,94205,608,138,994,0xdAC17F958D2ee523a2206206994597C13D831ec7,0x0E20DE7B8a72f6AFF5823dE0e695C38186d7C701
10602,15627902,46135,10534203750,45647,488,138,138,0x1Fa8559e873f698292766790AeCf8080A66433F6,0x673a041A8631DCF4A308E9669E09Ef8526de8f89
10603,15627902,46135,10534203750,45647,488,138,139,0x1Fa8559e873f698292766790AeCf8080A66433F6,0x673a041A8631DCF4A308E9669E09Ef8526de8f89
10604,15627902,135923,10534203750,133771,2152,778,1384,0x34c3f58058E2ad098ef437Ee5Ea1ff1fE2fe4214,0x33de5f7c0dcFfBbC399b603FF539250a2c132E3c
10605,15627902,198938,10534203750,193838,5100,1418,804,0x68b3465833fb72A70ecDF485E0e4C7bD8665Fc45,0x90e984118aa0E7c8EbFf4e644C62cC8986ee6d17
10606,15627902,21000,10534203750,21000,0,2,28,0xFD1EA44Ea8366c3e765f185170A87d3596a787C1,0x0fa03fF310d653f6De5E0CE4B7432a8421Ed3B83
10607,15627902,183207,10534203750,163683,19524,4682,419,0x00000000006c3852cbEf3e08E8dF289169EdE581,0xB8ef7f2082a0783aef1a8F85ecf89f06CD94F812
10608,15627902,241174,10534203750,235230,5944,1738,39,0x68b3465833fb72A70ecDF485E0e4C7bD8665Fc45,0x3816e1adA945f0a4495036D8F7E852A82495F4f4
10609,15627902,306590,10534203750,304206,2384,522,51,0x283Af0B28c62C092C9727F1Ee09c02CA627EB7F5,0x30628B81bc8439549c5AbBB27D02b828b1EA93A4
10610,15627902,21000,10534203750,21000,0,2,370,0xFEe6b9d5e0802eB9519F1a2B3EBc7cAc3D630361,0xC341D836c96E31e136aCf08A49DF9bD5e5aaE0D0
10611,15627902,50000,10519352264,49936,64,10,644,0x00000000006c3852cbEf3e08E8dF289169EdE581,0x9667857F0461354a7E2CaeB6C86a560eeCa1D2Da
10612,15627902,80000,10393016421,79056,944,138,0,0x95aD61b0a150d79219dCF64E1E6Cc01f0B64C4cE,0x06F9C480BC0A20df72e7591Bceb378C33cE21D57
10613,15627902,223570,10354203750,214954,8616,2570,57,0x4976fb03C32e5B8cfe2b6cCB31c09Ba78EBaBa41,0x0b08dA7068b73A579Bd5E8a8290ff8afd37bc32A
10614,15627902,600000,10331773787,597988,2012,522,3239,0x7a250d5630B4cF539739dF2C5dAcb4c659F2488D,0x17F50ea08EBD0Bd4148dE58E57C72C08803c5634
10615,15627902,600000,10331773787,598000,2000,522,3215,0x7a250d5630B4cF539739dF2C5dAcb4c659F2488D,0xDC001E4F2F29b6cdd6F3C0B78Ad89719e40857Be
10616,15627902,600000,10331773787,597988,2012,522,4612,0x7a250d5630B4cF539739dF2C5dAcb4c659F2488D,0x84Ab6D0401831896Fe2484f5eeeeb944B5BA95DB
10617,15627902,600000,10331773787,597692,2308,586,190,0x61ccc13104B547d79fC554CFF9479ecb1AcEDA50,0x0D46d49863d8354EFb02070e5Cf01502C28140f9
10618,15627902,600000,10331773787,597704,2296,586,1905,0x61ccc13104B547d79fC554CFF9479ecb1AcEDA50,0xeA491bfBD5cD014706118c8e060001ebE8d96529
10619,15627902,236566,10213812875,233326,3240,1034,42,0x68b3465833fb72A70ecDF485E0e4C7bD8665Fc45,0xf958F19fd86CB409Da8a1D5E2566db9624A5b79c
10620,15627902,236566,10213812875,233326,3240,1034,132,0x68b3465833fb72A70ecDF485E0e4C7bD8665Fc45,0xC730d85a7CeB1a1a865D4f6235078e4Be3EcaCc8
10621,15627902,236566,10213812875,233326,3240,1034,55,0x68b3465833fb72A70ecDF485E0e4C7bD8665Fc45,0xE34B99258D7268F1f8ef11719651393050593737
10622,15627902,54339,10213812875,53395,944,138,38,0x4b13006980aCB09645131b91D259eaA111eaF5Ba,0x40DE8c96A8119E1b6A611370F1599058adF6588f
10623,15627902,259320,10135203750,257040,2280,650,106636,0xA69babEF1cA67A37Ffaf7a485DfFF3382056e78C,0x9AAb3F81604c683a1a0D14019FBfe15bef7aA1ee
10624,15627902,181476,10034203750,179912,1564,394,95,0x1Fa8559e873f698292766790AeCf8080A66433F6,0xFFb051bAAfE73FCBd237dB08b8756807eDb06C28
10625,15627902,181476,10034203750,179912,1564,394,283,0x1Fa8559e873f698292766790AeCf8080A66433F6,0x995B03a0a8e556aA8CDB189c3aa2196eF84E0A33
10626,15627902,113310,10034203750,113106,204,74,390,0x5D004ddB5D92938dAF8448b9eac1CaA593cd26Ca,0x26DC5D39Bd7A8bc2d792dcAAAC55FE6DCef25593
10627,15627902,185700,10034203750,185128,572,138,4,0x9b9D659D4f2cF68b6616Cc0a65683f1951Eb725C,0xA616036C23f7e851A322199b2bEbf43B319ef7D2
10628,15627902,181476,10034203750,179912,1564,394,256,0x1Fa8559e873f698292766790AeCf8080A66433F6,0xCcF9eE81A4E4c316A1a261f424624A538C2A50Fe
10629,15627902,113310,10034203750,113106,204,74,391,0x5D004ddB5D92938dAF8448b9eac1CaA593cd26Ca,0x26DC5D39Bd7A8bc2d792dcAAAC55FE6DCef25593
10630,15627902,230625,10034203750,226961,3664,1162,935,0x68b3465833fb72A70ecDF485E0e4C7bD8665Fc45,0xdCb31a6d93b1a51101cCa6FCdc45594cd9688401
10631,15627902,334944,10034203750,333036,1908,458,17,0x7a250d5630B4cF539739dF2C5dAcb4c659F2488D,0x0cB5B5C356FcE965b26683E0B3854a6f098108aC
10632,15627902,181458,10034203750,179906,1552,394,7,0x1Fa8559e873f698292766790AeCf8080A66433F6,0x27a96DCe5A1146628E5F0Bc99f005c4997Af9459
10633,15627902,55950,10034203750,55006,944,138,592,0x6097004C68F7B350d72226003226Ac089597D579,0xc52CdB4821427B719b176765447578293e4CF9cb
10634,15627902,113310,10034203750,113106,204,74,392,0x5D004ddB5D92938dAF8448b9eac1CaA593cd26Ca,0x26DC5D39Bd7A8bc2d792dcAAAC55FE6DCef25593
10635,15627902,289961,10034203750,287577,2384,522,179,0x283Af0B28c62C092C9727F1Ee09c02CA627EB7F5,0x465169037Da9f80F3bA4bf6d3e6DA74e5c1BE182
10636,15627902,45038,10034203750,44974,64,10,2,0xC02aaA39b223FE8D0A0e5C4F27eAD9083C756Cc2,0x5f182F80375E5bD4C36596fD1B76Fd2178ed3D2F
10637,15627902,175092,10034203750,173540,1552,394,521,0x1Fa8559e873f698292766790AeCf8080A66433F6,0x42d6A5072Ea2d1BE8eF1f6A4c3a63f7EA2A1d751
10638,15627902,113310,10034203750,113106,204,74,393,0x5D004ddB5D92938dAF8448b9eac1CaA593cd26Ca,0x26DC5D39Bd7A8bc2d792dcAAAC55FE6DCef25593
10639,15627902,181476,10034203750,179912,1564,394,598,0x1Fa8559e873f698292766790AeCf8080A66433F6,0x12C4346E877443b49DcA0DF4Bb42936ebBD11a88
10640,15627902,181476,10034203750,179912,1564,394,676,0x1Fa8559e873f698292766790AeCf8080A66433F6,0xcdBF676b4695444F3b53b76476b0C2866125F95c
10641,15627902,113310,10034203750,113106,204,74,394,0x5D004ddB5D92938dAF8448b9eac1CaA593cd26Ca,0x26DC5D39Bd7A8bc2d792dcAAAC55FE6DCef25593
10642,15627902,181458,10034203750,179906,1552,394,293,0x1Fa8559e873f698292766790AeCf8080A66433F6,0x05d33DD9cC18618bcBB5aCD20082b8D4E0C8Fb38
10643,15627902,181476,10034203750,179912,1564,394,451,0x1Fa8559e873f698292766790AeCf8080A66433F6,0x02c0f635F77AD1b98c5917Cb14a04C46BB7Ef37B
10644,15627902,29929,10034203750,29865,64,10,186,0x00000000006c3852cbEf3e08E8dF289169EdE581,0xcEc55E6734a2e80D9257FB9d54A7A037Dab0be1F
10645,15627902,191095,10034203750,190183,912,266,441,0xd588b586D61C826A0e87919b3D1a239206d58bf2,0xA830488A25751F7dA0F5488f714C96F0035687dE
10646,15627902,113310,10034203750,113106,204,74,395,0x5D004ddB5D92938dAF8448b9eac1CaA593cd26Ca,0x26DC5D39Bd7A8bc2d792dcAAAC55FE6DCef25593
10647,15627902,181476,10034203750,179912,1564,394,1024,0x1Fa8559e873f698292766790AeCf8080A66433F6,0xFF37CB274E6C7eEBc8d95ae266A782E87AbF5cb4
10648,15627902,21000,10034203750,21000,0,2,4,0x656914ce792113e9E993a4117138A39D54521747,0xC75Eeb0F9D358B0BA7d916E843D55311416620Da
10649,15627902,113310,10034203750,113106,204,74,396,0x5D004ddB5D92938dAF8448b9eac1CaA593cd26Ca,0x26DC5D39Bd7A8bc2d792dcAAAC55FE6DCef25593
10650,15627902,181476,10034203750,179912,1564,394,897,0x1Fa8559e873f698292766790AeCf8080A66433F6,0x910947fF1342515122a7BF38F4e80AFC3B4E4a27
10651,15627902,181476,10034203750,179912,1564,394,178,0x1Fa8559e873f698292766790AeCf8080A66433F6,0x1E4a81E11Bd8C375a959b9D57F0661ffcB92160f
10652,15627902,181476,10034203750,179912,1564,394,113,0x1Fa8559e873f698292766790AeCf8080A66433F6,0x1307408ce7d7d83370e695d260f9A78eFD1275d1
10653,15627902,181476,10034203750,179912,1564,394,218,0x1Fa8559e873f698292766790AeCf8080A66433F6,0xae6B81d5BA50c50ea31Bc6c25F939a2876cd31f5
10654,15627902,417578,10034203750,413330,4248,1034,111043,0xa57Bd00134B2850B2a1c55860c9e9ea100fDd6CF,0x36a454aEF52938c8637CD4689B2980C1Cfd43389
10655,15627902,334944,10034203750,333036,1908,458,30,0x7a250d5630B4cF539739dF2C5dAcb4c659F2488D,0x8617d3B9f2C24a109BF18831fE358038AaB7034F
10656,15627902,113310,10034203750,113106,204,74,397,0x5D004ddB5D92938dAF8448b9eac1CaA593cd26Ca,0x26DC5D39Bd7A8bc2d792dcAAAC55FE6DCef25593
10657,15627902,262238,10034203750,258418,3820,970,117902,0xa57Bd00134B2850B2a1c55860c9e9ea100fDd6CF,0x26bce6eCb5b10138e4bf14aC0ffcc8727FEF3B2e
10658,15627902,181476,10034203750,179912,1564,394,6,0x1Fa8559e873f698292766790AeCf8080A66433F6,0x330610529266568837237B9611EFE70B13eb6B5e
10659,15627902,181476,10034203750,179912,1564,394,190,0x1Fa8559e873f698292766790AeCf8080A66433F6,0xE9d08991c77a99CEb79b54e94eD76B849b9FA3db
10660,15627902,550000,10034203750,548164,1836,458,89,0x7a250d5630B4cF539739dF2C5dAcb4c659F2488D,0x00804aD8aa538E852f5Bb4A49f8957a783ac132f
10661,15627902,21000,10034203750,21000,0,2,27,0xf9EB60263E0D4D35c75B0dcA0C87157ad39D26BD,0x49145934B63261150b250895E7512430d2e8210d
10662,15627902,113310,10034203750,113106,204,74,398,0x5D004ddB5D92938dAF8448b9eac1CaA593cd26Ca,0x26DC5D39Bd7A8bc2d792dcAAAC55FE6DCef25593
10663,15627902,175092,10034203750,173540,1552,394,766,0x1Fa8559e873f698292766790AeCf8080A66433F6,0xFcDd1958008c13b52217a60C58bb5871D783E19E
10664,15627902,181476,10034203750,179912,1564,394,2903,0x1Fa8559e873f698292766790AeCf8080A66433F6,0x9264EF74E0A2D76a8aBa10BB2db507814921cC6e
10665,15627902,181476,10034203750,179912,1564,394,2002,0x1Fa8559e873f698292766790AeCf8080A66433F6,0xaA88580E65fB09ff45985a174660428879ee4792
10666,15627902,181476,10034203750,179912,1564,394,123,0x1Fa8559e873f698292766790AeCf8080A66433F6,0x3Fd122E1f503A9806E9e3EbE17d48505949C0B76
10667,15627902,181476,10034203750,179912,1564,394,164,0x1Fa8559e873f698292766790AeCf8080A66433F6,0xb7B1568E2A54784b29AEC162AC34012fa9938B90
10668,15627902,113310,10034203750,113106,204,74,399,0x5D004ddB5D92938dAF8448b9eac1CaA593cd26Ca,0x26DC5D39Bd7A8bc2d792dcAAAC55FE6DCef25593
10669,15627902,120000,10033936099,119380,620,138,500,0xdAC17F958D2ee523a2206206994597C13D831ec7,0x2728D0FA57565e58dA5d291bb621E00887A50c73
10670,15627902,90000,10000000000,89392,608,138,15,0xA0b86991c6218b36c1d19D4a2e9Eb0cE3606eB48,0x0BF40bFDD11f9824605578Be3d2D869a187AeBa7
10671,15627902,90000,10000000000,89392,608,138,43,0xA0b86991c6218b36c1d19D4a2e9Eb0cE3606eB48,0x3466930EBEcf636590aF84c85D040D686B6f06D2
10672,15627902,90000,10000000000,89392,608,138,27,0xA0b86991c6218b36c1d19D4a2e9Eb0cE3606eB48,0x658A22f7E73338f3c12Da162Ca11e47CC591C62a
10673,15627902,90000,10000000000,89392,608,138,10,0xA0b86991c6218b36c1d19D4a2e9Eb0cE3606eB48,0x68724034Af8B4fedacA83E3c6b44711d1A14c3cF
10674,15627902,90000,10000000000,89404,596,138,82,0xA0b86991c6218b36c1d19D4a2e9Eb0cE3606eB48,0x7384BbFc1810A6C418eB58eacd5043957be1B532
10675,15627902,90000,10000000000,89392,608,138,108,0xA0b86991c6218b36c1d19D4a2e9Eb0cE3606eB48,0x88153bf5AA982DbE1737C2eeA154265568985cFA
10676,15627902,90000,10000000000,89392,608,138,96,0xA0b86991c6218b36c1d19D4a2e9Eb0cE3606eB48,0xABd6501ee23d86254e20af073C200b560AB0Ff55
10677,15627902,236566,9885705797,233326,3240,1034,13,0x68b3465833fb72A70ecDF485E0e4C7bD8665Fc45,0x30762F13B220765C6dCb0Cd6e87013dF3F8de924
10678,15627902,80000,9847323845,79056,944,138,0,0xA0b86991c6218b36c1d19D4a2e9Eb0cE3606eB48,0xD10Dd3EcF548FA0b716c69C03d8942746b26A8F0
10679,15627902,300000,9847323845,299368,632,138,150327,0xBBbbCA6A901c926F240b89EacB641d8Aec7AEafD,0x1C727a55eA3c11B0ab7D3a361Fe0F3C47cE6de5d
10680,15627902,300000,10393016421,299392,608,138,150328,0xdAC17F958D2ee523a2206206994597C13D831ec7,0x1C727a55eA3c11B0ab7D3a361Fe0F3C47cE6de5d
10681,15627902,105000,9847323845,105000,0,2,138581,0x71bE8f0e2cb1feEB6619DeA8a7D9E081C9E7EB72,0x974CaA59e49682CdA0AD2bbe82983419A2ECC400
10682,15627902,138107,9847323845,137531,576,74,3479116,0x485b9a41e8BF06E57BB64c6Ba7cB04f9d53D2d76,0xd24400ae8BfEBb18cA49Be86258a3C749cf46853
10683,15627902,64200,9847323845,63488,712,202,3479117,0x5f65f7b609678448494De4C87521CdF6cEf1e932,0xd24400ae8BfEBb18cA49Be86258a3C749cf46853
10684,15627902,398636,9847323845,397556,1080,266,3479118,0x5f65f7b609678448494De4C87521CdF6cEf1e932,0xd24400ae8BfEBb18cA49Be86258a3C749cf46853
10685,15627902,80000,9847323845,79056,944,138,0,0xA0b86991c6218b36c1d19D4a2e9Eb0cE3606eB48,0x76930D281F21936f8576dC1E6D40d1bcd8De5ccf
10686,15627902,105000,9847323845,105000,0,2,138582,0x6038AA00f09E58Aa9d3935183164391af2d8b41C,0x974CaA59e49682CdA0AD2bbe82983419A2ECC400
10687,15627902,105000,10590981166,105000,0,2,138583,0xc919cC63a66e099a9E40cC10d2A65560E1bC7aD5,0x974CaA59e49682CdA0AD2bbe82983419A2ECC400
10688,15627902,138107,9847323845,137531,576,74,3479119,0x485b9a41e8BF06E57BB64c6Ba7cB04f9d53D2d76,0xd24400ae8BfEBb18cA49Be86258a3C749cf46853
10689,15627902,90000,9847323845,90000,0,2,3479120,0x1D28a385cAFff2f148857d8aAbC7740Dd4F81A1B,0xd24400ae8BfEBb18cA49Be86258a3C749cf46853
10690,15627902,64200,9847323845,63488,712,202,3479121,0x5f65f7b609678448494De4C87521CdF6cEf1e932,0xd24400ae8BfEBb18cA49Be86258a3C749cf46853
10691,15627902,138107,9847323845,137531,576,74,3479122,0x485b9a41e8BF06E57BB64c6Ba7cB04f9d53D2d76,0xd24400ae8BfEBb18cA49Be86258a3C749cf46853
10692,15627902,1469560,9847323845,1466304,3256,778,226,0x6fBF1b6A681307f86c2d212f0f6Ad72621309eF1,0xe6ea784c71Ad73a0Ca03afc81dCB0F62EB8Ab8Be
10693,15627902,225889,9847323845,223793,2096,522,94,0xEfF92A263d31888d860bD50809A8D171709b7b1c,0x2F4277Adbd3E7129098368D44ccABA112c9b35e6
10694,15627902,163795,9750000000,161035,2760,842,270,0x68b3465833fb72A70ecDF485E0e4C7bD8665Fc45,0x4a2C71054469e8Cb34c81d88f5C665C2F1e2ad13
10695,15627902,75540,9706096672,75336,204,74,39,0x5D004ddB5D92938dAF8448b9eac1CaA593cd26Ca,0x95827d2Ab16a42e3A4A4c8451100e8c6fAcC9FA8
10696,15627902,50000,9620000000,49332,668,138,0,0xdAC17F958D2ee523a2206206994597C13D831ec7,0x26135faA3bf04F947d7d2C0ee5F5967b2b0b8253
10697,15627902,50000,9620000000,49332,668,138,0,0xdAC17F958D2ee523a2206206994597C13D831ec7,0x8501eC17F81fc3C38FB6c80f8bBc6e3A0bE85383
10698,15627902,100999,9611402020,100935,64,10,2,0x2f03e6A59f615e2B974cF0FfcaC89Dfa0e1C3890,0x700A27bB8F5DE9d604642b23022E084d272A85E6
10699,15627902,51758,9080000000,50350,1408,394,15,0x6B8281Df97604eeae4b9e0d26E667507eB301E91,0xdb47De41c76267Be87Ef5156290CAA21F9930acc
10700,15627903,220445,154153922888,219393,1052,156,5561,0xb9aa14b6774dbc9F84B15e7fF659c0dbA0D9ddF5,0xc4c162e5E2475675cf07f4c851659d0f4266c224
10701,15627903,188863,10145776169,188219,644,90,103248,0x01FF6318440f7D5553a82294D78262D5f5084EFF,0x5AA17fC7F2950ECa85376C3A8CB1509e8e4B39dF
10702,15627903,500000,75145776169,498140,1860,458,9,0x7a250d5630B4cF539739dF2C5dAcb4c659F2488D,0x948b6760d77Cd2D86e3C269de0897312a87A2C3F
10703,15627903,188055,274244773191,187079,976,130,103249,0x01FF6318440f7D5553a82294D78262D5f5084EFF,0x5AA17fC7F2950ECa85376C3A8CB1509e8e4B39dF
10704,15627903,500000,75145776169,498140,1860,458,17,0x7a250d5630B4cF539739dF2C5dAcb4c659F2488D,0x3326757e29b7394bfc98bde7E0c92dd2EB1C7a7C
10705,15627903,285008,60145776169,281720,3288,1034,228,0x68b3465833fb72A70ecDF485E0e4C7bD8665Fc45,0x1e5E02F68FA3e19d7140EDB93CF553defEA8E0A4
10706,15627903,21000,53000000000,21000,0,2,7,0x27315f5F282c31fBADE4aE952d2631C05cD3a26F,0x758f86C6F8B9a5bda9BE7786e72E75bC907Aa382
10707,15627903,181476,50000000000,179912,1564,394,971,0x1Fa8559e873f698292766790AeCf8080A66433F6,0x93Fb4aE4e6bcc506C9bc6ce6b2707C549E88370e
10708,15627903,942276,36005312885,940180,2096,522,20,0x7a250d5630B4cF539739dF2C5dAcb4c659F2488D,0x5053f790cb9cFa016268eDaBdefAFc498b6d59Ce
10709,15627903,387354,35155776169,385270,2084,522,354,0x7a250d5630B4cF539739dF2C5dAcb4c659F2488D,0x788296BAb7c874416c34BB5d7Bc0eb2170c97334
10710,15627903,200000,33440000000,199404,596,138,1205084,0xdAC17F958D2ee523a2206206994597C13D831ec7,0xFfec0067F5a79CFf07527f63D83dD5462cCf8BA4
10711,15627903,942276,33005312885,940192,2084,522,104,0x7a250d5630B4cF539739dF2C5dAcb4c659F2488D,0x3B5e05c1470B6907aF37Ec8C86E0fD86dbED6Ce2
10712,15627903,318086,29532080698,316186,1900,262,35102,0x6aF1A16fdE7346e7729fA921ad2dDf6a462061e2,0x4dD36C49B200A6d52eBB365F01Bf0e4Db8b9f765
10713,15627903,942276,27952812587,940192,2084,522,101,0x7a250d5630B4cF539739dF2C5dAcb4c659F2488D,0x56157B796BEf83dA422860Dde69cd0921A3CA95d
10714,15627903,600000,25000000000,598000,2000,522,336,0x7a250d5630B4cF539739dF2C5dAcb4c659F2488D,0xb04F4bB5e69e1A27E559890dDc98e1D6cb418501
10715,15627903,942276,21265501131,940192,2084,522,100,0x7a250d5630B4cF539739dF2C5dAcb4c659F2488D,0xa72775d7359422BB9292C9FC3FC8758eC0D28940
10716,15627903,181476,21145776169,179912,1564,394,25,0x1Fa8559e873f698292766790AeCf8080A66433F6,0xffA53bf06b584439440C09B4c9DcB0aADCe006C0
10717,15627903,21000,18200000000,21000,0,2,1,0x500A746c9a44f68Fe6AA86a92e7B3AF4F322Ae66,0x38b07c9E9d4D90C1c8F95aC29E9Cc38b04a4EC10
10718,15627903,84354,17157094596,83710,644,138,2188250,0x9813037ee2218799597d83D4a5B6F3b6778218d9,0x75e89d5979E4f6Fba9F97c104c2F0AFB3F1dcB88
10719,15627903,77356,17157094596,76748,608,138,2188251,0x467719aD09025FcC6cF6F8311755809d45a5E5f3,0x75e89d5979E4f6Fba9F97c104c2F0AFB3F1dcB88
10720,15627903,700000,17157094595,698276,1724,402,7462,0x81153f0889Ab398C4acb42CB58B565A5392bba95,0xAD84Bb8ca42667919Cb6366ee207F674EAE7662f
10721,15627903,21000,16800000000,21000,0,2,3,0x500A746c9a44f68Fe6AA86a92e7B3AF4F322Ae66,0x5279d99E47e94857203aa559A77ce7A3203CaEE5
10722,15627903,350000,15875908649,349380,620,138,6925073,0xA0b73E1Ff0B80914AB6fe0444E65848C4C34450b,0x46340b20830761efd32832A74d7169B29FEB9758
10723,15627903,334944,15145776169,333036,1908,458,217,0x7a250d5630B4cF539739dF2C5dAcb4c659F2488D,0x11cE31192602A36f4203b264da3132D2a5A9BF17
10724,15627903,600000,15145776169,598012,1988,522,990,0x7a250d5630B4cF539739dF2C5dAcb4c659F2488D,0x989f9Bf517053378a055df4DD555010673734a18
10725,15627903,21000,15000000000,21000,0,2,6860,0x0c7f11556a5CCBbcc0D40Be0Aa22E498Ff5352E3,0x8AbAB939cC1e72C4147642111b5778CFEaBF5403
10726,15627903,79352,15000000000,78744,608,138,17,0xA0b86991c6218b36c1d19D4a2e9Eb0cE3606eB48,0x6629122Cf577538415AD1AE2A4Be52Af4a8BF9E1
10727,15627903,80196,14013529136,79540,656,138,4709945,0x6B175474E89094C44Da98b954EedeAC495271d0F,0x2FAF487A4414Fe77e2327F0bf4AE2a264a776AD2
10728,15627903,21000,14000000000,21000,0,2,2,0x500A746c9a44f68Fe6AA86a92e7B3AF4F322Ae66,0xd000cF4b81b4c4E302bd4bF907DeB278a58d5bBf
10729,15627903,416508,14000000000,414508,2000,522,30,0x7a250d5630B4cF539739dF2C5dAcb4c659F2488D,0x7676E4779F14C73d9ED01f47DCdec51A0C99687a
10730,15627903,222031,14000000000,215443,6588,1802,1,0x00000000006c3852cbEf3e08E8dF289169EdE581,0x3f4F385826e1d57F1357E4Dc4088848081d2b07F
10731,15627903,100000,14000000000,100000,0,2,270672,0xD78e725b6F250FA93dDD25bb89c1fc6738cBbA25,0x23f4569002a5A07f0Ecf688142eEB6bcD883eeF8
10732,15627903,21000,13188513515,21000,0,2,94,0x9Ba01dC4E5De13257e9Dfd01fa68132b41d1E766,0xC1546aEfaC4081f343C54bEe1764fd18136ECD0E
10733,15627903,21000,13188513515,21000,0,2,89,0xd2E0a8614bECdbCb77993099726Edcf41fF9487F,0x83Db16d50CDbdC2E50E497861b7bd157d644e988
10734,15627903,210088,13145776169,208524,1564,394,909,0x1Fa8559e873f698292766790AeCf8080A66433F6,0x04cEEb36ecf128ecb79AC917035855e79deA9ED3
10735,15627903,210088,13145776169,208524,1564,394,270,0x1Fa8559e873f698292766790AeCf8080A66433F6,0x49B8EEbE09498103B4e72D6F6598944Af467018b
10736,15627903,210088,13145776169,208524,1564,394,4616,0x1Fa8559e873f698292766790AeCf8080A66433F6,0x46F3ec73eF9B77728bBf1e7d29BBE630623B4C6e
10737,15627903,181476,13145776169,179912,1564,394,115,0x1Fa8559e873f698292766790AeCf8080A66433F6,0xc97bB8Efbb55F3461c6DCD89226b3A0AF962EB0e
10738,15627903,305935,12645776169,298935,7000,970,376,0x9b3B6974531d8AA15A87908FFd821A64863Ede5B,0xFd100FFFe8fb419B445008941F1Ea0522f5562a7
10739,15627903,80000,12645776169,79056,944,138,0,0xdAC17F958D2ee523a2206206994597C13D831ec7,0x2Ac2742D8716F53fe0153F283819716759A044c9
10740,15627903,149772,12645776169,149568,204,74,33,0x7F9306FC1978938d5C1C57Bf6044dc67E07eeB8a,0x4b71BE4c8B4682C4d673bc3db401a608f181b58F
10741,15627903,120432,12645776169,120228,204,74,2599,0x5D004ddB5D92938dAF8448b9eac1CaA593cd26Ca,0x7672a2Cf4fD67FEC537776aa48EEB2Bf7ea60969
10742,15627903,84000,12645776169,83456,544,202,881,0x98030D0DF32c20ACDFb7E79Ca5563AAB08Ec8884,0xC0f11a81CC203A4b84C9cf0c70551b056B01D5e4
10743,15627903,339997,12645776169,338773,1224,266,23,0x79bAB004d5DbAf80A73e1633800EC51BeEa5F1DF,0x41d04ff02Bb7b4C159E2D010e30eB70001579095
10744,15627903,800000,12645776169,799056,944,138,375,0xFDBf91A7F2d757A9815326af5E1e60319571984c,0x6B485D535E2e6116F82576024B6fEa09b9E1D693
10745,15627903,140797,12645776169,140225,572,138,6,0x9f7605743c0cE20B6ac749C6783af6CCC1200c6D,0xee4c5167EB3f22D741A64e76DccC9dca438db95E
10746,15627903,80000,12317465307,79344,656,138,7,0x514910771AF9Ca656af840dff83E8264EcF986CA,0x118A15552139346412eC765B20eeD843ce22822A
10747,15627903,175110,12145776169,173546,1564,394,1264,0x1Fa8559e873f698292766790AeCf8080A66433F6,0x3b7318457f091965c488dac7e58559993e4971DE
10748,15627903,181476,12145776169,179912,1564,394,168,0x1Fa8559e873f698292766790AeCf8080A66433F6,0x4d3CfC2eEb34950E7a7EC864Dc1fd92B19aB12F0
10749,15627903,244825,12145776169,242029,2796,842,1476,0x68b3465833fb72A70ecDF485E0e4C7bD8665Fc45,0xf8F3257Eb61a71aB9c6b31a8c21ca3d2A88d59ec
10750,15627903,21000,12145776169,21000,0,2,105,0xA9FCa503047ef10086CDE3aaa914E6DB68014171,0x44DAb39DdabEb658E60943F106b41854E6d80cbb
10751,15627903,50000,12145776169,50000,0,2,58047,0xc36F3bBdb94Bf7fBFcBbA0c57476a42C9Db7AE97,0xE8527f01BdF894AaAB08eE10D813e009a85eDFaB
10752,15627903,57000,12145776169,56356,644,138,77,0x6B175474E89094C44Da98b954EedeAC495271d0F,0x4b9134890A71e58E5f3f87F7028AEa1dCF8B7fC7
10753,15627903,2000000,12145776169,1992628,7372,1738,171058,0xA9D1e08C7793af67e9d92fe308d5697FB81d3E43,0x7830c87C02e56AFf27FA8Ab1241711331FA86F43
10754,15627903,21000,12145776169,21000,0,2,7100807,0x5d48f6FCf3f368A9EB53956cb779320bFe83cDc8,0xddfAbCdc4D8FfC6d5beaf154f18B778f892A0740
10755,15627903,2000000,12145776169,1987456,12544,2698,171059,0xA9D1e08C7793af67e9d92fe308d5697FB81d3E43,0x7830c87C02e56AFf27FA8Ab1241711331FA86F43
10756,15627903,21000,12145776169,21000,0,2,1783213,0x9FaEF23c094716c4be098f58E7132eB7DD23900b,0x503828976D22510aad0201ac7EC88293211D23Da
10757,15627903,36027,12145776169,35751,276,74,101,0xC02aaA39b223FE8D0A0e5C4F27eAD9083C756Cc2,0xf201c24524Ee5131E00355695c35D5A650CbF19F
10758,15627903,21000,12145776169,21000,0,2,0,0xA090e606E30bD747d4E6245a1517EbE430F0057e,0xa885bd5b1cfA24FE955A9206Df713D0FD3Bbe179
10759,15627903,21000,12145776169,21000,0,2,5726,0xA090e606E30bD747d4E6245a1517EbE430F0057e,0x4675C7e5BaAFBFFbca748158bEcBA61ef3b0a263
10760,15627903,21000,12145776169,21000,0,2,0,0xA090e606E30bD747d4E6245a1517EbE430F0057e,0x5c1a712f0fC824958124d69E2a16D2048Ac60678
10761,15627903,21000,12145776169,21000,0,2,0,0xA090e606E30bD747d4E6245a1517EbE430F0057e,0x1065F22C4d040A070A3146Bdb8eFC2067c2F78a9
10762,15627903,21000,12145776169,21000,0,2,1,0xA090e606E30bD747d4E6245a1517EbE430F0057e,0x491d51E987482cC2fc131585b5208A1C48850075
10763,15627903,21000,12145776169,21000,0,2,2,0xA090e606E30bD747d4E6245a1517EbE430F0057e,0xE0C929D37209866ef3C1C59D39b961758C23eE66
10764,15627903,21000,12145776169,21000,0,2,0,0xA090e606E30bD747d4E6245a1517EbE430F0057e,0xB893AbdD4BdED17940Fa8c55e1507A0DC2F8B3fd
10765,15627903,21000,12145776169,21000,0,2,1,0xA090e606E30bD747d4E6245a1517EbE430F0057e,0x6BbDAb46d8e179fFD2265135D944Cc8eC835551B
10766,15627903,21000,12145776169,21000,0,2,1,0xA090e606E30bD747d4E6245a1517EbE430F0057e,0xbeA574304A3e6180cA50A7b702C62BC5ee21817F
10767,15627903,21000,12145776169,21000,0,2,1,0xA090e606E30bD747d4E6245a1517EbE430F0057e,0x86F1F3fC211f91c7bD2A9a20E27f74FBB3250947
10768,15627903,21000,12145776169,21000,0,2,14659,0xA090e606E30bD747d4E6245a1517EbE430F0057e,0xBc8Ec259E3026aE0D87bc442D034d6882ce4a35C
10769,15627903,21000,12145776169,21000,0,2,1,0xA090e606E30bD747d4E6245a1517EbE430F0057e,0x6e2FeF567bfe19122ba15811635f26A16602DEdb
10770,15627903,21000,12145776169,21000,0,2,1,0xA090e606E30bD747d4E6245a1517EbE430F0057e,0xA2D94301EB9819b85e4c272485C2eE96Cff4b15d
10771,15627903,21000,12145776169,21000,0,2,1,0xA090e606E30bD747d4E6245a1517EbE430F0057e,0x29D0657Ae845ac1315688a5326E314a7443976E5
10772,15627903,21000,12145776169,21000,0,2,0,0xA090e606E30bD747d4E6245a1517EbE430F0057e,0x6B08d85c678dBbD08Ebd82E42F12a0689EE2525C
10773,15627903,21000,12145776169,21000,0,2,1,0xA090e606E30bD747d4E6245a1517EbE430F0057e,0x3316d3Bee4898D6807A446a644e601e3fB9D1717
10774,15627903,21000,12145776169,21000,0,2,277,0xA090e606E30bD747d4E6245a1517EbE430F0057e,0xEC23e76C2b78E3973dEDE15de9B205eEE872b7D2
10775,15627903,21000,12145776169,21000,0,2,0,0xA090e606E30bD747d4E6245a1517EbE430F0057e,0x5A14E054b88f3E72F75153300C70D9Aa1e6644E8
10776,15627903,21000,12145776169,21000,0,2,1,0xA090e606E30bD747d4E6245a1517EbE430F0057e,0x8B350539175c4f90e462542bA61A79518CDfD92c
10777,15627903,21000,12145776169,21000,0,2,0,0xA090e606E30bD747d4E6245a1517EbE430F0057e,0x2b4D95B73d5809B55728ab762B1005af926f8f7e
10778,15627903,140913,12145776169,133373,7540,1162,48150,0x271682DEB8C4E0901D1a1550aD2e64D568E69909,0xd13b46290f61dB3E6638bE2746e88F0c04AB883F
10779,15627903,21000,12145776169,21000,0,2,1,0xA090e606E30bD747d4E6245a1517EbE430F0057e,0x271E412683Af079db4146E340AD6b8b7259310a7
10780,15627903,21000,12145776169,21000,0,2,14929,0xA090e606E30bD747d4E6245a1517EbE430F0057e,0x02d24cAB4f2c3Bf6e6EB07ea07e45F96baccFfE7
10781,15627903,400000,12145776169,393864,6136,1738,804,0x00000000006c3852cbEf3e08E8dF289169EdE581,0x17C2549B78439F056024EF500149EE75D818Bf7E
10782,15627903,42000,12145776169,42000,0,2,329558,0x29536Eb0fabB4980d67baB792F758F174Da434C7,0x9430801EBAf509Ad49202aaBC5F5Bc6fd8A3dAf8
10783,15627903,577356,12145776169,576736,620,138,150,0x467719aD09025FcC6cF6F8311755809d45a5E5f3,0x35F28F94a987C6c4027d3f5b34C340cd52B722b6
10784,15627903,62302,12145776169,61610,692,138,3,0x95aD61b0a150d79219dCF64E1E6Cc01f0B64C4cE,0x08D9ba2888c016bf2D72e49DCf3C3Dc5AAD85621
10785,15627903,193203,12145776169,186791,6412,1738,204,0x00000000006c3852cbEf3e08E8dF289169EdE581,0xF9E229b3323Bd3f87d80fd578b93d91fE0cFf0Ca
10786,15627903,334758,12094505669,329934,4824,1292,177,0x881D40237659C251811CEC9c364ef91dC08D300C,0x29d3144Fcbfd9450Cf33cc56b5E706617e5Bc1aC
10787,15627903,133505,12000000000,129213,4292,1482,445,0x3284C2bcb3d2f5edB959aD72F8c07Af1D6D4d1bb,0xC59f09cb676Fb3cA1b12BF88970B98583F99427C
10788,15627903,259353,12000000000,257941,1412,402,260,0x1111111254fb6c44bAC0beD2854e76F90643097d,0x5D505A5A3b12e998Cd45C7Dee4d692d8Ea322e81
10789,15627903,181476,12000000000,179912,1564,394,442,0x1Fa8559e873f698292766790AeCf8080A66433F6,0x4adA478AAb6Fe49ee439960Ac491Ac9f4D3C7897
10790,15627903,21000,11791776169,21000,0,2,8348,0x4938df248CFd0F259c561Fa5c1d95Af32275DD8e,0x770E66bf008C0204a8231F4ea5C3Af12e5f580e4
10791,15627903,21000,11791776169,21000,0,2,3,0x2f671a39613861EC17ad35de44F4f84e3D4C69f4,0x71520CFFEB8F89764f9Fe070d23D5cEae0FD16Fb
10792,15627903,247333,11679268031,245493,1840,466,90,0x1111111254fb6c44bAC0beD2854e76F90643097d,0xe45419390B38f2A90645a8930cE4039D99F116f7
10793,15627903,196437,11645776169,189961,6476,1746,469,0x00000000006c3852cbEf3e08E8dF289169EdE581,0x03a3FE85b051f428Cf1e1b836F2b906568148483
10794,15627903,21000,11645776169,21000,0,2,11,0x69e620E854f42c0708535F7a7EFcb239818937B4,0x6eF314FE7C08Cb78D58Df1995dE6CdF2060435F9
10795,15627903,305890,11645776169,298890,7000,970,837,0x9b3B6974531d8AA15A87908FFd821A64863Ede5B,0x980F0d46BA52CFcEea9dC5176Ad5369cAf7F4d96
10796,15627903,234261,11645776169,227841,6420,1226,1,0xA13b8cBD068Fe176b3D37C6694173064E17Ef563,0x433dC467dD8EF8c30c93C81829258804BC276167
10797,15627903,288402,11645776169,285898,2504,522,298,0x283Af0B28c62C092C9727F1Ee09c02CA627EB7F5,0xBd3aE808d527a8d17531274A4a604eEd708f73Dd
10798,15627903,46179,11645776169,45691,488,138,47,0x209e639a0EC166Ac7a1A4bA41968fa967dB30221,0xD36d9c896f7d5A089bED0B1C92c8b409813Ab371
10799,15627903,147691,11645776169,141243,6448,1738,229,0x00000000006c3852cbEf3e08E8dF289169EdE581,0x8ACa1662a0d84309E5afbD935e10d909A4187bc8
10800,15627903,71709,11645776169,69513,2196,458,66,0x74312363e45DCaBA76c59ec49a7Aa8A65a67EeD3,0x12C0290a35FC87d0435FB782bdEF6a9B5881aA8f
10801,15627903,146747,11645776169,140107,6640,1810,161,0x00000000006c3852cbEf3e08E8dF289169EdE581,0x7296077C84DD5249B2e3ae7fC3d49C86abc38C03
10802,15627903,46280,11645776169,45420,860,138,327,0xC02aaA39b223FE8D0A0e5C4F27eAD9083C756Cc2,0x9e743c7eCA2561EE3272cabeD03e9A76b8dF1d30
10803,15627903,149645,11645776169,143045,6600,1802,30,0x00000000006c3852cbEf3e08E8dF289169EdE581,0x19443b60F0047551b16491a65e0A01486a2Cd9a0
10804,15627903,73170,11645776169,72574,596,138,193,0xA0b86991c6218b36c1d19D4a2e9Eb0cE3606eB48,0x29E868A99472dc829Ea0c2Ef95EB2f3aFC4c55D1
10805,15627903,125877,11645776169,124925,952,202,3,0x3a70B2C9d86Df638EcaC4053607C4c67b9cccE41,0xcA2F9F0e9e39Bd3fcfB84C84516E67A1EaE1d383
10806,15627903,21000,11645776169,21000,0,2,25,0x888874E5ab7b4F0955Fc07f3400016Ab2e948888,0x000090EA76D0A1a79beaF9571b6fdA5F32c58888
10807,15627903,21000,11645776169,21000,0,2,24,0x76C6A9031A6d2CcE52f6770450E454BB53BaFdF6,0x751cEaa7E0aFAbAFf8B4F0a50c96a1Cd9C88Bb16
10808,15627903,46083,11645776169,45595,488,138,122,0x55fd7945c833ad75cA6d267B06E4b2186C9a0fB9,0xf3943984EEE828010104b04039c8BFce976C306D
10809,15627903,55978,11645776169,55034,944,138,1,0xd4cB651749953988647eEE9b51DDB8DB5aeb3410,0x808dd2A92e823EF37e7ad0623117383289118Dd8
10810,15627903,21000,11645776169,21000,0,2,74,0x335c8817885842850bc5776F7A4d8D0021fDFb92,0xA534651A29e4538708be186f4B5CA5BB95A17BE1
10811,15627903,21000,11645776169,21000,0,2,451,0x25899a9A47384f0307776aD266a9B1cD024B002B,0x41CCD6A219b0c2eD4a24AD9119006356E6d312DA
10812,15627903,175110,11645776169,173546,1564,394,666,0x1Fa8559e873f698292766790AeCf8080A66433F6,0x45F1e7EeE9dc2dba7d85F2EC146632DC8Db8Ce85
10813,15627903,21000,11645776169,21000,0,2,127,0x528d4e4E0dbF071eC23013f06D8487BaD5A8a68B,0x8AfA51A90C6968E98eFb0C7F02A3D988bcb19865
10814,15627903,21000,11645776169,21000,0,2,12,0xaC3Ff5e67A41c9F0D5E492Fa14D7dA00C874d10f,0x7edA84463fCF29c4fEa6D63A057D93F28E843B8c
10815,15627903,46109,11645776169,45621,488,138,36,0xF7b8aabC98D169020b9EE716FC55541cF3e8B55B,0x7A086A31046aC36A487533003E246c1Ae55Ee7eA
10816,15627903,45038,11645776169,44974,64,10,379,0xC02aaA39b223FE8D0A0e5C4F27eAD9083C756Cc2,0xB5938f76a5850caDeb1F1705bA18A7ae76C897F2
10817,15627903,335187,11645776169,334391,796,202,639,0x72a19342e8F1838460eBFCCEf09F6585e32db86E,0x514E494c86F9249CfDc0e072f71f71a97cf33e65
10818,15627903,36027,11645776169,35751,276,74,26,0xC02aaA39b223FE8D0A0e5C4F27eAD9083C756Cc2,0xD49C4eab9b614bF8AE0c21D9e9b751ad3Cae900a
10819,15627903,220445,11645776169,213909,6536,1746,949,0x00000000006c3852cbEf3e08E8dF289169EdE581,0x428d49fbcE9DBc806f5458E946dD463C49b498f8
10820,15627903,55875,11645776169,54931,944,138,5,0x9AB7bb7FdC60f4357ECFef43986818A2A3569c62,0xe1D27A4ae92d42B81C35125aa5dFBDA4b28eCf87
10821,15627903,21000,11645776169,21000,0,2,419,0x0447a4cd15178973FbF1c38B5406785FF0857D49,0x6c6C1a2597f32EeFebd82A048550A6060C2a91FD
10822,15627903,21000,11645776169,21000,0,2,247,0x171E9C388FFf90809Fc129e2D63746c6872b5983,0x5a2079450f5D9abdEA4996E88E6710F86838FE0b
10823,15627903,181476,11645776169,179912,1564,394,121,0x1Fa8559e873f698292766790AeCf8080A66433F6,0x56B76598F4b76471dff9166Df2Eeff49e325cB42
10824,15627903,21000,11645776169,21000,0,2,44,0x6d794109409B0EaDb4428D8d2743d3922DaeA72e,0x73aD061ecCDD611914Ce75cB457F1f25Db3C556a
10825,15627903,229603,11645776169,226843,2760,842,323,0x68b3465833fb72A70ecDF485E0e4C7bD8665Fc45,0xff7fEd770EE4E628a6106A2399044E3C4fC7521C
10826,15627903,242090,11645776169,240266,1824,458,3,0x7a250d5630B4cF539739dF2C5dAcb4c659F2488D,0xC6Fc3f59b26e057D965730B7d3758e646568c6A8
10827,15627903,36015,11645776169,35751,264,74,10,0xC02aaA39b223FE8D0A0e5C4F27eAD9083C756Cc2,0xd12e7f8125f2Cb42eF61BB4B1bA48Ee3725E41b4
10828,15627903,97756,11645776169,97304,452,138,708,0xBcB288B32E28768cC98182966431Cb2F199df40a,0x6a8c449D05aFDAA5b3241Ad44E48e25D324178D5
10829,15627903,181476,11645776169,179912,1564,394,1194,0x1Fa8559e873f698292766790AeCf8080A66433F6,0x39af7F3790Eaf739C6aD27b541169252A3D152DC
10830,15627903,46157,11645776169,45669,488,138,3,0xEb4e856F69158052aC0AaF7Dc26f63DCb1ee067F,0x1B8F6285f62C2c96BBab316a0dB11034d0Ac3E53
10831,15627903,46267,11645776169,45691,576,74,215,0x283Af0B28c62C092C9727F1Ee09c02CA627EB7F5,0x1f854Ee78e4d4f5AACeC5004CBaDE1b0525321Ab
10832,15627903,173418,11645776169,166854,6564,1802,206,0x00000000006c3852cbEf3e08E8dF289169EdE581,0xca2A1A6D84dE2c1b3F44A42F42558302F0AEA831
10833,15627903,202352,11645776169,184852,17500,4426,293,0x00000000006c3852cbEf3e08E8dF289169EdE581,0xA346C2615F70607F1973Caf6d45A26aF51089fe6
10834,15627903,237757,11645776169,234093,3664,1162,212,0x68b3465833fb72A70ecDF485E0e4C7bD8665Fc45,0x9AC3b437ce4D8F10210955D7A7829f3312612D90
10835,15627903,689824,11645776169,686148,3676,1162,593,0x68b3465833fb72A70ecDF485E0e4C7bD8665Fc45,0x2f0525A6Da1cd2D7730FC59A7302450Bc43b8846
10836,15627903,131871,11645776169,130215,1656,458,0,0xb8901acB165ed027E32754E0FFe830802919727f,0xd23bE7Ff473b4FE64F2dc91A14CF30DaAD26932b
10837,15627903,184306,11645776169,182582,1724,330,771,0x3a8Dfa04bD213861AD66102F589730EE130FC071,0x344A4c67Ee8AE84b89BCdE443F982C07AE5B1358
10838,15627903,62465,11645776169,61893,572,138,23,0x4CEB477A068350BC652caBFf127f87AD874B11F9,0xaEa18Ca7575bFf32b98DBe934A8fA97Bfe1f62B5
10839,15627903,191570,11645776169,172094,19476,4682,1160,0x00000000006c3852cbEf3e08E8dF289169EdE581,0xEd04eff2e061f1FFF5F04bfd97E3B9A07B698855
10840,15627903,231029,11645776169,224617,6412,1738,79,0x00000000006c3852cbEf3e08E8dF289169EdE581,0xC9b704465A27edf2123c186C6468E127e6F9789D
10841,15627903,135587,11645776169,128835,6752,1698,47,0x00000000006c3852cbEf3e08E8dF289169EdE581,0x04128317261b5aB669372F990580fAc7E5c3937e
10842,15627903,100824,11645776169,94464,6360,1034,12,0x67097aA25f25CBA53e6a32b1f8df4e76c8c82D80,0xe1380E157285EA9d15d9E13BE9E610bd02CbFF49
10843,15627903,21000,11645776169,21000,0,2,27,0x36F6C70732F67914c69D32D9780047a39Bc4d191,0xF9635Db7778D5461719e9e4827F55C3b43590928
10844,15627903,163876,11645776169,157264,6612,1802,148,0x00000000006c3852cbEf3e08E8dF289169EdE581,0x091caFe937Cc446fCC45a87FCbB8d55590B862Dd
10845,15627903,46138,11645776169,45650,488,138,4,0x0B2f7F5c4d88C8b6ed3b40a7467731326C7A0820,0x49e3A5C8DEF00Cd7f3148267CE5dA5dB0c516856
10846,15627903,46414,11645776169,45926,488,138,2,0x92342459caca0DAdf2DA27772b4945bD3E46C33d,0x1eA67003aB749a39b01a7DD5a25CA8463ede1E3D
10847,15627903,46219,11645776169,45647,572,138,693,0x1Fa8559e873f698292766790AeCf8080A66433F6,0x8cd519D58E38E37955fa19d20ef6F9d3074F1A3e
10848,15627903,52332,11645776169,52332,0,2,1081,0x273bb8237c399c366c860A72472cABc6E9a9506F,0xc926Ea5c9897cCBB7932BDfCC5AFF8e903804559
10849,15627903,21000,11645776169,21000,0,2,1216,0xde40131e0d03104F86Adc112798e8D460880A84b,0x12FebA52718411C91f0df6f77b84fc21bdeA31Db
10850,15627903,184010,11645776169,181262,2748,842,168,0x68b3465833fb72A70ecDF485E0e4C7bD8665Fc45,0x913e1f1bd40202bfa82447Be99E03Bc1E2DB43d3
10851,15627903,36015,11645776169,35751,264,74,515,0xC02aaA39b223FE8D0A0e5C4F27eAD9083C756Cc2,0x647e04f1d1Cb2fF2BbCEEb85aB4d8AF5f6EeC135
10852,15627903,21000,11590000000,21000,0,2,705894,0x07e85B082586d3c347662322c269a506a3e70226,0x6dfc34609a05bC22319fA4Cce1d1E2929548c0D7
10853,15627903,21000,11590000000,21000,0,2,0,0x6dfc34609a05bC22319fA4Cce1d1E2929548c0D7,0x88574D2D323C6d8b494e0C2e9376D674bD53Ba99
10854,15627903,21000,11590000000,21000,0,2,7,0x6dfc34609a05bC22319fA4Cce1d1E2929548c0D7,0xFB650c41B3C3F0A4E1EC63b30bA3FDA4A2CBFf1D
10855,15627903,21000,11532824145,21000,0,2,1569074,0x4A4d0975fC1064C0eB8C67E4819863A0386724A4,0xAe45a8240147E6179ec7c9f92c5A18F9a97B3fCA
10856,15627903,21000,11532824145,21000,0,2,1569075,0x29082A9D84D5c422f7d22f14219dca9708bA057E,0xAe45a8240147E6179ec7c9f92c5A18F9a97B3fCA
10857,15627903,21000,11532824145,21000,0,2,1569076,0x6918796Da11589dA97e68adF441c6EDe40F494ea,0xAe45a8240147E6179ec7c9f92c5A18F9a97B3fCA
10858,15627903,60000,11532824145,59404,596,138,10,0xA0b86991c6218b36c1d19D4a2e9Eb0cE3606eB48,0x6ecaaA0812d39D68E5F2506319d438F0146511A7
10859,15627903,35000,11532824145,35000,0,2,1,0x7758E507850dA48cd47df1fB5F875c23E3340c50,0xC23813Cb4C261938F342d9C3869385563D58b04a
10860,15627903,103962,11275776169,101514,2448,650,826,0x4D9079Bb4165aeb4084c526a32695dCfd2F77381,0x15652636f3898F550b257B89926d5566821c32E1
10861,15627903,181476,11145776169,179912,1564,394,551,0x1Fa8559e873f698292766790AeCf8080A66433F6,0xF6160fcfb3D0695728B8806AABb619854Bad833F
10862,15627903,181476,11145776169,179912,1564,394,161,0x1Fa8559e873f698292766790AeCf8080A66433F6,0x05937D7387360af24aC27d2960897De044BDE75D
10863,15627903,181476,11145776169,179912,1564,394,5,0x1Fa8559e873f698292766790AeCf8080A66433F6,0x50C2756B62b7Fe159272Cf8cD5aC6687020FFbd5
10864,15627903,113310,11145776169,113106,204,74,400,0x5D004ddB5D92938dAF8448b9eac1CaA593cd26Ca,0x26DC5D39Bd7A8bc2d792dcAAAC55FE6DCef25593
10865,15627903,181476,11145776169,179912,1564,394,2,0x1Fa8559e873f698292766790AeCf8080A66433F6,0x62a3EcEA934B476c58B0B5A23E22f28B26dEa26F
10866,15627903,181476,11145776169,179912,1564,394,61,0x1Fa8559e873f698292766790AeCf8080A66433F6,0x736501215F7bae4d48fdB5d3127A5f8370dd58EB
10867,15627903,181476,11145776169,179912,1564,394,1103,0x1Fa8559e873f698292766790AeCf8080A66433F6,0x6C420B45dCFfAadAa2baA3B4D13A81ddedb4c126
10868,15627903,21000,11145776169,21000,0,2,39,0x7488294c29cc0317be745cbA82E226fdaAa28fA2,0xb3E1E51595B340690E56131af1610944aD774Ba5
10869,15627903,113310,11145776169,113106,204,74,401,0x5D004ddB5D92938dAF8448b9eac1CaA593cd26Ca,0x26DC5D39Bd7A8bc2d792dcAAAC55FE6DCef25593
10870,15627903,181476,11145776169,179912,1564,394,210,0x1Fa8559e873f698292766790AeCf8080A66433F6,0x53AA4b81B3F5028658161c4522b9DFFdA83e821c
10871,15627903,181476,11145776169,179912,1564,394,109,0x1Fa8559e873f698292766790AeCf8080A66433F6,0x928E3d39ab7D68b0cf4C45473D6971E374A801E5
10872,15627903,181458,11145776169,179906,1552,394,1255,0x1Fa8559e873f698292766790AeCf8080A66433F6,0x85C385dA631F7CF7436304480040d2F36B791336
10873,15627903,113310,11145776169,113106,204,74,402,0x5D004ddB5D92938dAF8448b9eac1CaA593cd26Ca,0x26DC5D39Bd7A8bc2d792dcAAAC55FE6DCef25593
10874,15627903,181476,11145776169,179912,1564,394,455,0x1Fa8559e873f698292766790AeCf8080A66433F6,0xd7CB1d43e1b95E99b9aEf02eaf7e9cE6A9b31169
10875,15627903,181476,11145776169,179912,1564,394,2125,0x1Fa8559e873f698292766790AeCf8080A66433F6,0x3B334052bc8d623d7733c5318893ae4f33776959
10876,15627903,345590,11145776169,341950,3640,1162,66,0x68b3465833fb72A70ecDF485E0e4C7bD8665Fc45,0x4f52F2777277426Cd4d769D758E7dc44DEa2715F
10877,15627903,181476,11145776169,179912,1564,394,709,0x1Fa8559e873f698292766790AeCf8080A66433F6,0x3515A681477d4127bf95c26B53913fC6e89740e7
10878,15627903,181476,11145776169,179912,1564,394,402,0x1Fa8559e873f698292766790AeCf8080A66433F6,0x1f3BaA7fb44D58025B28Af654182C66e058CE806
10879,15627903,181458,11145776169,179906,1552,394,304,0x1Fa8559e873f698292766790AeCf8080A66433F6,0x8dD4A7B2E2Fb065d18580E3EE4f1c54343413E83
10880,15627903,113310,11145776169,113106,204,74,403,0x5D004ddB5D92938dAF8448b9eac1CaA593cd26Ca,0x26DC5D39Bd7A8bc2d792dcAAAC55FE6DCef25593
10881,15627903,181476,11145776169,179912,1564,394,995,0x1Fa8559e873f698292766790AeCf8080A66433F6,0x20E76b8F164E626429c8d5a912223d54FFF206C1
10882,15627903,181476,11145776169,179912,1564,394,354,0x1Fa8559e873f698292766790AeCf8080A66433F6,0x4cF47a30703E3169D1BD45948fcaFc63B2d0Db09
10883,15627903,113310,11145776169,113106,204,74,404,0x5D004ddB5D92938dAF8448b9eac1CaA593cd26Ca,0x26DC5D39Bd7A8bc2d792dcAAAC55FE6DCef25593
10884,15627903,181476,11145776169,179912,1564,394,10,0x1Fa8559e873f698292766790AeCf8080A66433F6,0xac98a867bF13f9d205CE10C3cEC7a2DcBe078835
10885,15627903,181476,11145776169,179912,1564,394,1649,0x1Fa8559e873f698292766790AeCf8080A66433F6,0x702f5A3F5afC85375Fe6706258f9470DD4E0062d
10886,15627903,179808,11145776169,179236,572,138,5,0x9b9D659D4f2cF68b6616Cc0a65683f1951Eb725C,0xA616036C23f7e851A322199b2bEbf43B319ef7D2
10887,15627903,181476,11145776169,179912,1564,394,74,0x1Fa8559e873f698292766790AeCf8080A66433F6,0xbD8fd7a8CC64F9c046C7950e95844834851Aca63
10888,15627903,121018,11145776169,120446,572,138,44,0x1748B24faf9780B74E5A9f3Feb41553E712E94aa,0x6819eA7792CC89394fEEE84FC70d54a67cD0B765
10889,15627903,113310,11145776169,113106,204,74,405,0x5D004ddB5D92938dAF8448b9eac1CaA593cd26Ca,0x26DC5D39Bd7A8bc2d792dcAAAC55FE6DCef25593
10890,15627903,68604,11145776169,68400,204,74,5,0x4556561740B7B5F858967A6a4E54e506609704Bd,0x90080f967bfF98761cB1A6cb26EDdcd247aBc574
10891,15627903,113310,11145776169,113106,204,74,406,0x5D004ddB5D92938dAF8448b9eac1CaA593cd26Ca,0x26DC5D39Bd7A8bc2d792dcAAAC55FE6DCef25593
10892,15627903,181476,11145776169,179912,1564,394,1982,0x1Fa8559e873f698292766790AeCf8080A66433F6,0x6AF71b3aD135d102e08139B15D507303CBFe6EcF
10893,15627903,181476,11145776169,179912,1564,394,2298,0x1Fa8559e873f698292766790AeCf8080A66433F6,0xa97361Df4aa89345b626134eb8aaAC6FfB97e6E3
10894,15627903,181458,11145776169,179906,1552,394,1340,0x1Fa8559e873f698292766790AeCf8080A66433F6,0x78A2B2f00481f1DAc3dF3382f3946f58FE98315C
10895,15627903,181458,11145776169,179906,1552,394,753,0x1Fa8559e873f698292766790AeCf8080A66433F6,0xED11C61307259222643B85324D833BEa00bc9a20
10896,15627903,113310,11145776169,113106,204,74,407,0x5D004ddB5D92938dAF8448b9eac1CaA593cd26Ca,0x26DC5D39Bd7A8bc2d792dcAAAC55FE6DCef25593
10897,15627903,244796,11145776169,242024,2772,842,2,0x68b3465833fb72A70ecDF485E0e4C7bD8665Fc45,0x90FbF5B4774e0F073B20534C52B17fD173F69348
10898,15627903,200000,11124150690,198632,1368,266,40070,0x5a54fe5234E811466D5366846283323c954310B2,0x6eCe61d29b90642941C41240da924690da145696
10899,15627903,363831,11039999806,360255,3576,686,83034,0x0000000000007F150Bd6f54c40A34d7C3d5e9f56,0x0336E78E4D09b8A6A84D34d0fD103452dE57A7A3
10900,15627903,346324,10900783893,345256,1068,140,290,0xdb7A53E6AE058E1Dcf4502341E2ADFA522E2B29F,0xa23cABeCa2145Ce4e6fdD81a45be8fB53A4F9535
10901,15627903,213962,10454609145,212090,1872,296,929,0xF6465Aa892574e159dd1B4ab92cE12a3DbE47774,0x6ecE2367Fe06cBf5890cb60a73FdE945D61F5361
10902,15627903,80000,10393016421,79056,944,138,0,0xA0b86991c6218b36c1d19D4a2e9Eb0cE3606eB48,0x892e8d53D4b2eCA7B8Da72d201E5BEcAe26631D5
10903,15627903,376229,10393016421,374193,2036,522,145,0xEfF92A263d31888d860bD50809A8D171709b7b1c,0x00dBF2d57C07bBBFcd8c47c6132055e73fee8871
10904,15627903,21000,10393016421,21000,0,2,46,0x7bFdABea32100ff443Fa3CCE7eb88735D26d7Fe3,0x843b8bA3Ad6E61E983702C22D1FD7fD80900236F
10905,15627903,80000,10393016421,79056,944,138,0,0xA0b86991c6218b36c1d19D4a2e9Eb0cE3606eB48,0xcB8a0225a3CfAE3a670386Ea7C7924a1ECb8db82
10906,15627903,191113,10393016421,190189,924,266,90,0xd588b586D61C826A0e87919b3D1a239206d58bf2,0x710E29C9c3bD8904Eb3d993b05E1bE418Bc715aa
10907,15627903,387729,10381697994,169201,218528,27498,183255,0x5E4e65926BA27467555EB562121fac00D24E9dD2,0x6887246668a3b87F54DeB3b94Ba47a6f63F32985
10908,15627903,290030,10381697994,266102,23928,5258,23858,0x5427FEFA711Eff984124bFBB1AB6fbf5E3DA1820,0xbfa2F68bf9Ad60Dc3cFB1cEF04730Eb7FA251424
10909,15627903,70770,10381697994,67178,3592,778,131319,0x1531b6e3d51BF80f634957dF81A990B92dA4b154,0xCb6Ed7E78d27FDff28127F9CbD61d861F09a2324
10910,15627903,174636,10381697994,173112,1524,458,22551,0xe2FD57e2F964E9980bE872b1baBe4Ce1608E8Bcf,0x83E725d29b5A573db65f8B896d1be6C71F14b0be
10911,15627903,364138,10213812875,362582,1556,402,547,0x1111111254fb6c44bAC0beD2854e76F90643097d,0x7EBa9BCBAf748A2dd7C01Cf833A96fCeFad38fE3
10912,15627903,67109,10173545950,66501,608,138,28,0xdAC17F958D2ee523a2206206994597C13D831ec7,0x5A668ACB1Ee419E638F0e6c26E0215f84A02F0B9
10913,15627903,26000,10145776169,26000,0,2,12033,0xE94f1fa4F27D9d288FFeA234bB62E1fBC086CA0c,0xDAFEA492D9c6733ae3d56b7Ed1ADB60692c98Bc5
10914,15627904,173325,39161819874,171977,1348,190,2327,0x9507c04B10486547584C37bCBd931B2a4FeE9A41,0x0f2De9AE421d6951dE9AE7128b4C8074fdD07c89
10915,15627904,21000,30355136594,21000,0,2,1,0xA86309988947559b6E72Ef716C5058F479386C0F,0x7302e9577D815a301121412D26Ce0a1824198b40
10916,15627904,5049176,17000000000,5042112,7064,1098,300,0x0a39DA505DfB5E0BBc6bd84428281A8ba1bC7753,0x495E889d1A6cEB447a57dcc1C68410299392380c
10917,15627904,751291,16060000000,736435,14856,4682,1,0x3b3ae790Df4F312e745D270119c6052904FB6790,0xa444DA422D8382A19761Dc10b15A11EDc6D5cAF3
10918,15627904,181458,15220698345,179906,1552,394,112,0x1Fa8559e873f698292766790AeCf8080A66433F6,0x55eD6bEA8F00e1a0C4576143029B18148668969E
10919,15627904,63000,14488451312,63000,0,2,2710065,0xBd238Fd336dEC840DCAEbA36a277A120456150f8,0xC098B2a3Aa256D2140208C3de6543aAEf5cd3A94
10920,15627904,120000,14015292291,119392,608,138,1484,0xdAC17F958D2ee523a2206206994597C13D831ec7,0x77134cbC06cB00b66F4c7e623D5fdBF6777635EC
10921,15627904,21000,14000000000,21000,0,2,0,0x9AA65464b4cFbe3Dc2BDB3dF412AeE2B3De86687,0x96c764Dbe7dCb64B48E2d003Ef96c7d4bf3A088a
10922,15627904,222222,14000000000,220670,1552,394,121,0x1Fa8559e873f698292766790AeCf8080A66433F6,0x32a382d1621a966cef4032c9a181F227e8D4b801
10923,15627904,26000000,14000000000,25937760,62240,15306,16092,0x4F4495243837681061C4743b74B3eEdf548D56A5,0x19e34D09c2664d4F0829B1431eA73daC1B2bea93
10924,15627904,222222,14000000000,220670,1552,394,120,0x1Fa8559e873f698292766790AeCf8080A66433F6,0x3F6F3e5754D3cc85eC9dda3652f162b61df67a83
10925,15627904,100000,13905188362,99416,584,138,181440,0x473037de59cf9484632f4A27B509CFE8d4a31404,0x6238872A0Bd9F0E19073695532a7Ed77ce93C69E
10926,15627904,120432,13620698345,120228,204,74,204,0x5D004ddB5D92938dAF8448b9eac1CaA593cd26Ca,0x5AF6078c321c186bA9F699D45AD3EDAC0f8e1d71
10927,15627904,120432,13620698345,120228,204,74,217,0x5D004ddB5D92938dAF8448b9eac1CaA593cd26Ca,0x1a11E51fBd743E0F917bccC7E02C2a5B14FC3274
10928,15627904,120432,13620698345,120228,204,74,126,0x5D004ddB5D92938dAF8448b9eac1CaA593cd26Ca,0x009Eda273Bf77fe305aa5B715ab3ec7B52aE92Ce
10929,15627904,291401,13620698345,289589,1812,458,25,0x7a250d5630B4cF539739dF2C5dAcb4c659F2488D,0x90b639929d6f947Ad77B00C013ad277D62e3c7aF
10930,15627904,172350,13120698345,171922,428,138,220,0x28c6ea3F9cF9bC1a07A828fce1e7783261691B49,0x158DF9e0dF873286B1233CbA5F4965044cb779C8
10931,15627904,305965,13120698345,298965,7000,970,69,0x9b3B6974531d8AA15A87908FFd821A64863Ede5B,0xb65fdCDf3FeC4beBcE5e06dFb244Dab852bcc6c1
10932,15627904,153855,13120698345,152815,1040,330,1738,0x6D7c44773C52D396F43c2D511B81aa168E9a7a42,0xC9eD24f32FE31a5157A73bafF4c619E5b87D8cd2
10933,15627904,102249,13120698345,100957,1292,330,573,0xA0c68C638235ee32657e8f720a23ceC1bFc77C77,0xD25B0DBcf6FD24D05EE90d64042C79ba290c6D19
10934,15627904,21000,12977122492,21000,0,2,0,0xcDd37Ada79F589c15bD4f8fD2083dc88E34A2af2,0x7221BfA769F08Ac4F2A1Ce29a33c5DaD523BDC8F
10935,15627904,21000,12977122492,21000,0,2,155628,0x9Aee91055D78D5bA1E79631E342071ca7ee485d6,0xcDd37Ada79F589c15bD4f8fD2083dc88E34A2af2
10936,15627904,21000,12620698345,21000,0,2,2759951,0x549A9A252F49ED51b99CF462e350B242EF8f1397,0x267be1C1D684F78cb4F6a176C4911b741E4Ffdc0
10937,15627904,21000,12620698345,21000,0,2,4,0xB93CB628fA1fcb9D3C66abf70cB03a55607b8A93,0xE9916126a4D8b363b684Ad3EE8644C54D493AABd
10938,15627904,21000,12620698345,21000,0,2,2342,0x9f82f46FCaeBE047BF0108e74eb8f7f2E1c0bC68,0xc44C70fBFEf750862fbCf73F5197a28bCAA11253
10939,15627904,56659,12620698345,55715,944,138,17,0xAD13C2a8d418d01F3236F4d8b9d724575a4e9d24,0x020908f3B227Dd0D5913af8Ffe02Cbbb28EAa9f3
10940,15627904,21000,12620698345,21000,0,2,6,0xF710d23fA1C4055D2e8b33c50D7C41d48775339C,0x72a4FBf5cF07dF624e979904Fc9214e2adEa3a27
10941,15627904,207128,12620698345,207128,0,2,1679539,0x5c9F061039D25543e82cB4eCBe0f038B0d44C571,0x4976A4A02f38326660D17bf34b431dC6e2eb2327
10942,15627904,207128,12620698345,207128,0,2,3492292,0x6B6dc6886A4Bb4fa3091089f0E2d0E29a8c8e150,0x56Eddb7aa87536c09CCc2793473599fD21A8b17F
10943,15627904,207128,12620698345,207128,0,2,3199187,0xde622a75ed35F70986bD84AB7B140C14923439Af,0x9696f59E4d72E237BE84fFD425DCaD154Bf96976
10944,15627904,207128,12620698345,207128,0,2,4468969,0x427CDF01dFb4BA7B4ede0cb0F7B17223C178E7a3,0x21a31Ee1afC51d94C2eFcCAa2092aD1028285549
10945,15627904,207128,12620698345,206472,656,138,4468970,0x111111111117dC0aa78b770fA6A738034120C302,0x21a31Ee1afC51d94C2eFcCAa2092aD1028285549
10946,15627904,42000,12620698345,42000,0,2,329559,0x5383Be1381B75C406f579D101240622c3238292F,0x9430801EBAf509Ad49202aaBC5F5Bc6fd8A3dAf8
10947,15627904,336112,12620698345,332948,3164,906,210,0x68b3465833fb72A70ecDF485E0e4C7bD8665Fc45,0xD4854c4EdEC0a3e5b160b1e10b45192cE1E96e01
10948,15627904,268401,12620698345,267961,440,138,26,0x07F76e1ec845c5C54b7BA81f16d8Ac0EB31bd48a,0x2A207956B61AA0eF50a84E9058Eb9bf3793da136
10949,15627904,72343,12620698345,71391,952,202,321,0x1Fa8559e873f698292766790AeCf8080A66433F6,0x481c6116506B890308C239Cc6E7053Fe72AD0Cdd
10950,15627904,175110,12620698345,173546,1564,394,717,0x1Fa8559e873f698292766790AeCf8080A66433F6,0x74cC526EEfda969DB0185720834821eB598eA836
10951,15627904,55774,12620698345,54830,944,138,38,0x40FD72257597aA14C7231A7B1aaa29Fce868F677,0xC42542925B540371708e319df9f093D1Ef49eE2f
10952,15627904,38327,12322827272,38327,0,2,2,0x7E8F76beD54D945d942C90F76B06C64aF17C39CF,0xb9e2b6b3367180f4408fc37075e77c7EfEEFCa41
10953,15627904,21000,12317465307,21000,0,2,221,0x711c75d6A6e9678B0E8b2d44f3a5f16C195d1d23,0x732CB71F3cCD5840189142C200cF329481518c9D
10954,15627904,278376,12154190208,276084,2292,650,106637,0xA69babEF1cA67A37Ffaf7a485DfFF3382056e78C,0x9AAb3F81604c683a1a0D14019FBfe15bef7aA1ee
10955,15627904,261670,12154190207,255726,5944,1738,1,0x68b3465833fb72A70ecDF485E0e4C7bD8665Fc45,0x3af7bd79BDaf5E4aA5eeeaCAD2df9dB41793c5a2
10956,15627904,99226,12120698345,98630,596,138,160,0xA0b86991c6218b36c1d19D4a2e9Eb0cE3606eB48,0x38A9078c6aC80847a3E9110388A3a1041b539926
10957,15627904,21000,12120698345,21000,0,2,24,0x4535be0b873D47Afa636B3Eb7804d1Ba40e74C5e,0xCEDd7D764d971a15Be57A42DBD66844D18fe375B
10958,15627904,77356,12120698345,76736,620,138,121,0x467719aD09025FcC6cF6F8311755809d45a5E5f3,0x17FB2283a010c1C9e5fd435435277d7AedDC507b
10959,15627904,117533,12120698345,117341,192,74,3,0xfc33E8b6E160A81DdB442B07355D01DF711EFEee,0x2d383113CECF9869eFDc9471Dac3CDf6DB0e8f4F
10960,15627904,111597,12120698345,111405,192,74,17,0xae7ab96520DE3A18E5e111B5EaAb095312D7fE84,0x31437e500Ead4285A717f5F23017a05450FCb1c1
10961,15627904,533341,12120698345,498569,34772,12114,785,0x00000000006c3852cbEf3e08E8dF289169EdE581,0x824B486c701e8Be00dCFe8A9eedE5F052a600fa1
10962,15627904,21000,12120698345,21000,0,2,57,0xF61ECE32C8f000AbbDA8E7F3ECEb20608499c204,0xf958A34b11a361B075ac5eC398ba16C5A229C2FE
10963,15627904,73188,12120698345,72580,608,138,184,0xA0b86991c6218b36c1d19D4a2e9Eb0cE3606eB48,0xC2606254E1c3bD456B19650c9488F031823a8c77
10964,15627904,136244,12120698345,130148,6096,1682,146,0x00000000006c3852cbEf3e08E8dF289169EdE581,0xd99881A272e14666a5b4394f9deeb383fa05F38B
10965,15627904,142168,12120698345,141940,228,74,149,0xcDA72070E455bb31C7690a170224Ce43623d0B6f,0x0f5c0Dd31f7b122E4203e49Af864C3680373beE3
10966,15627904,77303,12120698345,76579,724,202,169,0x12DEb1Cb5732E40Dd55B89aBB6D5C31dF13A6e38,0x7b989E2F025cDF1b39Ca45CA01f694caE71ffed9
10967,15627904,300000,12120698345,299620,380,138,148,0x47b513D33D6E2B6F071b09CFbd7F4eDfF29CE07A,0x0cdA44cBBA0742D1b3f5B6dE5D83F6403340CE22
10968,15627904,181568,12120698345,181072,496,202,15,0x2eD2c16B073f573cEDeCfFD943fD6AE966CdB9cE,0x32e192615dCC744D5bE76f5542327632996b7E54
10969,15627904,46663,12120698345,46175,488,138,128,0x3a5051566b2241285BE871f650C445A88A970edd,0xf647E28840F35A14d5B4dF5890453D83663927F4
10970,15627904,46232,12120698345,45660,572,138,125,0x165a2eD732eb15B54b5E8C057CbcE6251370D6e8,0xdD9962aA2Afdc842B3a09A344886E2309158c636
10971,15627904,496876,12120698345,494080,2796,842,26,0x68b3465833fb72A70ecDF485E0e4C7bD8665Fc45,0x8001E22B2b3948E8B2cEDCa34e0c1eAF24a7B648
10972,15627904,193203,12120698345,186791,6412,1738,3116,0x00000000006c3852cbEf3e08E8dF289169EdE581,0x76951F6E84213f189FeE1524D382B312dFd85EbC
10973,15627904,21000,12120698345,21000,0,2,125,0x0517B9bd7EDd8e30901DDe8E0c52DBB44329b776,0x9C4C8539FbDc0A1ab8d461E192d20c554fEb9B99
10974,15627904,185823,12120698345,183671,2152,586,164,0xFbdDaDD80fe7bda00B901FbAf73803F2238Ae655,0xB78F8440a21a3128439BE04ac257703EE549a41E
10975,15627904,21000,12120698345,21000,0,2,454,0xD1Be27915cF8dc799D3800f93e92C1be8216F046,0x615e3bB7B96A54D80Eb8f6B61Fc1851e399f578d
10976,15627904,46187,12120698345,45615,572,138,63,0x34Bc797F40Df0445c8429d485232874B15561728,0xd77F04D8F98ec8421DBeF22Bc24641bD55965eb6
10977,15627904,377410,12120698345,376778,632,138,611,0xba60672a655fB952404f8F8942112Ed4C3233fEd,0x31F9A30FF5C8Ec029ACB5E5BacCabd76C611fc08
10978,15627904,163841,12120698345,157217,6624,1802,28,0x00000000006c3852cbEf3e08E8dF289169EdE581,0x00afEf6643be882b258F0Ca6A0b9d5b244e9ECBB
10979,15627904,21000,12120698345,21000,0,2,5,0x1Edb8Fd19949ca4b219E9d971e2762Aa760387dF,0x3fA045124da7df44c0aA3697421dc877536eEf3a
10980,15627904,235303,12120698345,234067,1236,338,14139,0x1111111254fb6c44bAC0beD2854e76F90643097d,0xD54e4f8A55247487dd7C8c59f14EE5c0c2889477
10981,15627904,46280,12120698345,45420,860,138,483,0xC02aaA39b223FE8D0A0e5C4F27eAD9083C756Cc2,0x36f7FFC2ea91241dAAb9aE7ACb40cE801aB19A7A
10982,15627904,36015,12120698345,35751,264,74,12,0xC02aaA39b223FE8D0A0e5C4F27eAD9083C756Cc2,0xB349e1DEce468D6552345Ec929D8E0BDfb55EBe8
10983,15627904,99244,12120698345,98636,608,138,254,0xA0b86991c6218b36c1d19D4a2e9Eb0cE3606eB48,0x26489976F21c323164116C6cbB1Ff537F17b4C5b
10984,15627904,21000,12120698345,21000,0,2,2394,0x6f58b9fac2E7847e43f61Ab50bb3C1dDaa84D249,0xe1e2E153e785118Fa7b50e93e6b8cf887F025Bc7
10985,15627904,194735,12120698345,193307,1428,458,133,0x612E2DadDc89d91409e40f946f9f7CfE422e777E,0xC0723DcFBF60002b3B5b55Fca06F0414263ff111
10986,15627904,1000000,12120698345,998036,1964,522,11,0x7a250d5630B4cF539739dF2C5dAcb4c659F2488D,0x152619812C4fd6da35Ff18881d3123bFb0172653
10987,15627904,60751,12120698345,53271,7480,2506,211,0x00000000006c3852cbEf3e08E8dF289169EdE581,0xCaaF8d01C55df01B897437093EAfE09810cCa6Fa
10988,15627904,254710,12120698345,235222,19488,4682,328,0x00000000006c3852cbEf3e08E8dF289169EdE581,0x9e743c7eCA2561EE3272cabeD03e9A76b8dF1d30
10989,15627904,66175,12120698345,65555,620,138,12,0xA0b86991c6218b36c1d19D4a2e9Eb0cE3606eB48,0x72BC2DeE3ed241930C593B65A4a55d4D6bb0B093
10990,15627904,1791696,12120698345,1787588,4108,1162,205,0x03c364C3e0EBa5463275a3867BA07FFf14821d61,0x9239beCFd66919A23477ebe10EA24f68b4Ed1704
10991,15627904,181476,12120698345,179912,1564,394,25,0x1Fa8559e873f698292766790AeCf8080A66433F6,0x9fB8ABc0A4776e89319F64Ac13B457A18C50f618
10992,15627904,240514,12120698345,237790,2724,842,46,0x68b3465833fb72A70ecDF485E0e4C7bD8665Fc45,0x0b4bFCeFc4996Ea2E62f897bDA147C0f8FF4de39
10993,15627904,216517,12120698345,213757,2760,650,1893243,0xD1669Ac6044269b59Fa12c5822439F609Ca54F41,0xD2C82F2e5FA236E114A81173e375a73664610998
10994,15627904,78749,12120698345,78545,204,74,15,0x8a657ec8f1739e9db5e338eD1b0C3a58324787a4,0xF7A04146F81B7092c04EdFBB1F598a9254C01da3
10995,15627904,60647,12120698345,53271,7376,2514,1433,0x00000000006c3852cbEf3e08E8dF289169EdE581,0x2cdc001EA87149210328d292cC84c250b4995DC2
10996,15627904,210430,12120698345,207646,2784,842,323,0x68b3465833fb72A70ecDF485E0e4C7bD8665Fc45,0xf18c47E22aB2352C6fbF39Ed87F53F54Bd476ffF
10997,15627904,118256,12120698345,116012,2244,650,157,0xC45f3c76FeeEa53aAE5AFA9b51F166E025145400,0xD2214C3F8cE3ea0B4907267aC085348f0263f4Ac
10998,15627904,56652,12120698345,55708,944,138,265,0x892ED660Ba89BEAb93E35dF7fFa909048c3bB115,0x26e35CDb264614d6843B57D444082EA62709c4f9
10999,15627904,36792,12120698345,36232,560,138,16,0xD95Be0e49472927AdAd417e5E62e2f087b8E210c,0x682Cad157D79d73Eb1D93d036B438d6F05084736
11000,15627904,46124,12120698345,45636,488,138,288,0x2F073c4a897c615101Fe4dF00ea0869191c6FA8d,0xA9684014290976aED5B098E3f60cceda447204bf
11001,15627904,84354,12000000000,84150,204,74,80,0x9b9D659D4f2cF68b6616Cc0a65683f1951Eb725C,0x4802a5a84d23Bd886B978eec822Da2bc5971B49c
11002,15627904,84354,12000000000,84150,204,74,72,0x9b9D659D4f2cF68b6616Cc0a65683f1951Eb725C,0x308a322e4F7dB2710313D788cfA5DA224Bf3fE71
11003,15627904,84354,12000000000,84150,204,74,79,0x9b9D659D4f2cF68b6616Cc0a65683f1951Eb725C,0x5061Ff0938926C854AF12D1657B6Ac822546Dfc4
11004,15627904,21000,11841044500,21000,0,2,19,0x9Ba01dC4E5De13257e9Dfd01fa68132b41d1E766,0xC57FD5b9F4ff1C3d2fa7dF72f909131d3cBFfaE9
11005,15627904,21000,11830698345,21000,0,2,1906,0x9E76DCC6656a6817d989F4074eE8D032Dc93187d,0x2479493E18cb729e940443a5589c358Cef835647
11006,15627904,63589,11720699345,63325,264,74,102,0xC02aaA39b223FE8D0A0e5C4F27eAD9083C756Cc2,0x48653786839D8eC253D7833DBE9492F346CF488A
11007,15627904,181476,11620698345,179912,1564,394,249,0x1Fa8559e873f698292766790AeCf8080A66433F6,0x859c7c99128AE2dC80b43F2da711E35F9DEb0d5C
11008,15627904,113310,11620698345,113106,204,74,408,0x5D004ddB5D92938dAF8448b9eac1CaA593cd26Ca,0x26DC5D39Bd7A8bc2d792dcAAAC55FE6DCef25593
11009,15627904,181476,11620698345,179912,1564,394,8,0x1Fa8559e873f698292766790AeCf8080A66433F6,0x8960E580A6A3BB91cC2Bbdf46df4e08A2AD8834D
11010,15627904,181476,11620698345,179912,1564,394,368,0x1Fa8559e873f698292766790AeCf8080A66433F6,0xF10693A893FcDDC34A92452A263D60Fc7113A47D
11011,15627904,69826,11620698345,68882,944,138,28,0x95aD61b0a150d79219dCF64E1E6Cc01f0B64C4cE,0xB164FbA6B8570cAb99e065aE8AcA949c3B346DA5
11012,15627904,181476,11620698345,179912,1564,394,16,0x1Fa8559e873f698292766790AeCf8080A66433F6,0xa6Bcc9858a0Db5828732fD6697fEa268f7A6f619
11013,15627904,181476,11620698345,179912,1564,394,3703,0x1Fa8559e873f698292766790AeCf8080A66433F6,0x0d917a622ed9a5773e52cCb1fAc82A75a8a6d9D9
11014,15627904,181476,11620698345,179912,1564,394,57,0x1Fa8559e873f698292766790AeCf8080A66433F6,0x1d91d9ccAeC63BD9f318d2772596418d2BafFa1f
11015,15627904,229678,11620698345,228218,1460,522,11616,0xF3E778F839934fC819cFA1040AabaCeCBA01e049,0xF165D353abDDb7Cb00052d610254249FCc12a8C7
11016,15627904,113310,11620698345,113106,204,74,409,0x5D004ddB5D92938dAF8448b9eac1CaA593cd26Ca,0x26DC5D39Bd7A8bc2d792dcAAAC55FE6DCef25593
11017,15627904,181476,11620698345,179912,1564,394,315,0x1Fa8559e873f698292766790AeCf8080A66433F6,0xBC4AD49BE7A12d771FC9F5ca9707547A71bf6455
11018,15627904,181476,11620698345,179912,1564,394,397,0x1Fa8559e873f698292766790AeCf8080A66433F6,0xD5cD2e1DBd1AbECD87C3CD1884B435A6129bf232
11019,15627904,175110,11620698345,173546,1564,394,1186,0x1Fa8559e873f698292766790AeCf8080A66433F6,0xeaeB42B770E662E653F0De9F4C6F1677102517b7
11020,15627904,113310,11620698345,113106,204,74,410,0x5D004ddB5D92938dAF8448b9eac1CaA593cd26Ca,0x26DC5D39Bd7A8bc2d792dcAAAC55FE6DCef25593
11021,15627904,46103,11620698345,45615,488,138,2,0x346378C67d0F71343F80299ed8C0407aC2Df05eB,0x1AD783fE41E08FbB7856bedAd344174941FA3Baf
11022,15627904,181476,11620698345,179912,1564,394,373,0x1Fa8559e873f698292766790AeCf8080A66433F6,0xc4fBCB5C649A94Ee5d72875aE3d71B92f8c049e7
11023,15627904,181476,11620698345,179912,1564,394,1658,0x1Fa8559e873f698292766790AeCf8080A66433F6,0x7Cb85ee6a587a1184E9D074fCA9afc55a75b3b2F
11024,15627904,181476,11620698345,179912,1564,394,983,0x1Fa8559e873f698292766790AeCf8080A66433F6,0x0E642E32974470085e362FE76DE5C43330632bdb
11025,15627904,181476,11620698345,179912,1564,394,536,0x1Fa8559e873f698292766790AeCf8080A66433F6,0xD7b2138710B7ec19C45F1C39247133392Fa8eb9e
11026,15627904,113310,11620698345,113106,204,74,411,0x5D004ddB5D92938dAF8448b9eac1CaA593cd26Ca,0x26DC5D39Bd7A8bc2d792dcAAAC55FE6DCef25593
11027,15627904,175110,11620698345,173546,1564,394,212,0x1Fa8559e873f698292766790AeCf8080A66433F6,0xA86f5324129c34312187CdE5B42Fe283FC493fD8
11028,15627904,181476,11620698345,179912,1564,394,164,0x1Fa8559e873f698292766790AeCf8080A66433F6,0x816A4e43cF8fA3C1623F7A2574b8840349a293A8
11029,15627904,181476,11620698345,179912,1564,394,329,0x1Fa8559e873f698292766790AeCf8080A66433F6,0x1750fAa03511E5BbaF0713f9692F461E4a3985eE
11030,15627904,181476,11620698345,179912,1564,394,940,0x1Fa8559e873f698292766790AeCf8080A66433F6,0x35f82c76Bf78a17d5a844e116e0BEAbd7928A1B2
11031,15627904,113310,11620698345,113106,204,74,412,0x5D004ddB5D92938dAF8448b9eac1CaA593cd26Ca,0x26DC5D39Bd7A8bc2d792dcAAAC55FE6DCef25593
11032,15627904,609505,11355059341,608193,1312,202,373,0xEFFC18fC3b7eb8E676dac549E0c693ad50D1Ce31,0x907206D1Fb31AeB9E36Fdc98CE09F5B088bE56bF
11033,15627904,191743,11325385294,190403,1340,402,261,0x1111111254fb6c44bAC0beD2854e76F90643097d,0x40C4b38156dCebCd96D177cb521332Df50Fef924
11034,15627904,21000,11157094596,21000,0,2,57,0x0860C025C5BeE09087c5D453D85B34E4aB6Da522,0x00428adc6751d0b2e4463b6A3822a030a6B82225
11035,15627904,84354,11000000000,84150,204,74,89,0x9b9D659D4f2cF68b6616Cc0a65683f1951Eb725C,0x342111b74610994a6eD9a0e19fEf9B0041AE07Af
11036,15627904,84354,11000000000,84150,204,74,88,0x9b9D659D4f2cF68b6616Cc0a65683f1951Eb725C,0x71bC6438d2Ccf31c6b06D0D973aBbDE75C1D65CF
11037,15627904,84354,11000000000,84150,204,74,92,0x9b9D659D4f2cF68b6616Cc0a65683f1951Eb725C,0x6785F6F9f736B168492c0eC7e8Df9Be5A0f5322b
11038,15627904,191041,11000000000,190165,876,266,1403,0xd588b586D61C826A0e87919b3D1a239206d58bf2,0xC22d03e13B888Dabb33A1575e4F6542f0e996622
11039,15627904,26000,10620698345,26000,0,2,12034,0xeBec795c9c8bBD61FFc14A6662944748F299cAcf,0xDAFEA492D9c6733ae3d56b7Ed1ADB60692c98Bc5
11040,15627905,164883,149212033492,162855,2028,458,8324,0xD249942f6d417CbfdcB792B1229353B66c790726,0xb18ccf69940177F3Ec62920dDb2A08eF7CB16E8f
11041,15627905,188863,10479885410,188219,644,90,103250,0x01FF6318440f7D5553a82294D78262D5f5084EFF,0x5AA17fC7F2950ECa85376C3A8CB1509e8e4B39dF
11042,15627905,319320,15479885410,317412,1908,458,218,0x7a250d5630B4cF539739dF2C5dAcb4c659F2488D,0x11cE31192602A36f4203b264da3132D2a5A9BF17
11043,15627905,188055,404220632376,187079,976,130,103251,0x01FF6318440f7D5553a82294D78262D5f5084EFF,0x5AA17fC7F2950ECa85376C3A8CB1509e8e4B39dF
11044,15627905,400000,112000000000,399056,944,138,10,0x2b8beC81F648f327B7d8278EE74932845cDa3d19,0x948b6760d77Cd2D86e3C269de0897312a87A2C3F
11045,15627905,400000,112000000000,399056,944,138,18,0x2b8beC81F648f327B7d8278EE74932845cDa3d19,0x3326757e29b7394bfc98bde7E0c92dd2EB1C7a7C
11046,15627905,236876,10479885410,234692,2184,650,119383,0xA69babEF1cA67A37Ffaf7a485DfFF3382056e78C,0x0cac3d1a887206e0f6169222C4504301A8b4b993
11047,15627905,21000,21594242170,21000,0,2,99,0x559722C975eB56cfa633AA021C61e7dF82CE177B,0x6e9F5342Fa5C5FD56A82D47a130C144951aEcEC1
11048,15627905,2000001,10479885410,1998221,1780,346,66090,0x00000000003b3cc22aF3aE1EAc0440BcEe416B40,0xa6Ae57b1dA8238Cd149bC718c40578E4620b752c
11049,15627905,69598,12479885410,68654,944,138,6,0x9992eC3cF6A55b00978cdDF2b27BC6882d88D1eC,0x6d22f76FBDAc8b6807c226ec2A8d59bC93E89f3c
11050,15627905,452839,12479885410,444287,8552,2442,7,0xe66B31678d6C16E9ebf358268a790B763C133750,0x6d22f76FBDAc8b6807c226ec2A8d59bC93E89f3c
11051,15627905,281051,52327520929,278843,2208,386,66091,0x00000000003b3cc22aF3aE1EAc0440BcEe416B40,0xa6Ae57b1dA8238Cd149bC718c40578E4620b752c
11052,15627905,5049496,17000000000,5042372,7124,1098,301,0x0a39DA505DfB5E0BBc6bd84428281A8ba1bC7753,0x495E889d1A6cEB447a57dcc1C68410299392380c
11053,15627905,252999,16479885410,250999,2000,522,244,0x7a250d5630B4cF539739dF2C5dAcb4c659F2488D,0x4Fd47Ead21BA0be8F1efe7217be88ddD82ec40e2
11054,15627905,21000,16000000000,21000,0,2,998,0x3486C57f0247bf335B1a9436dBEDEa0711446418,0x6F8f0743792347b6B34ea2B827853e919833Bb22
11055,15627905,350000,15589524632,350000,0,2,6925074,0x0938330abF1EB9aaC8F8FdD89f371049D332E65C,0x46340b20830761efd32832A74d7169B29FEB9758
11056,15627905,350000,15589524632,349392,608,138,6925075,0xdAC17F958D2ee523a2206206994597C13D831ec7,0x46340b20830761efd32832A74d7169B29FEB9758
11057,15627905,350000,15589524632,349392,608,138,6925076,0xdAC17F958D2ee523a2206206994597C13D831ec7,0x46340b20830761efd32832A74d7169B29FEB9758
11058,15627905,350000,15589524632,350000,0,2,6925077,0x3cE45354361113480E64909E38Ad09a50AFef3ED,0x46340b20830761efd32832A74d7169B29FEB9758
11059,15627905,350000,15589524632,350000,0,2,6925078,0xB81f1044147E9f3c8fC3f8b4B568D39eb1aE3b7A,0x46340b20830761efd32832A74d7169B29FEB9758
11060,15627905,300000,10479885410,298592,1408,394,224460,0x98C3d3183C4b8A650614ad179A1a98be0a8d6B8E,0x91aaE0aAfd9D2d730111b395c6871f248d7Bd728
11061,15627905,119467,15479885410,118771,696,266,1208,0x4Ee9dEBB3046139661b51E17bdfD54Fd63211de7,0x84F16a9Bcba65fA271dcEFa3F84eCaB632192eF5
11062,15627905,181476,15479885410,179912,1564,394,1084,0x1Fa8559e873f698292766790AeCf8080A66433F6,0x19694868cb9Fc8435eF794545C7332915ec43330
11063,15627905,78538,14612000000,77894,644,138,0,0x12b6893cE26Ea6341919FE289212ef77e51688c8,0x252c6e14e37cF0B9FA49f97E996D0D2569DC3d57
11064,15627905,80178,14347638377,79570,608,138,4709946,0x3C4B6E6e1eA3D4863700D7F76b36B7f3D3f13E3d,0x2FAF487A4414Fe77e2327F0bf4AE2a264a776AD2
11065,15627905,50000,14000000000,50000,0,2,719001,0x1aa34ba12e85f99BC03c219Dc7DBE41c92cEBaa9,0xA4e5961B58DBE487639929643dCB1Dc3848dAF5E
11066,15627905,21000,13580000000,21000,0,2,0,0x6dfc34609a05bC22319fA4Cce1d1E2929548c0D7,0xfFE804404Af26c2514EF331A7333e375b80BFb9f
11067,15627905,181476,13479885410,179912,1564,394,230,0x1Fa8559e873f698292766790AeCf8080A66433F6,0xc0ED29533713bB73613b81Ca3408E990f9704D1c
11068,15627905,69872,13479885410,68928,944,138,26,0xFDBf91A7F2d757A9815326af5E1e60319571984c,0x90b639929d6f947Ad77B00C013ad277D62e3c7aF
11069,15627905,850000,13479885410,848036,1964,522,121,0x7a250d5630B4cF539739dF2C5dAcb4c659F2488D,0x2C5789571A40a5554114bB6548DD9bc69D494b15
11070,15627905,291419,13479885410,289595,1824,458,98,0x7a250d5630B4cF539739dF2C5dAcb4c659F2488D,0xf9937382833256438041Ee09881396E98F6D6AeF
11071,15627905,21000,13030000000,21000,0,2,8,0x292f04a44506c2fd49Bac032E1ca148C35A478c8,0xb14158F5f457231836909612bD00692aE5F4450f
11072,15627905,90000,13000000000,89392,608,138,0,0xdAC17F958D2ee523a2206206994597C13D831ec7,0x4F027bb401166D3CC6Ff2ea53b33fD03579Ef9d4
11073,15627905,50720,13000000000,50112,608,138,20,0xdAC17F958D2ee523a2206206994597C13D831ec7,0xFF1E52C7E92C049D676f8A65f464C6F991c9902e
11074,15627905,90000,13000000000,90000,0,2,449982,0x93585472F6B9f0C9A682Eb7209c6296E5d75a8e6,0x077D360f11D220E4d5D831430c81C26c9be7C4A4
11075,15627905,21592,12979885410,21000,592,76,13471,0xaf65E45F4C0BD388F91EeB23cFCd52F4fCdd6Ee2,0xaf65E45F4C0BD388F91EeB23cFCd52F4fCdd6Ee2
11076,15627905,50000,12978000000,49332,668,138,0,0xdAC17F958D2ee523a2206206994597C13D831ec7,0xCdDE392A0c86a9eFc82d190723d75F1E36a6DEBe
11077,15627905,21000,12881885410,21000,0,2,36161,0x92EC1E559366Ce50a8dAb6D90b460C070943d9a5,0xDB044B8298E04D442FdBE5ce01B8cc8F77130e33
11078,15627905,90000,12479885410,89392,608,138,93929,0xdAC17F958D2ee523a2206206994597C13D831ec7,0xf89d7b9c864f589bbF53a82105107622B35EaA40
11079,15627905,140088,12479885410,138524,1564,394,10,0x1Fa8559e873f698292766790AeCf8080A66433F6,0x8d9ed489e62fF77038D8c3459b88A431f873FBaf
11080,15627905,140088,12479885410,138524,1564,394,3,0x1Fa8559e873f698292766790AeCf8080A66433F6,0xDA9DA4Ce4e7A2A50cf54A4987cc682BBE2F6c925
11081,15627905,140088,12479885410,138524,1564,394,0,0x1Fa8559e873f698292766790AeCf8080A66433F6,0x321de44E19373a54C48a9073d9FBCA70c7c44127
11082,15627905,140088,12479885410,138524,1564,394,8,0x1Fa8559e873f698292766790AeCf8080A66433F6,0xA0fbc0562A4A05c88BC02D16321c137b188D6BF6
11083,15627905,140088,12479885410,138524,1564,394,3,0x1Fa8559e873f698292766790AeCf8080A66433F6,0x9b93431a995F1bC9Af3504959730fF3C191E46Cb
11084,15627905,140088,12479885410,138524,1564,394,2,0x1Fa8559e873f698292766790AeCf8080A66433F6,0x8fbCDd76053A0B1dCaA6171ccc1e01FB433331DC
11085,15627905,140073,12479885410,138521,1552,394,3,0x1Fa8559e873f698292766790AeCf8080A66433F6,0xe27E27E9414e1BFb762A669EbCF4974657e1254B
11086,15627905,140088,12479885410,138524,1564,394,0,0x1Fa8559e873f698292766790AeCf8080A66433F6,0x57674049a4f6EeC97e25131BcdB8534FCA094298
11087,15627905,140088,12479885410,138524,1564,394,0,0x1Fa8559e873f698292766790AeCf8080A66433F6,0x04b0F29007197d5Bdd0Fd674867Ea50AcaBa2e7F
11088,15627905,140073,12479885410,138521,1552,394,0,0x1Fa8559e873f698292766790AeCf8080A66433F6,0x82E223d426693e31d499C9a22Cc8277fc30095f8
11089,15627905,140088,12479885410,138524,1564,394,4,0x1Fa8559e873f698292766790AeCf8080A66433F6,0x207d0A49C485E57D35B64FEEbf29EA04203e9Be7
11090,15627905,140073,12479885410,138521,1552,394,0,0x1Fa8559e873f698292766790AeCf8080A66433F6,0xe397a1Fb8Ac739Bc2E6c52740a1E33005c563c60
11091,15627905,140088,12479885410,138524,1564,394,3,0x1Fa8559e873f698292766790AeCf8080A66433F6,0x506A07d3561E628108707F99Aeb619CC96436923
11092,15627905,140088,12479885410,138524,1564,394,8,0x1Fa8559e873f698292766790AeCf8080A66433F6,0x21038F582601adE36EF424821878A910859e6023
11093,15627905,140073,12479885410,138521,1552,394,0,0x1Fa8559e873f698292766790AeCf8080A66433F6,0x91D55F18480D15cFdcd8100cfB92fC2d97D9A709
11094,15627905,140088,12479885410,138524,1564,394,3,0x1Fa8559e873f698292766790AeCf8080A66433F6,0x46Db49BAc6Cc80118C5668E6Bc93035095d64c41
11095,15627905,140088,12479885410,138524,1564,394,3,0x1Fa8559e873f698292766790AeCf8080A66433F6,0x526959E8D43Ca6F34fe8A1d8526afF37E24a1231
11096,15627905,140088,12479885410,138524,1564,394,6,0x1Fa8559e873f698292766790AeCf8080A66433F6,0xFF92e6919DfEd7d635376d7FBE5538b5f2E75CED
11097,15627905,140073,12479885410,138521,1552,394,0,0x1Fa8559e873f698292766790AeCf8080A66433F6,0x239903D1893a22448E83B7002E3eBc81Ea19301c
11098,15627905,140088,12479885410,138524,1564,394,3,0x1Fa8559e873f698292766790AeCf8080A66433F6,0x11895aA4d05EeAA4C4B4f342Cb20fb59bAc1306B
11099,15627905,140073,12479885410,138521,1552,394,4,0x1Fa8559e873f698292766790AeCf8080A66433F6,0x21FCfBd19e09f1de300c8ACA3400C6E73E475C60
11100,15627905,140073,12479885410,138521,1552,394,3,0x1Fa8559e873f698292766790AeCf8080A66433F6,0x0b873ee3eee60BC74dc4821e552B8E757389D013
11101,15627905,140088,12479885410,138524,1564,394,3,0x1Fa8559e873f698292766790AeCf8080A66433F6,0x7fC71E20eB5F16a0821b5763F6b5C8079dA690f9
11102,15627905,140088,12479885410,138524,1564,394,0,0x1Fa8559e873f698292766790AeCf8080A66433F6,0xf33Fe0581E04C77467253b0E52D0Fa5ED819693C
11103,15627905,140088,12479885410,138524,1564,394,4,0x1Fa8559e873f698292766790AeCf8080A66433F6,0x80a509Aa2Adb13188158E2AdD8b96d025D5c692f
11104,15627905,140088,12479885410,138524,1564,394,10,0x1Fa8559e873f698292766790AeCf8080A66433F6,0x48736ABb93ad686ebf5128322c937362C06086EA
11105,15627905,140088,12479885410,138524,1564,394,13,0x1Fa8559e873f698292766790AeCf8080A66433F6,0x28214f92248db93dee60A68092fE19E0379afe06
11106,15627905,140073,12479885410,138521,1552,394,13,0x1Fa8559e873f698292766790AeCf8080A66433F6,0x8e2Bad9743f6284948B9f9460d20DF79170D5Bf1
11107,15627905,140088,12479885410,138524,1564,394,2,0x1Fa8559e873f698292766790AeCf8080A66433F6,0xDf74bC0284d142CC8c9485D379a31C071C1a29e3
11108,15627905,140073,12479885410,138521,1552,394,0,0x1Fa8559e873f698292766790AeCf8080A66433F6,0x53cE6DCC9c2F01fa8c53001a3844dB3E25189998
11109,15627905,140073,12479885410,138521,1552,394,0,0x1Fa8559e873f698292766790AeCf8080A66433F6,0x2E3BFd7c15FAfF0e5824091627Ed038e9bdEbBC0
11110,15627905,140073,12479885410,138521,1552,394,0,0x1Fa8559e873f698292766790AeCf8080A66433F6,0x01402755E12f651Ae8C1636ebe857b942b008AB2
11111,15627905,140088,12479885410,138524,1564,394,8,0x1Fa8559e873f698292766790AeCf8080A66433F6,0xF5bB0B73c63D9Af92873eCe4Bd55FeAEb31Dc31B
11112,15627905,140059,12479885410,138519,1540,394,0,0x1Fa8559e873f698292766790AeCf8080A66433F6,0xE6231FcEc7f6726a82C831DFb393D7B8fAd1AA30
11113,15627905,140088,12479885410,138524,1564,394,0,0x1Fa8559e873f698292766790AeCf8080A66433F6,0x6bEA5365D3685D2A4623F6d30578Cc29Cf24386D
11114,15627905,140088,12479885410,138524,1564,394,0,0x1Fa8559e873f698292766790AeCf8080A66433F6,0x651c63C8eC4e360e6761Be4153eB95ccc40E593B
11115,15627905,140088,12479885410,138524,1564,394,0,0x1Fa8559e873f698292766790AeCf8080A66433F6,0x6E0fe87976a5647e1b768886D7037b2675F3a193
11116,15627905,140073,12479885410,138521,1552,394,3,0x1Fa8559e873f698292766790AeCf8080A66433F6,0x38A977a002CD10C26AF60C7bd93ddF296372D7B6
11117,15627905,140073,12479885410,138521,1552,394,0,0x1Fa8559e873f698292766790AeCf8080A66433F6,0xb32f00AC1106beA1E9d02722406fA8D54eA9a8b5
11118,15627905,140088,12479885410,138524,1564,394,3,0x1Fa8559e873f698292766790AeCf8080A66433F6,0xdd3aF7BaFAd4ffBD73f12a9555a54A6921389525
11119,15627905,140088,12479885410,138524,1564,394,0,0x1Fa8559e873f698292766790AeCf8080A66433F6,0x8f31872B2156f1AA620C95fdcd441a2d836178eF
11120,15627905,140088,12479885410,138524,1564,394,8,0x1Fa8559e873f698292766790AeCf8080A66433F6,0xF2C3FcF3d94aA3a3c5573fa39Ee8AD01f0bE4225
11121,15627905,140088,12479885410,138524,1564,394,0,0x1Fa8559e873f698292766790AeCf8080A66433F6,0xD1dEc9F6b6C34b19C26017D43dd97aeEaB02C14C
11122,15627905,140088,12479885410,138524,1564,394,3,0x1Fa8559e873f698292766790AeCf8080A66433F6,0x5f933A05d4f5025B0514bf3ef93c13d5E5aDBd09
11123,15627905,140088,12479885410,138524,1564,394,0,0x1Fa8559e873f698292766790AeCf8080A66433F6,0x8DAE899c94444ec5B0Cb18AA661F2211B731d2ff
11124,15627905,140088,12479885410,138524,1564,394,13,0x1Fa8559e873f698292766790AeCf8080A66433F6,0xc962236cf2111A72cf526c1E3e59a0687f9CbeFc
11125,15627905,140073,12479885410,138521,1552,394,8,0x1Fa8559e873f698292766790AeCf8080A66433F6,0xa0C2D355292F187Ce9cD73D8e6BDB61998C8f718
11126,15627905,140088,12479885410,138524,1564,394,0,0x1Fa8559e873f698292766790AeCf8080A66433F6,0x405a6Ea74363e69EF833BfE557420ae34B64fD24
11127,15627905,140088,12479885410,138524,1564,394,0,0x1Fa8559e873f698292766790AeCf8080A66433F6,0xaC1324Be1c70598d5f234BEa52A13B906BC097C3
11128,15627905,140088,12479885410,138524,1564,394,0,0x1Fa8559e873f698292766790AeCf8080A66433F6,0x3c728Ad647f1b66fcB687b5CF5ab29De3ee37b6d
11129,15627905,42000,12479885410,42000,0,2,329560,0xB7f19037492423987e58BDBE3aF9b51Ae1Ab945E,0x9430801EBAf509Ad49202aaBC5F5Bc6fd8A3dAf8
11130,15627905,186366,12479885410,179730,6636,1802,3372,0x00000000006c3852cbEf3e08E8dF289169EdE581,0xAD950bABed19971577dac5A7eb662923Da771EED
11131,15627905,323792,12479885410,320664,3128,714,67901,0x00000000C2Cf7648c169b25ef1C217864bFa38cC,0x31a7CA77c0BC7A26a5EE69Ea3e65363ead6aa322
11132,15627905,289196,12479885410,285856,3340,970,67,0x68b3465833fb72A70ecDF485E0e4C7bD8665Fc45,0x1C95D028093B47754Ac1c0D4A9DCCEe8d556209c
11133,15627905,21000,12479885410,21000,0,2,6,0x44c4c24770Dd61d569862B44b88389B19e686af2,0xcC4c74311C5CEe0CB5Ba194690bDdE93a66Dc2c4
11134,15627905,238992,12479885410,236172,2820,842,4029,0x68b3465833fb72A70ecDF485E0e4C7bD8665Fc45,0x1541681a72632143E412e918dA772DEaDF6DbC76
11135,15627905,181476,12479885410,179912,1564,394,354,0x1Fa8559e873f698292766790AeCf8080A66433F6,0xbd91279F2220678182E7ea0dC9277AD371C36Fcb
11136,15627905,54040,12479885410,53764,276,74,77,0xC02aaA39b223FE8D0A0e5C4F27eAD9083C756Cc2,0x5012e2f6b9d81e96622BFA2F2764fcB406d8e6C1
11137,15627905,21000,12479885410,21000,0,2,4292,0x4d7618a7a2A8CE5155986841ad09cb1e003D87Ef,0x0f83D15821D6dd59337E625DE78c76C9eD0171da
11138,15627905,140059,12479885410,138519,1540,394,86,0x1Fa8559e873f698292766790AeCf8080A66433F6,0x8B71E3e3536ac600718973C273Da926f72e9e859
11139,15627905,140088,12479885410,138524,1564,394,99,0x1Fa8559e873f698292766790AeCf8080A66433F6,0x1E5f858bBe6B91cA9c7330c574C569CE409461Fc
11140,15627905,140088,12479885410,138524,1564,394,330,0x1Fa8559e873f698292766790AeCf8080A66433F6,0x8683BbBe511B269F1b9dC0108fb6B267Ea764F8e
11141,15627905,140088,12479885410,138524,1564,394,93,0x1Fa8559e873f698292766790AeCf8080A66433F6,0x4AfB4f175033e60AD3BcCd789Aa2f9176fF46BA8
11142,15627905,404479,12479885410,403835,644,138,43,0xa3c56427683a19F7574b9fc219CFD27d5d6e87Fa,0xB9dc4e64815402C7e522986E0Eed2A82aD9dAd52
11143,15627905,140088,12479885410,138524,1564,394,101,0x1Fa8559e873f698292766790AeCf8080A66433F6,0xa555f61F20bf111cD0a1869DA464Bf7fC56dB822
11144,15627905,140073,12479885410,138521,1552,394,115,0x1Fa8559e873f698292766790AeCf8080A66433F6,0x2AbeBa9A879127C8395EB01006cCd91FB9DcBEaf
11145,15627905,140088,12479885410,138524,1564,394,59,0x1Fa8559e873f698292766790AeCf8080A66433F6,0x888f432Ec01ec0d168C6B7c8639256b77c16f7CD
11146,15627905,140088,12479885410,138524,1564,394,52,0x1Fa8559e873f698292766790AeCf8080A66433F6,0x4c7e6059fafF3012F5D489ADa5EdD56EE6283EeC
11147,15627905,140088,12479885410,138524,1564,394,155,0x1Fa8559e873f698292766790AeCf8080A66433F6,0x1475186E8782D1AA7D64C9c9a7E3e31A42787783
11148,15627905,140073,12479885410,138521,1552,394,78,0x1Fa8559e873f698292766790AeCf8080A66433F6,0x233C82445884bfA53600323A1E96E2AbcABee83c
11149,15627905,140088,12479885410,138524,1564,394,39,0x1Fa8559e873f698292766790AeCf8080A66433F6,0xB3c61B950D7c0a39f455D6633A50B4230BAE33d3
11150,15627905,140088,12479885410,138524,1564,394,63,0x1Fa8559e873f698292766790AeCf8080A66433F6,0xA87f58dB7b5A44a5402DEAbCE614040F0C524b57
11151,15627905,140073,12479885410,138521,1552,394,63,0x1Fa8559e873f698292766790AeCf8080A66433F6,0xd66D5dEd0FEbAB8E3680D2B8425453a614A72D9e
11152,15627905,140073,12479885410,138521,1552,394,30,0x1Fa8559e873f698292766790AeCf8080A66433F6,0x66CF4C132Af9341ee1ba4f60BeCeBFE67B001A2f
11153,15627905,140088,12479885410,138524,1564,394,106,0x1Fa8559e873f698292766790AeCf8080A66433F6,0xB0238d4e93d1E79FF6229B01436659345a3e241C
11154,15627905,140030,12479885410,138514,1516,394,124,0x1Fa8559e873f698292766790AeCf8080A66433F6,0xB5118d00da7b51Eb141Ce60019189D5504f37819
11155,15627905,140088,12479885410,138524,1564,394,61,0x1Fa8559e873f698292766790AeCf8080A66433F6,0x31441a9E4509d8A936882b4199FE5aDd5fAE0Ecd
11156,15627905,140088,12479885410,138524,1564,394,42,0x1Fa8559e873f698292766790AeCf8080A66433F6,0x0ed5B89525c9Fc2eC1f54D2Cd1bAfBa79eC19e44
11157,15627905,140073,12479885410,138521,1552,394,104,0x1Fa8559e873f698292766790AeCf8080A66433F6,0x68b877F5825AA2720d277213A8423B9253194638
11158,15627905,140088,12479885410,138524,1564,394,68,0x1Fa8559e873f698292766790AeCf8080A66433F6,0xa8B7b427AEb394184408bf865d82FE1B59b9Ee8C
11159,15627905,140088,12479885410,138524,1564,394,49,0x1Fa8559e873f698292766790AeCf8080A66433F6,0x8fc5905837790f42A44D73cE42622daAF793d59A
11160,15627905,140088,12479885410,138524,1564,394,60,0x1Fa8559e873f698292766790AeCf8080A66433F6,0xfBdA142Df1CDd6DBaFBa771cd17DE8Ac285ff1fc
11161,15627905,140088,12479885410,138524,1564,394,19,0x1Fa8559e873f698292766790AeCf8080A66433F6,0xa7f338e74f7FCEa08317C0bed96578F11FcAA192
11162,15627905,140073,12479885410,138521,1552,394,19,0x1Fa8559e873f698292766790AeCf8080A66433F6,0x4f4A3D52695BF6D622E3410F6473D4BBe2F57E68
11163,15627905,140088,12479885410,138524,1564,394,19,0x1Fa8559e873f698292766790AeCf8080A66433F6,0xC83C4449Bfc09Aac2B4a6C4676e34b9Fae3f804f
11164,15627905,140088,12479885410,138524,1564,394,26,0x1Fa8559e873f698292766790AeCf8080A66433F6,0x022799D9AbDf12Fc13411072C5d890379e0C5A7D
11165,15627905,140073,12479885410,138521,1552,394,26,0x1Fa8559e873f698292766790AeCf8080A66433F6,0x34dC5Cd1f27826cD9e860c3497708bE1F9E5516f
11166,15627905,140073,12479885410,138521,1552,394,26,0x1Fa8559e873f698292766790AeCf8080A66433F6,0xd0c0ae973dD4872Bc32321AB1C057D39a34650EC
11167,15627905,140073,12479885410,138521,1552,394,26,0x1Fa8559e873f698292766790AeCf8080A66433F6,0xCC793C54aEDcD7Ec404916dA8CF630B7aBd5b3F4
11168,15627905,140088,12479885410,138524,1564,394,19,0x1Fa8559e873f698292766790AeCf8080A66433F6,0xE4d1149450d81702B47f9055750E0CEB0452Efb4
11169,15627905,140088,12479885410,138524,1564,394,25,0x1Fa8559e873f698292766790AeCf8080A66433F6,0x642DF50259c2efe8FD42Ca6673b2E2201fDDdEB0
11170,15627905,140088,12479885410,138524,1564,394,25,0x1Fa8559e873f698292766790AeCf8080A66433F6,0xfbab1396CD0FD41119c15ddC22a948faE628D324
11171,15627905,140088,12479885410,138524,1564,394,25,0x1Fa8559e873f698292766790AeCf8080A66433F6,0x1E82485e38db71DC9A30Df8722150A6593EBBa1a
11172,15627905,341527,12479885410,338411,3116,906,4105,0x68b3465833fb72A70ecDF485E0e4C7bD8665Fc45,0xaAa313393E79ea3454939e843E0AA8DEC66A9949
11173,15627905,140088,12479885410,138524,1564,394,26,0x1Fa8559e873f698292766790AeCf8080A66433F6,0x2FD9F39eA3d7C190EacE03744541b812d0118463
11174,15627905,140088,12479885410,138524,1564,394,30,0x1Fa8559e873f698292766790AeCf8080A66433F6,0x0ec6aD436FeE9C71F2a3aD785863Ec62c70169ba
11175,15627905,140088,12479885410,138524,1564,394,19,0x1Fa8559e873f698292766790AeCf8080A66433F6,0xBEC11e421c7f75Ea0f44c085d19F012F9094847C
11176,15627905,140088,12479885410,138524,1564,394,25,0x1Fa8559e873f698292766790AeCf8080A66433F6,0x93bcD94a9372e658eC79965516614CC35b61bd19
11177,15627905,140088,12479885410,138524,1564,394,25,0x1Fa8559e873f698292766790AeCf8080A66433F6,0xf9532f73b98577B0f05880FB6aD94FA1381E1038
11178,15627905,140088,12479885410,138524,1564,394,19,0x1Fa8559e873f698292766790AeCf8080A66433F6,0xe2E7cd255F9346ea509809622f4ECADfaA7a1B15
11179,15627905,140059,12479885410,138519,1540,394,25,0x1Fa8559e873f698292766790AeCf8080A66433F6,0x8086f0fa9604008B00e6CAF958552F8dBB7DEe40
11180,15627905,140088,12479885410,138524,1564,394,26,0x1Fa8559e873f698292766790AeCf8080A66433F6,0xD5e59B9A4a30DAbf3886Fb8D65489865E79BDF44
11181,15627905,140088,12479885410,138524,1564,394,19,0x1Fa8559e873f698292766790AeCf8080A66433F6,0x9d0b1963482689630B254bF96Cf9C60307Bc1fB8
11182,15627905,140088,12479885410,138524,1564,394,19,0x1Fa8559e873f698292766790AeCf8080A66433F6,0x531B04CF19CD98bc60a3868272F1381ad5C76BFd
11183,15627905,140088,12479885410,138524,1564,394,19,0x1Fa8559e873f698292766790AeCf8080A66433F6,0xF22364c2323FC665f8838C5e15D49d1AA7CD4E31
11184,15627905,140088,12479885410,138524,1564,394,25,0x1Fa8559e873f698292766790AeCf8080A66433F6,0x8f4b269b54e0FC867027EA5878A34ebe78DE0138
11185,15627905,140088,12479885410,138524,1564,394,25,0x1Fa8559e873f698292766790AeCf8080A66433F6,0x7ed060aB3bC01564f206f99136A723FC01FAfe8D
11186,15627905,140059,12479885410,138519,1540,394,26,0x1Fa8559e873f698292766790AeCf8080A66433F6,0xdAa55986C160a6FD992778Ce8E5AeF2fBDcB3DD2
11187,15627905,207128,12479885410,206520,608,138,4468971,0xdAC17F958D2ee523a2206206994597C13D831ec7,0x21a31Ee1afC51d94C2eFcCAa2092aD1028285549
11188,15627905,181476,12000000000,179912,1564,394,1545,0x1Fa8559e873f698292766790AeCf8080A66433F6,0x2BBAD01F50EAE735F95050b62E3a7d0c4Cf8f6Ca
11189,15627905,181476,12000000000,179912,1564,394,4110,0x1Fa8559e873f698292766790AeCf8080A66433F6,0xB2Aadf6BFc0a5213acb9c279394B46F50aEa65a3
11190,15627905,393310,11979885410,388078,5232,1610,192,0x68b3465833fb72A70ecDF485E0e4C7bD8665Fc45,0xD12EC12A77D3f30844a58c2E992273B8152A2eD5
11191,15627905,46198,11979885410,45710,488,138,35,0x018BeFB7D1F3e84948466ef15Cc46bAF9Ba5295F,0xA0b1852234aA69c7377077Bf541304ae2b2Afa68
11192,15627905,67544,11979885410,66068,1476,458,18,0x74fD1E808dD4919c90bc79F62d786C3576461ED6,0x030ce9d143332f6D9c287414f08e22c145c43c58
11193,15627905,181476,11979885410,179912,1564,394,2550,0x1Fa8559e873f698292766790AeCf8080A66433F6,0xdcf5bF70535F3680a5AD5E16Ee485153546E1ea0
11194,15627905,60991,11979885410,53271,7720,2506,340,0x00000000006c3852cbEf3e08E8dF289169EdE581,0x6542902cEC03E31707915694ad36e5A386c46A4b
11195,15627905,21000,11979885410,21000,0,2,194,0xa825aC21a697F26281177ca5cc7Bd4aEDD71A2E5,0x29E868A99472dc829Ea0c2Ef95EB2f3aFC4c55D1
11196,15627905,55948,11979885410,55004,944,138,1570,0x67954768E721FAD0f0f21E33e874497C73ED6a82,0xadE9086630754563619908beAd432de161a1F558
11197,15627905,46157,11979885410,45669,488,138,480,0x55f1C36Bb7aE0d7D6caE97902E30A2306686Ec73,0x36151eF8bF252eB963235fd76245B98580D595F0
11198,15627905,181476,11979885410,179912,1564,394,10,0x1Fa8559e873f698292766790AeCf8080A66433F6,0x38f10F5fc8242dD75197583B9467b8F7C866945e
11199,15627905,258823,11979885410,257919,904,394,82,0x920A8d9e9F0DefD6F86e4388a5503B04CaC83b57,0x088e294499e2e47a81064D28017f8D225c52A071
11200,15627905,43004,11979885410,42444,560,138,490,0xA0b86991c6218b36c1d19D4a2e9Eb0cE3606eB48,0x2EceCf5a33d038694133BbF3A22AEAFBc96d4B04
11201,15627905,203857,11979885410,197205,6652,1810,72,0x00000000006c3852cbEf3e08E8dF289169EdE581,0x219f34e5DB50279CD23Aac461E5344d332F14ed9
11202,15627905,21000,11979885410,21000,0,2,591,0xcf3B9dFB29EaE12b6389EB6ccd19a03DE02318D9,0x9Aff445b765c047a1d14fe47daefCe2803241676
11203,15627905,77830,11979885410,77186,644,138,219,0xC0B376f1887b00b66De12cD0741618FCaAA6D47d,0xA57f1e4d7f08E5F4880E293A51d8bF3BdaFb44e2
11204,15627905,126625,11979885410,126005,620,138,130,0xc5fB36dd2fb59d3B98dEfF88425a3F425Ee469eD,0xFc30c771c795b4d23A44B861d91A542365f21e33
11205,15627905,157887,11979885410,151083,6804,1802,615,0x00000000006c3852cbEf3e08E8dF289169EdE581,0x0dbb8BAFB3D12880dDab40F08082A35Fd31f7B79
11206,15627905,182601,11979885410,171429,11172,3410,484,0x00000000006c3852cbEf3e08E8dF289169EdE581,0x36f7FFC2ea91241dAAb9aE7ACb40cE801aB19A7A
11207,15627905,21000,11979885410,21000,0,2,493,0xD06819622dfe25652daEE22561c2f70cF7b0165f,0x05bF72a25e8A11895648f78c093cf2F38C2FEaE4
11208,15627905,181476,11979885410,179912,1564,394,106,0x1Fa8559e873f698292766790AeCf8080A66433F6,0x48DCA1f211FDb997Bb25D9d54156bC5D9c636ddd
11209,15627905,326475,11979885410,322819,3656,1098,109,0x68b3465833fb72A70ecDF485E0e4C7bD8665Fc45,0x6aC20BF955649752F7a7797A4BC98FBAA1e9af8D
11210,15627905,131062,11979885410,125114,5948,1674,34,0x00000000006c3852cbEf3e08E8dF289169EdE581,0x7d0cbbF6f53aEE1Bd2CeB5CE410336A0265CAF71
11211,15627905,192958,11979885410,186406,6552,1802,42,0x00000000006c3852cbEf3e08E8dF289169EdE581,0xAEFf8f5eEE811039Bd087bCF84742bA9c4eCced9
11212,15627905,45897,11979885410,44953,944,138,595,0x57f1887a8BF19b14fC0dF6Fd9B2acc9Af147eA85,0x761989CF4dB9d6a878F924c91B53a68e647f28fC
11213,15627905,181476,11979885410,179912,1564,394,1218,0x1Fa8559e873f698292766790AeCf8080A66433F6,0xd7ad9005d7F0E1cee2190517825C7B53C13f5826
11214,15627905,48464,11979885410,47820,644,138,17,0x7D1AfA7B718fb893dB30A3aBc0Cfc608AaCfeBB0,0x682Cad157D79d73Eb1D93d036B438d6F05084736
11215,15627905,46653,11979885410,46165,488,138,3,0x8F86C6fa0F2Aa138D256ed7Ab5C64181e60a6f89,0x1eA67003aB749a39b01a7DD5a25CA8463ede1E3D
11216,15627905,99226,11979885410,98630,596,138,152,0xA0b86991c6218b36c1d19D4a2e9Eb0cE3606eB48,0xdD2Ec9A41e07D490f4426e1F6F50F6DF66822490
11217,15627905,27938,11979885410,27874,64,10,3060,0xC02aaA39b223FE8D0A0e5C4F27eAD9083C756Cc2,0x6Ec30Fd91A504Aad948839B985C7263888B2Ad68
11218,15627905,156319,11979885410,149731,6588,1802,5,0x00000000006c3852cbEf3e08E8dF289169EdE581,0xFda13fFab1D19b97094580AFC05a8A7c1427e0cA
11219,15627905,46280,11979885410,45420,860,138,220,0xC02aaA39b223FE8D0A0e5C4F27eAD9083C756Cc2,0x00002Af92bFc4502bcE533589f7C7d8340280e67
11220,15627905,21000,11979885410,21000,0,2,4,0x86Cd0944013e2B852DA7AFa6C8b7ad76d0B35a67,0x169128a6fCe2a1C50b13fd54831e4E80974d4835
11221,15627905,1221694,11979885410,1221338,356,138,90,0x2b591e99afE9f32eAA6214f7B7629768c40Eeb39,0x3fd5fAD140419090cF565aa9F435E06Db3941256
11222,15627905,288882,11979885410,285566,3316,970,6,0x68b3465833fb72A70ecDF485E0e4C7bD8665Fc45,0xe1D27A4ae92d42B81C35125aa5dFBDA4b28eCf87
11223,15627905,2821240,11979885410,2623048,198192,25910,1,,0x23180E88bdE1fc5EA9278a41c75a1D35Aeab73FE
11224,15627905,71709,11979885410,69513,2196,458,118,0x74312363e45DCaBA76c59ec49a7Aa8A65a67EeD3,0x8c8363EE1D5AE7E3931D8EfD302ea1bB39Ef0488
11225,15627905,34706,11979885410,34074,632,138,6,0x6B175474E89094C44Da98b954EedeAC495271d0F,0x83De83871f2bF41600d4cC98519437a1D772886c
11226,15627905,172683,11979885410,171715,968,330,0,0xb08Aa31Cc2B8C0582bE42D38Bb643292e0A4b9EB,0xFE6fc65866F075882efBF9F7464898260d159187
11227,15627905,148222,11979885410,142214,6008,1674,702,0x00000000006c3852cbEf3e08E8dF289169EdE581,0x5932Fe40c0c5F1bf781ccC553baa19Be3b846a34
11228,15627905,153566,11979885410,146538,7028,1866,148,0x00000000006c3852cbEf3e08E8dF289169EdE581,0x3E61DFfa0bC323Eaa16F4C982F96FEB89ab89E8a
11229,15627905,46135,11979885410,45647,488,138,1094,0x1Fa8559e873f698292766790AeCf8080A66433F6,0xAD47E9d28103D74E94AC5A36eCdbDCc573B5A393
11230,15627905,2000000,11942282187,1997940,2060,522,412,0x7a250d5630B4cF539739dF2C5dAcb4c659F2488D,0xC598DE2944734AF41EeB92dFD24Aac8803aDca0E
11231,15627905,21000,11841044500,21000,0,2,8,0x83B3432C2E4e37a4982dcd32f94067024151DC84,0x7D35286C7d6864Cf6A61b4EC90F3d2FB6F8C7935
11232,15627905,100000,11774576924,99392,608,138,19548,0xdAC17F958D2ee523a2206206994597C13D831ec7,0xF2750EAd8816CbA74F8c9Ab84B8Cee67A1772348
11233,15627905,46000,11479885410,46000,0,2,19479,0x452C7aC85e26EC6483BcE1a7E1d96C71B6E1345E,0x8D056D457a52c4dAF71CEf45F540a040c143Ea05
11234,15627905,46364,11479885410,45420,944,138,3,0xC02aaA39b223FE8D0A0e5C4F27eAD9083C756Cc2,0x5f182F80375E5bD4C36596fD1B76Fd2178ed3D2F
11235,15627905,181476,11479885410,179912,1564,394,231,0x1Fa8559e873f698292766790AeCf8080A66433F6,0xb8De4b56d05555712a28383582AacDA271709B16
11236,15627905,113310,11479885410,113106,204,74,413,0x5D004ddB5D92938dAF8448b9eac1CaA593cd26Ca,0x26DC5D39Bd7A8bc2d792dcAAAC55FE6DCef25593
11237,15627905,181476,11479885410,179912,1564,394,1440,0x1Fa8559e873f698292766790AeCf8080A66433F6,0x9daea748b52acd41E055FBb7E3985625F080b7A7
11238,15627905,181458,11479885410,179906,1552,394,20,0x1Fa8559e873f698292766790AeCf8080A66433F6,0xDC3eb221814A84ccD862135d197F5e2d7A982B8f
11239,15627905,181476,11479885410,179912,1564,394,494,0x1Fa8559e873f698292766790AeCf8080A66433F6,0x53Dcc405F74043AE84dcb86e7f75e6Df9Ad03182
11240,15627905,113310,11479885410,113106,204,74,414,0x5D004ddB5D92938dAF8448b9eac1CaA593cd26Ca,0x26DC5D39Bd7A8bc2d792dcAAAC55FE6DCef25593
11241,15627905,416720,11479885410,413080,3640,1162,274,0x68b3465833fb72A70ecDF485E0e4C7bD8665Fc45,0x1625B73F49F6f45027a234fAbd9BFC6179Ff41AE
11242,15627905,181476,11479885410,179912,1564,394,165,0x1Fa8559e873f698292766790AeCf8080A66433F6,0x816A4e43cF8fA3C1623F7A2574b8840349a293A8
11243,15627905,181476,11479885410,179912,1564,394,931,0x1Fa8559e873f698292766790AeCf8080A66433F6,0x5d0eD3086857bC36f6af403110c8C3715658FE7F
11244,15627905,113310,11479885410,113106,204,74,415,0x5D004ddB5D92938dAF8448b9eac1CaA593cd26Ca,0x26DC5D39Bd7A8bc2d792dcAAAC55FE6DCef25593
11245,15627905,269218,11479885410,265398,3820,970,91230,0xa57Bd00134B2850B2a1c55860c9e9ea100fDd6CF,0x4603180BBB8221157880AfaA84638E0fc467738D
11246,15627905,181440,11479885410,179900,1540,394,460,0x1Fa8559e873f698292766790AeCf8080A66433F6,0xc69451A0c0bd71394813EBb42De90109dd75FC7b
11247,15627905,181458,11479885410,179906,1552,394,223,0x1Fa8559e873f698292766790AeCf8080A66433F6,0x4A8A4201f125f6Cb7a43120867C10e1416fd357f
11248,15627905,181458,11479885410,179906,1552,394,574,0x1Fa8559e873f698292766790AeCf8080A66433F6,0xBf7553a7fdbc1CC0c32ee791efe5CDf1C0bad1Fd
11249,15627905,181458,11479885410,179906,1552,394,153,0x1Fa8559e873f698292766790AeCf8080A66433F6,0x3A15816975EdBB27da070A4a7aE8D73bCfc775Fe
11250,15627905,113310,11479885410,113106,204,74,416,0x5D004ddB5D92938dAF8448b9eac1CaA593cd26Ca,0x26DC5D39Bd7A8bc2d792dcAAAC55FE6DCef25593
11251,15627905,181476,11479885410,179912,1564,394,42,0x1Fa8559e873f698292766790AeCf8080A66433F6,0x0c36550A5E25Cf3BaF746217439774d48766aa2E
11252,15627905,113310,11479885410,113106,204,74,417,0x5D004ddB5D92938dAF8448b9eac1CaA593cd26Ca,0x26DC5D39Bd7A8bc2d792dcAAAC55FE6DCef25593
11253,15627905,63589,11479885410,63325,264,74,342,0xC02aaA39b223FE8D0A0e5C4F27eAD9083C756Cc2,0x4ae1CA9bD2Cc1bE18d37110A1D2cfF4C58BE70E8
11254,15627905,105000,10856620170,105000,0,2,7178,0xc82Df81f2549f24F8023936eae26DEb71a87033E,0x787B8840100d9BaAdD7463f4a73b5BA73B00C6cA
11255,15627905,346274,10715807235,164966,181308,22886,183256,0x5E4e65926BA27467555EB562121fac00D24E9dD2,0x6887246668a3b87F54DeB3b94Ba47a6f63F32985
11256,15627905,26000,10479885410,26000,0,2,12035,0x8C173d857b8D9C355a8d618c615a418443d098eA,0xDAFEA492D9c6733ae3d56b7Ed1ADB60692c98Bc5
11257,15627906,153378,29106786626,152202,1176,266,8325,0xD249942f6d417CbfdcB792B1229353B66c790726,0xb18ccf69940177F3Ec62920dDb2A08eF7CB16E8f
11258,15627906,222222,15507362806,220658,1564,394,276,0x1Fa8559e873f698292766790AeCf8080A66433F6,0x196B2968397A48689038966c83CB71b30d4782C3
11259,15627906,90000,15473159056,90000,0,2,784419,0x9259219a9d0FF26ffb7e13B269a056d4658A78D7,0xcaD621da75a66c7A8f4FF86D30A2bF981Bfc8FdD
11260,15627906,251581,15375115773,250557,1024,202,4709947,0x7Fc66500c84A76Ad7e9c93437bFc5Ac33E2DDaE9,0x2FAF487A4414Fe77e2327F0bf4AE2a264a776AD2
11261,15627906,84276,15232038809,83300,976,202,355161,0xA0b86991c6218b36c1d19D4a2e9Eb0cE3606eB48,0x7abE0cE388281d2aCF297Cb089caef3819b13448
11262,15627906,88958,15000000000,87594,1364,330,12,0x4976fb03C32e5B8cfe2b6cCB31c09Ba78EBaBa41,0x03cc71FBe5E1620f5a3D9aC2135642260ADC82bb
11263,15627906,69872,14507362806,68928,944,138,99,0xFDBf91A7F2d757A9815326af5E1e60319571984c,0xf9937382833256438041Ee09881396E98F6D6AeF
11264,15627906,48780,14507362806,48184,596,138,3416,0xA0b86991c6218b36c1d19D4a2e9Eb0cE3606eB48,0xfB183eb452CEe258c7e429610cb7d9e2a5fA68Ff
11265,15627906,222222,14000000000,220658,1564,394,175,0x1Fa8559e873f698292766790AeCf8080A66433F6,0x182D565da9a0B7b2895b66EC75417FD392e00Bc4
11266,15627906,70000,14000000000,69416,584,138,3,0xdAC17F958D2ee523a2206206994597C13D831ec7,0x33c304f2c7AEA6EC194Ef657215E9606DcDD915C
11267,15627906,21000,13744838014,21000,0,2,0,0x6f375F9Dd0f5D2A558451a89dfc744C69C4D8f42,0x4fdF69FE1B23Cc17b75a21c363f988749c2d8763
11268,15627906,21000,13580000000,21000,0,2,0,0x6dfc34609a05bC22319fA4Cce1d1E2929548c0D7,0xE0841FC56BC4ED2cA4CD4A80F92BF0540Af43785
11269,15627906,21000,13575862492,21000,0,2,7,0x00CD0BB7f00D725B0660107a211B6581fF2F464F,0x59fFC51A482e945df44c9E42904019e936d31825
11270,15627906,21000,13508362806,21000,0,2,1926,0xB2DCFEDdc3F44c298eEDdFAad74e4f211dC0F666,0x3EEBBEBeCde31d36D6AA7AA4FE2A06159119b659
11271,15627906,140088,13507362806,138524,1564,394,27,0x1Fa8559e873f698292766790AeCf8080A66433F6,0x9949aEb6A3E8762E22bE61469eE22C9CC242e94F
11272,15627906,140088,13507362806,138524,1564,394,25,0x1Fa8559e873f698292766790AeCf8080A66433F6,0x36e83A97bF311D0138BFACEf6987DB7bd3222e69
11273,15627906,162396,13507362806,155504,6892,1810,270,0x00000000006c3852cbEf3e08E8dF289169EdE581,0x9f9f226D5f2048373c94Fa2204DC90f4Bba8dD2c
11274,15627906,207128,13507362806,206508,620,138,3199188,0xdAC17F958D2ee523a2206206994597C13D831ec7,0x9696f59E4d72E237BE84fFD425DCaD154Bf96976
11275,15627906,140088,13507362806,138524,1564,394,19,0x1Fa8559e873f698292766790AeCf8080A66433F6,0xc85f7379905D320243FCd5421e4Fcb93D05d35A4
11276,15627906,140073,13507362806,138521,1552,394,25,0x1Fa8559e873f698292766790AeCf8080A66433F6,0xbD8ba47B1e0c30927E80A73759DCbf8706FF77a4
11277,15627906,188286,13507362806,184646,3640,1162,902,0x68b3465833fb72A70ecDF485E0e4C7bD8665Fc45,0x99291eaEC9f3208bC4e3621bb92Ca8F701Dc211e
11278,15627906,52017,13507362806,51065,952,202,322,0x1Fa8559e873f698292766790AeCf8080A66433F6,0x481c6116506B890308C239Cc6E7053Fe72AD0Cdd
11279,15627906,55950,13507362806,55006,944,138,1310,0x6097004C68F7B350d72226003226Ac089597D579,0xBB14E70d0dBeE8B4BCf1b13A0a175075d4A274DB
11280,15627906,100000,13507362806,99036,964,202,88944,0xdAC17F958D2ee523a2206206994597C13D831ec7,0x3018018c44338B9728d02be12d632C6691E020d1
11281,15627906,55951,13507362806,55007,944,138,1477,0xeE3FC268418f54cFEb7817cc52C642489A5DF098,0xf8F3257Eb61a71aB9c6b31a8c21ca3d2A88d59ec
11282,15627906,740000,13507362806,728992,11008,2506,65465,0xCFC1C64e721bC034ab894302B78149b3C7a1066d,0x57CD4848b12469618b689163f507817940AccA02
11283,15627906,388637,13507362806,382185,6452,1740,100,0x881D40237659C251811CEC9c364ef91dC08D300C,0x8bA6C358fC7513369d32DCe31bECb5Eee52Ab11F
11284,15627906,42000,13507362806,42000,0,2,329561,0xBB738526e92FE67A8D5944C0Dd8Fe71e814Fc01E,0x9430801EBAf509Ad49202aaBC5F5Bc6fd8A3dAf8
11285,15627906,247006,13507362806,243754,3252,1034,565,0x68b3465833fb72A70ecDF485E0e4C7bD8665Fc45,0xd1Cd6e571a6b9106552464c0e47210EF397E5571
11286,15627906,181476,13507362806,179912,1564,394,2701,0x1Fa8559e873f698292766790AeCf8080A66433F6,0x41a420856b3828462eA555c736cAa93Ccf022391
11287,15627906,238948,13507362806,236164,2784,842,1480,0x68b3465833fb72A70ecDF485E0e4C7bD8665Fc45,0xa12B0Fa4104569906c018Eb3541e6605ffe8e54b
11288,15627906,21000,13410000000,21000,0,2,0,0x6dfc34609a05bC22319fA4Cce1d1E2929548c0D7,0x5fBcF32FeAb411B63c290CAe05e09118A1178959
11289,15627906,21000,13200000000,21000,0,2,19,0xae79D1a2f595E810bf7606D02064DbD327ca057b,0x591dB921a4906Df8185B4674ed540fD1fD9Ea048
11290,15627906,28594,13117362806,27874,720,146,222,0xC02aaA39b223FE8D0A0e5C4F27eAD9083C756Cc2,0x1F847A01cbC91dD8ab4ec05Bf16e5F655dF08f11
11291,15627906,46121,13107362806,45501,620,138,188,0xdAC17F958D2ee523a2206206994597C13D831ec7,0xE739051749C9Cd2cE60D9F25b710e64E03E1F382
11292,15627906,150000,13060796593,149404,596,138,45196,0xC77Ad0a71008d7094a62cFbD250a2eB2AfdF2776,0xa7fB5cA286Fc3FD67525629048a4de3bA24Cba2E
11293,15627906,225757,13052000000,224313,1444,394,4,0x3b3ae790Df4F312e745D270119c6052904FB6790,0xE43B61Ba1D9745f410e0B7a7A89b55C1c9E57317
11294,15627906,541843,13040854668,525555,16288,5266,2896,0x1111111254fb6c44bAC0beD2854e76F90643097d,0xf27Fc78282c865f34a5D3BBdA59238D9B65BcAb6
11295,15627906,262726,13007362807,260446,2280,650,106638,0xA69babEF1cA67A37Ffaf7a485DfFF3382056e78C,0x9AAb3F81604c683a1a0D14019FBfe15bef7aA1ee
11296,15627906,99786,13007362806,97906,1880,330,312,0x000000000000509081d6FCD3ee63e791aD1db763,0x8F1ce698746D93B06152066ED8DBE359245AbA65
11297,15627906,279963,13007362806,276715,3248,714,83,0x7a250d5630B4cF539739dF2C5dAcb4c659F2488D,0xbb526dF2Adf2b4A9cF00d931c960BF343827B621
11298,15627906,313321,13007362806,299397,13924,4618,1378,0x83C8F28c26bF6aaca652Df1DbBE0e1b56F8baBa2,0xA2B0E6cF670740e0c0DF7bfcAf6B79684988a6F3
11299,15627906,229588,13007362806,226840,2748,842,1139,0x68b3465833fb72A70ecDF485E0e4C7bD8665Fc45,0x6d01af8711133DEE2B2edfC54DC6Ce38223f8396
11300,15627906,150432,13007362806,149104,1328,330,14140,0xA0c68C638235ee32657e8f720a23ceC1bFc77C77,0xD54e4f8A55247487dd7C8c59f14EE5c0c2889477
11301,15627906,181476,13007362806,179912,1564,394,587,0x1Fa8559e873f698292766790AeCf8080A66433F6,0x30202cc3d9593f3511924C0192cD101bD393738E
11302,15627906,46267,13007362806,45691,576,74,502,0x283Af0B28c62C092C9727F1Ee09c02CA627EB7F5,0xb46d81875005228e1da4eDB50e229683972a8375
11303,15627906,52872,13007362806,51920,952,202,31,0x83565d91809Ab9c0D4d4d5a74610095264aBa4Ce,0x7542eB9FA33Cd07EFf75D20F0dC4015321546F85
11304,15627906,149633,13007362806,143045,6588,1802,21,0x00000000006c3852cbEf3e08E8dF289169EdE581,0x57B2F7aA809645765E4a9a2e19ECb83fde4F24bF
11305,15627906,232107,13007362806,231307,800,330,126,0xC29C38D309D72Aec5489B1c98B4E5cA34cF8Dc9E,0xdD9962aA2Afdc842B3a09A344886E2309158c636
11306,15627906,21000,13007362806,21000,0,2,13,0x068A6304F670e1D01Df4285F009a56F56B26ECce,0x790E46C554c4ED0FBdd0F5F1495EC7d6d7894Ae0
11307,15627906,21000,13007362806,21000,0,2,330,0x8712F58C0D39C6Fbb61F842C84e8C2B425c8c8eb,0x1750fAa03511E5BbaF0713f9692F461E4a3985eE
11308,15627906,69145,13007362806,68549,596,138,210,0xdAC17F958D2ee523a2206206994597C13D831ec7,0x37b3805388479f7b47940B8c190c9E32efD82Fb5
11309,15627906,237897,13007362806,231585,6312,1802,1924,0x00000000006c3852cbEf3e08E8dF289169EdE581,0x28ec4b9785C3D7E4dB5017D3CD09224136F7Ff34
11310,15627906,48863,13007362806,47551,1312,202,349,0x57f1887a8BF19b14fC0dF6Fd9B2acc9Af147eA85,0xd3AfEA7C924cBbFe8C3B514cefb6dbd505788Fa3
11311,15627906,21000,13007362806,21000,0,2,9,0xDA7A7F4624FFBc47735190041371aE91Ba85c902,0x8f48C1ff8d3Fe32F035DD2e52FF8Fabc620a76C6
11312,15627906,73188,13007362806,72580,608,138,124,0xA0b86991c6218b36c1d19D4a2e9Eb0cE3606eB48,0x92cEb2341A91fAc7381F585516806a13bFB34Ff4
11313,15627906,21000,13007362806,21000,0,2,91,0x9b62D7b1Bd0457D923DB2c3Dde7979e5E295732f,0xfcAEd3c07DAa9Af2A4Ff266B0DFBD5214FE25f24
11314,15627906,146900,13007362806,140260,6640,1810,54,0x00000000006c3852cbEf3e08E8dF289169EdE581,0x423a056d9AA86d9F215EDc0D6f11491dc7429F95
11315,15627906,246416,13007362806,243596,2820,842,252,0x68b3465833fb72A70ecDF485E0e4C7bD8665Fc45,0x4700e91062e2D4926489a87485F1af38e086dA47
11316,15627906,94795,13007362806,94199,596,138,79,0xdAC17F958D2ee523a2206206994597C13D831ec7,0x4FDDAD751d5716a66cd036f389334D451EF63fdb
11317,15627906,96299,13007362806,95347,952,202,175,0x123b30E25973FeCd8354dd5f41Cc45A3065eF88C,0x10c71Fb754cf5e4dAD96fB42Ea7aA9ba2E05807E
11318,15627906,195735,13007362806,192999,2736,842,3,0x68b3465833fb72A70ecDF485E0e4C7bD8665Fc45,0x2C18B2b26EFd5e0A062f7925E15Aab1Fc10E58e7
11319,15627906,611684,13007362806,566284,45400,15826,824,0x00000000006c3852cbEf3e08E8dF289169EdE581,0x9a09ef13a5e89235484c1C3F7B934D8D5A9E8046
11320,15627906,46109,12650000000,45501,608,138,321,0xdAC17F958D2ee523a2206206994597C13D831ec7,0xd34d98b3026E0d1Aa0b4Da6FAD1A6bcE5027e205
11321,15627906,294169,12507362806,280245,13924,4618,611,0x83C8F28c26bF6aaca652Df1DbBE0e1b56F8baBa2,0xa7c3f481810149f3853993abC4E85C49023CD2B6
11322,15627906,175110,12507362806,173546,1564,394,37,0x1Fa8559e873f698292766790AeCf8080A66433F6,0x30664D66212e917b7f031d6c488915A2fD185548
11323,15627906,181476,12507362806,179912,1564,394,1066,0x1Fa8559e873f698292766790AeCf8080A66433F6,0xe713a75d8bc2f29F42b0d2C2BE3370E65A62b5Eb
11324,15627906,69400,12507362806,68824,576,74,898,0x283Af0B28c62C092C9727F1Ee09c02CA627EB7F5,0x42E2f1c250d46e3d13102a2e1da6298bB8116F87
11325,15627906,181476,12507362806,179912,1564,394,160,0x1Fa8559e873f698292766790AeCf8080A66433F6,0x91B7Da286D8887Efe8907B34760C98B624F56a62
11326,15627906,113310,12507362806,113106,204,74,418,0x5D004ddB5D92938dAF8448b9eac1CaA593cd26Ca,0x26DC5D39Bd7A8bc2d792dcAAAC55FE6DCef25593
11327,15627906,76672,12507362806,75728,944,138,2,0xfC98e825A2264D890F9a1e68ed50E1526abCcacD,0x7497D64c9CCc21B8Ff6c4dEaC7e9fe9c8059BA3f
11328,15627906,181476,12507362806,179912,1564,394,167,0x1Fa8559e873f698292766790AeCf8080A66433F6,0xc456E918889145eeAEff958B7a54168865552198
11329,15627906,181476,12507362806,179912,1564,394,273,0x1Fa8559e873f698292766790AeCf8080A66433F6,0xe756bE93636274396Fef2e03cd4d4CB511F698e6
11330,15627906,600000,12507362806,590640,9360,4490,11617,0xCAF0784E89D2BCa4e9790eA6003947bfE7Ee31B7,0xF165D353abDDb7Cb00052d610254249FCc12a8C7
11331,15627906,121018,12507362806,120446,572,138,45,0x1748B24faf9780B74E5A9f3Feb41553E712E94aa,0x6819eA7792CC89394fEEE84FC70d54a67cD0B765
11332,15627906,181476,12507362806,179912,1564,394,715,0x1Fa8559e873f698292766790AeCf8080A66433F6,0xCE049b5D72Ca7fc71Cf4f2e93ebc2413a3530EF5
11333,15627906,181476,12507362806,179912,1564,394,39,0x1Fa8559e873f698292766790AeCf8080A66433F6,0x8bC01c3A784398993D7351a9c415f2aF76d494DC
11334,15627906,181458,12507362806,179906,1552,394,53,0x1Fa8559e873f698292766790AeCf8080A66433F6,0x7986A5cFacA96c93a7b48551fd192b71046af910
11335,15627906,181476,12507362806,179912,1564,394,232,0x1Fa8559e873f698292766790AeCf8080A66433F6,0xAd9C9fF69bfcC37c73fbaAda6D1bA53404Bcc228
11336,15627906,181458,12507362806,179906,1552,394,589,0x1Fa8559e873f698292766790AeCf8080A66433F6,0x93fDb06Cff65f22cEc66C88554D9907E5585Ea5e
11337,15627906,21000,12328708484,21000,0,2,0,0xC098B2a3Aa256D2140208C3de6543aAEf5cd3A94,0x2Fe20FBCd2e7Adacf16522AA6aD1858B6A674Cae
11338,15627906,444062,12317465307,431166,12896,3858,8,0x1111111254fb6c44bAC0beD2854e76F90643097d,0x118A15552139346412eC765B20eeD843ce22822A
11339,15627906,242503,12226905328,239743,2760,842,135,0x68b3465833fb72A70ecDF485E0e4C7bD8665Fc45,0xE0be3112F71fee89cC14ef59F1F6C8840BC0b799
11340,15627906,46109,12147362806,45501,608,138,15,0xdAC17F958D2ee523a2206206994597C13D831ec7,0xfEF7f2A4dBe9f8B7D2180c2CdE2E0C4caEc52B94
11341,15627906,65000,11507974816,64392,608,138,646176,0xdAC17F958D2ee523a2206206994597C13D831ec7,0x29D5527CaA78f1946a409FA6aCaf14A0a4A0274b
11342,15627907,2000003,10940851212,1998975,1028,174,15391,0x00000000003b3cc22aF3aE1EAc0440BcEe416B40,0xb7aB1DE5b259a880c4BB5451bDbE6f80F3798538
11343,15627907,511886,12440851212,508282,3604,970,1150,0x68b3465833fb72A70ecDF485E0e4C7bD8665Fc45,0x3B722bfB1c27B1Edc6C9C2e057c590a9ee57B2b0
11344,15627907,584063,548731692378,583023,1040,174,15392,0x00000000003b3cc22aF3aE1EAc0440BcEe416B40,0xb7aB1DE5b259a880c4BB5451bDbE6f80F3798538
11345,15627907,105087,10940851212,104375,712,130,5201,0xE8c060F8052E07423f71D445277c61AC5138A2e5,0x971aC48e6F904406edBC22687ED92Bc8966fe551
11346,15627907,1000000,11940851212,998164,1836,458,6338,0xd9e1cE17f2641f24aE83637ab66a2cca9C378B9F,0x329aFA43F8c89F65Fb6b22397c1A098EA4210D7E
11347,15627907,95567,232519079499,94535,1032,170,5202,0xE8c060F8052E07423f71D445277c61AC5138A2e5,0x971aC48e6F904406edBC22687ED92Bc8966fe551
11348,15627907,213768,10940851212,213032,736,130,10553,0xE8c060F8052E07423f71D445277c61AC5138A2e5,0xb8feFFAC830C45b4Cd210ECDAAB9D11995D338ee
11349,15627907,319338,11940851212,317418,1920,458,31,0x7a250d5630B4cF539739dF2C5dAcb4c659F2488D,0x8617d3B9f2C24a109BF18831fE358038AaB7034F
11350,15627907,157089,193602385604,156033,1056,170,10554,0xE8c060F8052E07423f71D445277c61AC5138A2e5,0xb8feFFAC830C45b4Cd210ECDAAB9D11995D338ee
11351,15627907,193760,24887644142,192664,1096,166,2100,0x40Cd64cf6F2Ed6E86790FC39EDC3A91B91cb6d12,0x0ddFF0c42AAA6870CFd79D0050a0387134Aa5163
11352,15627907,241814,10940851212,239642,2172,650,97408,0xA69babEF1cA67A37Ffaf7a485DfFF3382056e78C,0x76e40D0a69Fd81826B5eb7D18145626d46EAFdef
11353,15627907,46386,12150853412,45442,944,138,41,0xa117000000f279D81A1D3cc75430fAA017FA5A2e,0xBc13D80CB3FD572FDBc64210DE762dcb8Bd93469
11354,15627907,282294,12040852212,277110,5184,1484,42,0x881D40237659C251811CEC9c364ef91dC08D300C,0xBc13D80CB3FD572FDBc64210DE762dcb8Bd93469
11355,15627907,250566,10940851212,248382,2184,650,93264,0xA69babEF1cA67A37Ffaf7a485DfFF3382056e78C,0xFF82BF5238637B7E5E345888BaB9cd99F5Ebe331
11356,15627907,289443,11353709732,287811,1632,278,6144,0xED77777586D73C58EB4D6BEBDF9c85C2d5F56C2d,0x38AccdeB1c62DADE625bCAbDca85701d5f6C8618
11357,15627907,400000,11264680370,398552,1448,330,5125,0x23C8030Cb6e7E9f190F79591a39cc928C55d650F,0xCB949f634DCA0B791981CE5706774ab91E112b3f
11358,15627907,150000,30000000000,149344,656,138,11173686,0xc6e145421FD494B26dCF2BFeB1b02b7c5721978f,0xFBb1b73C4f0BDa4f67dcA266ce6Ef42f520fBB98
11359,15627907,175554,14750000000,174898,656,138,10,0x7db5af2B9624e1b3B4Bb69D6DeBd9aD1016A58Ac,0x994cf915cA1987F4FEBfdf5004CbaB8f0d818869
11360,15627907,81661,13575862492,81005,656,138,4,0x6c6EE5e31d828De241282B9606C8e98Ea48526E2,0xe9292bFD1AaB4e689E3C87723912A9F1d85c849a
11361,15627907,191041,13000000000,190165,876,266,1404,0xd588b586D61C826A0e87919b3D1a239206d58bf2,0xC22d03e13B888Dabb33A1575e4F6542f0e996622
11362,15627907,600000,12940851212,596200,3800,1290,2828,0xed136c7f420f35e43D43ff73FA2C0c259718749e,0x40D0F1c7979CD5E91f52a0FE00a1c61b466BAa15
11363,15627907,181476,12940851212,179912,1564,394,250,0x1Fa8559e873f698292766790AeCf8080A66433F6,0xC1D4aa6De06e9d7F49d9ED18c633104B5b4BF275
11364,15627907,201931,12940851212,199183,2748,842,2623,0x68b3465833fb72A70ecDF485E0e4C7bD8665Fc45,0x5B8f487765cF8F88Db19C19e2409B51A59Df084C
11365,15627907,300000,12540851212,297632,2368,586,278,0xd9e1cE17f2641f24aE83637ab66a2cca9C378B9F,0x49b2d9EF9658007d2d5A4Bf0d9E78F1ae0457AA7
11366,15627907,48668,12440851212,47724,944,138,8,0x2260FAC5E5542a773Aa44fBCfeDf7C193bc2C599,0xc86eb5D3df4A68A6ae0A37fd789edd6E8A29474e
11367,15627907,36027,12440851212,35751,276,74,27,0xC02aaA39b223FE8D0A0e5C4F27eAD9083C756Cc2,0x8001E22B2b3948E8B2cEDCa34e0c1eAF24a7B648
11368,15627907,21000,12440851212,21000,0,2,1236,0x0a15289bDb52F1051Ddb428D907a6f444656E33b,0xb396D5EdcbFaB009cBF4602329371F908118d115
11369,15627907,599210,12440851212,564018,35192,12306,1074,0x00000000006c3852cbEf3e08E8dF289169EdE581,0x565cea2Fd86FF22694ad53167E715FB81F4395AE
11370,15627907,73188,12440851212,72580,608,138,52,0xA0b86991c6218b36c1d19D4a2e9Eb0cE3606eB48,0xf9dB50c51279E9cd52aD4EA7853750b58B3c0765
11371,15627907,147590,12440851212,143566,4024,778,1319,0x23E79722Bb8B55a0d04f3AFbCFC34eb771526Adb,0x4642D9D9A434134CB005222eA1422e1820508d7B
11372,15627907,237534,12440851212,192130,45404,13194,777,0x74312363e45DCaBA76c59ec49a7Aa8A65a67EeD3,0xCBb2534C6898655d50FDaC79D6E4B23b18a25B97
11373,15627907,21000,12440851212,21000,0,2,201,0xe5ae2923a8E55421AcfD1e19679B2104540D2Eb7,0x10d87be26cFA2EE07b2E2F7E2C27c08b61c43b68
11374,15627907,323000,12440851212,317568,5432,1482,3393,0x68b3465833fb72A70ecDF485E0e4C7bD8665Fc45,0x3D61d3da40a372CA317832717d7E6205cEDb439b
11375,15627907,178160,12440851212,174592,3568,1162,4,0x68b3465833fb72A70ecDF485E0e4C7bD8665Fc45,0xF81104d66bE8b2D7bDeadA73FC64BC8d909A0333
11376,15627907,99244,12440851212,98636,608,138,178,0xA0b86991c6218b36c1d19D4a2e9Eb0cE3606eB48,0x29d3144Fcbfd9450Cf33cc56b5E706617e5Bc1aC
11377,15627907,51490,12440851212,50298,1192,394,247,0xD152f549545093347A162Dce210e7293f1452150,0xaeC405274c1aDB1BDdE9d50E015320DD7a12Eb09
11378,15627907,46274,12440851212,45642,632,138,15,0x1EA48B9965bb5086F3b468E50ED93888a661fc17,0xaaFA6b898A43b61F576bc71513A0ac23Ca0220b7
11379,15627907,181476,11940851212,179912,1564,394,60,0x1Fa8559e873f698292766790AeCf8080A66433F6,0xE08701df8a6799aEcDC00AcACF19188e6Ae9E561
11380,15627907,181476,11940851212,179912,1564,394,213,0x1Fa8559e873f698292766790AeCf8080A66433F6,0x52579f87Cc8565E5AA3766328eEF015aa8797D15
11381,15627907,175110,11940851212,173546,1564,394,253,0x1Fa8559e873f698292766790AeCf8080A66433F6,0x800b87c7602976bFB7c4b05F454ea68F7229f01f
11382,15627907,55897,11659494535,54953,944,138,43,0xFDBf91A7F2d757A9815326af5E1e60319571984c,0xf958F19fd86CB409Da8a1D5E2566db9624A5b79c
11383,15627907,46103,11000000000,45615,488,138,1,0x346378C67d0F71343F80299ed8C0407aC2Df05eB,0x3212DF3e23a01c4c0ebA025E6d7Fc12188936996
11384,15627907,69064,11000000000,68112,952,202,2228,0x346378C67d0F71343F80299ed8C0407aC2Df05eB,0x0A24b03fA2CB9b51AF900C68600B3f70211b3540
11385,15627907,30000,10940851212,30000,0,2,3676,0xF56EB8280970451b109F823963008F033Eaa1ca2,0xF2f5C73fa04406b1995e397B55c24aB1f3eA726C
11386,15627908,534196,62605924836,526568,7628,1524,53740,0x0000000000007F150Bd6f54c40A34d7C3d5e9f56,0x048Fde2d3d47F54d3E7bE0Be7A40e1cb5AfF5d72
11387,15627908,21000,50000000000,21000,0,2,206384,0xa822fF65cbd0cd7c96007cd41E12A7e07b6bb7E5,0xc35fB86F962ea955751a793a007B5CDd44F798D7
11388,15627908,21000,50000000000,21000,0,2,206385,0x75A97FB3B9737E86d916a4Cc6d2A17329b9BA356,0xc35fB86F962ea955751a793a007B5CDd44F798D7
11389,15627908,307692,25743254368,307692,0,2,96399,0xBbAD96336943A36E3e292D973B3382dd0bA4D1EF,0xBbAD96336943A36E3e292D973B3382dd0bA4D1EF
11390,15627908,181476,20118450220,179912,1564,394,762,0x1Fa8559e873f698292766790AeCf8080A66433F6,0x347Fa469242885F437cca63cFb20a5ab873C5864
11391,15627908,5049560,17000000000,5042424,7136,1098,302,0x0a39DA505DfB5E0BBc6bd84428281A8ba1bC7753,0x495E889d1A6cEB447a57dcc1C68410299392380c
11392,15627908,45000,16113770247,45000,0,2,130783,0x0000000000007F150Bd6f54c40A34d7C3d5e9f56,0x029f388aC4D5C8BfF490550ce0853221030E822b
11393,15627908,21000,15400000000,21000,0,2,233251,0x58dacf1cA22BA8279E1D1cD356b00863cb01E20B,0x9Afa066884cE723200438B672C0B8D5769E03A6A
11394,15627908,181476,15000000000,179912,1564,394,374,0x1Fa8559e873f698292766790AeCf8080A66433F6,0x278247b65DE8DA437e25Ac767C2cD5cD6989B669
11395,15627908,90000,15000000000,89392,608,138,19766,0xdAC17F958D2ee523a2206206994597C13D831ec7,0x356f029FB2f673ca083ea223D5835F4ac00539DD
11396,15627908,300014,14118450220,298806,1208,330,224461,0x98C3d3183C4b8A650614ad179A1a98be0a8d6B8E,0x91aaE0aAfd9D2d730111b395c6871f248d7Bd728
11397,15627908,300014,14118450220,298794,1220,330,92675,0x98C3d3183C4b8A650614ad179A1a98be0a8d6B8E,0x5E2B6c6B2240d582995537D3FafdB556E4A3822F
11398,15627908,222222,14000000000,220658,1564,394,78,0x1Fa8559e873f698292766790AeCf8080A66433F6,0x54DA15b96E01cFB8BDb6e3388F2FF287eb6f91E5
11399,15627908,181476,14000000000,179912,1564,394,566,0x1Fa8559e873f698292766790AeCf8080A66433F6,0x98e0b03e9a722B57CE97EEB0eb2930C6FeC55584
11400,15627908,222222,14000000000,220658,1564,394,86,0x1Fa8559e873f698292766790AeCf8080A66433F6,0x7664a2F15707E104972Ce1A3917913eDD058ebe3
11401,15627908,85119,13986203187,84451,668,138,4709948,0x320623b8E4fF03373931769A31Fc52A4E78B5d70,0x2FAF487A4414Fe77e2327F0bf4AE2a264a776AD2
11402,15627908,21000,13575862492,21000,0,2,0,0xb52B09Cbd5606f83dc34944C25400e1469c386b0,0xA4B90B3b6dFc321697D9f0eFc72Ed2893122c1C4
11403,15627908,175074,13118450220,173534,1540,394,544,0x1Fa8559e873f698292766790AeCf8080A66433F6,0x6f5EED238400430e0281dE0DA4dCF021Af45D35C
11404,15627908,2000000,12917613094,1997928,2072,522,325,0x7a250d5630B4cF539739dF2C5dAcb4c659F2488D,0x158318657de819928C935ae3436Ae2a796bcd681
11405,15627908,181476,12856620170,179912,1564,394,684,0x1Fa8559e873f698292766790AeCf8080A66433F6,0x9732d496B1fc582eD20EC0d0F8337F7e8Cf0A921
11406,15627908,143796,12618450220,143592,204,74,28,0x7F9306FC1978938d5C1C57Bf6044dc67E07eeB8a,0x99dac5def66E9fEc67Ed69D274d4D42370A75FB2
11407,15627908,21000,12618450220,21000,0,2,0,0xDbAD0E8a2497C9dbD0AC9083f9850c5a4d90B0C2,0xc830d6bF563C63Abc0073B3F2Ca7dc28f7c2409b
11408,15627908,21000,12618450220,21000,0,2,67396,0xB32c4DF056f086Cb614782697C3BCE689D83537D,0x963737C550E70FFe4D59464542a28604eDb2eF9a
11409,15627908,332313,12488450220,330333,1980,458,31,0x3b3ae790Df4F312e745D270119c6052904FB6790,0xC8A1768652cFD807a252Cc94DA60EDeB3B04b5d5
11410,15627908,169628,12118450220,163204,6424,1738,205,0x00000000006c3852cbEf3e08E8dF289169EdE581,0xF9E229b3323Bd3f87d80fd578b93d91fE0cFf0Ca
11411,15627908,244446,12118450220,239966,4480,1420,221,0x881D40237659C251811CEC9c364ef91dC08D300C,0x6c7C127EDfccb1288936b2df71293DB41DD021A0
11412,15627908,69529,12118450220,68921,608,138,19,0xdAC17F958D2ee523a2206206994597C13D831ec7,0x7aFAAbA65633c8dD138ba1b10a6b67aA0cee5183
11413,15627908,21000,12118450220,21000,0,2,30,0x998236fcf8A811f83e479F267b8FDa636ed0d8bd,0x998236fcf8A811f83e479F267b8FDa636ed0d8bd
11414,15627908,207128,12118450220,206508,620,138,3199189,0xdAC17F958D2ee523a2206206994597C13D831ec7,0x9696f59E4d72E237BE84fFD425DCaD154Bf96976
11415,15627908,207128,12118450220,207128,0,2,3492293,0x3fD254b46316B3aeCbdAD659936F4107cB16Ef8b,0x56Eddb7aa87536c09CCc2793473599fD21A8b17F
11416,15627908,207128,12118450220,207128,0,2,4468972,0xC2eB680d21FCbF3721CAdB0DF78815545E51ccD1,0x21a31Ee1afC51d94C2eFcCAa2092aD1028285549
11417,15627908,207128,12118450220,206520,608,138,3492294,0xdAC17F958D2ee523a2206206994597C13D831ec7,0x56Eddb7aa87536c09CCc2793473599fD21A8b17F
11418,15627908,42000,12118450220,42000,0,2,329562,0x76CcC8fFF57f2604670406F0420DC9061e821268,0x9430801EBAf509Ad49202aaBC5F5Bc6fd8A3dAf8
11419,15627908,401930,12118450220,398338,3592,1162,18,0x68b3465833fb72A70ecDF485E0e4C7bD8665Fc45,0x020908f3B227Dd0D5913af8Ffe02Cbbb28EAa9f3
11420,15627908,39630,12118450220,39354,276,74,329,0xC02aaA39b223FE8D0A0e5C4F27eAD9083C756Cc2,0x9e743c7eCA2561EE3272cabeD03e9A76b8dF1d30
11421,15627908,39617,12118450220,39353,264,74,322,0xC02aaA39b223FE8D0A0e5C4F27eAD9083C756Cc2,0xc20b23462377bea7A7C1253057F8Ce1a74406Fcf
11422,15627908,181458,12118450220,179906,1552,394,162,0x1Fa8559e873f698292766790AeCf8080A66433F6,0x165c8b55B403C46A646487C52329f54685091b48
11423,15627908,211500,12118450220,191976,19524,4682,483,0x00000000006c3852cbEf3e08E8dF289169EdE581,0x50c7AA78B01Eb084a0bC3ad94A2C8DAFC65D91bC
11424,15627908,69382,12118450220,68818,564,74,10,0x283Af0B28c62C092C9727F1Ee09c02CA627EB7F5,0x725707A1B85A929E6F21Be73301cA0C974CC0aB4
11425,15627908,2000000,12118450220,1994924,5076,1226,171060,0xA9D1e08C7793af67e9d92fe308d5697FB81d3E43,0x7830c87C02e56AFf27FA8Ab1241711331FA86F43
11426,15627908,21000,12118450220,21000,0,2,469171,0xeF6fF10a5075D8137F9c808F88282bF317333C7c,0xb739D0895772DBB71A89A3754A160269068f0D45
11427,15627908,21000,12118450220,21000,0,2,52383,0x1A4E27b6C5fD25fcd46E374102dFd279Ec4488D0,0x7c195D981AbFdC3DDecd2ca0Fed0958430488e34
11428,15627908,2000000,12118450220,1995820,4180,970,171061,0xA9D1e08C7793af67e9d92fe308d5697FB81d3E43,0x7830c87C02e56AFf27FA8Ab1241711331FA86F43
11429,15627908,21000,12118450220,21000,0,2,469172,0xc70E2481ba90eB22a42B06FaAC25A96979Eae297,0xb739D0895772DBB71A89A3754A160269068f0D45
11430,15627908,21000,12118450220,21000,0,2,8804469,0x14780506a321927f75a5EE71BAaf39D152219C41,0x3cD751E6b0078Be393132286c442345e5DC49699
11431,15627908,21000,12118450220,21000,0,2,8804470,0x828f556f391327CAA77d53ac3F8c8b1F1353d7D2,0x3cD751E6b0078Be393132286c442345e5DC49699
11432,15627908,430868,12118450220,425376,5492,1482,10,0x68b3465833fb72A70ecDF485E0e4C7bD8665Fc45,0x37c855ca54014AD2f577823D7b01B18f6B3E2164
11433,15627908,21000,12118450220,21000,0,2,1783214,0x4ebbb2fb847E30FF528C303840f7884D60403019,0x503828976D22510aad0201ac7EC88293211D23Da
11434,15627908,181458,12118450220,179906,1552,394,148,0x1Fa8559e873f698292766790AeCf8080A66433F6,0x4b4e6891c53BEA97Fa7BEa953C9d2Dc7dFEE5573
11435,15627908,21000,12118450220,21000,0,2,1783215,0x066ea15558Ab131222Be3287B569b18737ce9A88,0x503828976D22510aad0201ac7EC88293211D23Da
11436,15627908,180696,12118450220,177044,3652,1162,39,0x68b3465833fb72A70ecDF485E0e4C7bD8665Fc45,0xC42542925B540371708e319df9f093D1Ef49eE2f
11437,15627908,175110,12118450220,173546,1564,394,736,0x1Fa8559e873f698292766790AeCf8080A66433F6,0xA8CFeA1AA0b45ca82bc3BaAa1371890999117964
11438,15627908,181476,12118450220,179912,1564,394,1423,0x1Fa8559e873f698292766790AeCf8080A66433F6,0xB32D39508240cacbC8B0fcCFf4191c330eA6B4b6
11439,15627908,210259,12118450220,190771,19488,4682,1710,0x00000000006c3852cbEf3e08E8dF289169EdE581,0x9f82f46FCaeBE047BF0108e74eb8f7f2E1c0bC68
11440,15627908,500000,12118450220,498028,1972,394,60932,0x585C3d4Da9b533C7e3dF8AC7356C882859298cEe,0xd5cf0Cb9a8DF9B46f077f561d8b76c34A69bD82F
11441,15627908,21000,12118450220,21000,0,2,2,0x621E2b5F4864AAd10e53d4a72F265baEeF3Cfa86,0x6b07ed45a377b998503182D852ED1dD93717Aa78
11442,15627908,175110,12118450220,173546,1564,394,705,0x1Fa8559e873f698292766790AeCf8080A66433F6,0x011Ef908aaa0b116176F4863Ea291EbAC90F6412
11443,15627908,80000,12118450220,79332,668,138,25934,0x090185f2135308BaD17527004364eBcC2D37e5F6,0x8C54EbDD960056d2CfF5998df5695dACA1FC0190
11444,15627908,181476,12118450220,179912,1564,394,1959,0x1Fa8559e873f698292766790AeCf8080A66433F6,0xEEa8e8DADb85CF9774F4201e1942736063e96f27
11445,15627908,175092,12118450220,173540,1552,394,907,0x1Fa8559e873f698292766790AeCf8080A66433F6,0x632DF214F78c98D6D627C60CcfcbA83Bc10029C1
11446,15627908,181458,12118450220,179906,1552,394,908,0x1Fa8559e873f698292766790AeCf8080A66433F6,0x632DF214F78c98D6D627C60CcfcbA83Bc10029C1
11447,15627908,122577,12118450220,121013,1564,394,90,0x1Fa8559e873f698292766790AeCf8080A66433F6,0x7D0c3019607410D7fe3Cc049C1aFbF155bDBe684
11448,15627908,295410,12100000000,293402,2008,466,1972,0x1111111254fb6c44bAC0beD2854e76F90643097d,0x800874e6f4f8B6028f607292Aa7B3D8a9EB83395
11449,15627908,51492,12000000000,51004,488,138,196,0xc92C3B7385F048b2Ba1f7c9639A2fC48F0DAd7c9,0x40B14fF84F1FD993aC788Ce9912B35C55a628481
11450,15627908,46109,12000000000,45501,608,138,191,0xdAC17F958D2ee523a2206206994597C13D831ec7,0x8952Bbb130c1638802D5888B554B6e24D660e9bD
11451,15627908,307692,11769950220,307692,0,2,116843,0x6046945C5B5eF5933b8E73a98A6AD7bF3e031df7,0x6046945C5B5eF5933b8E73a98A6AD7bF3e031df7
11452,15627908,600000,11743284631,599392,608,138,138584,0xdAC17F958D2ee523a2206206994597C13D831ec7,0x974CaA59e49682CdA0AD2bbe82983419A2ECC400
11453,15627908,105000,11743284631,105000,0,2,138585,0xF8d3032C4781100fd8d4401056a8c79B6316353F,0x974CaA59e49682CdA0AD2bbe82983419A2ECC400
11454,15627908,75771,11743284631,71607,4164,842,3782,0x00000000219ab540356cBB839Cbe05303d7705Fa,0x5180db0237291A6449DdA9ed33aD90a38787621c
11455,15627908,21000,11743284631,21000,0,2,78,0xeB605a560181F27C90d62F8E27c5Bef6F9a33157,0x2b0D7B32487B9B6B728A1e1aCcE2cf1DcFd19B20
11456,15627908,138107,11743284631,137531,576,74,3479123,0x485b9a41e8BF06E57BB64c6Ba7cB04f9d53D2d76,0xd24400ae8BfEBb18cA49Be86258a3C749cf46853
11457,15627908,235307,11743284631,233435,1872,458,96,0xEfF92A263d31888d860bD50809A8D171709b7b1c,0xf89e4fB7C052Ec1E01bac3A465eE58380Ee972B4
11458,15627908,75753,11743284631,71601,4152,842,3783,0x00000000219ab540356cBB839Cbe05303d7705Fa,0x5180db0237291A6449DdA9ed33aD90a38787621c
11459,15627908,300000,11718450220,297632,2368,586,720,0xd9e1cE17f2641f24aE83637ab66a2cca9C378B9F,0x06d5c81EeD0A8e15467475b90143D0B98f586fac
11460,15627908,21000,11668450220,21000,0,2,3,0xd705c4517220E9c1fE97f9e3eB0287d650034369,0x2c770990300f5bE567CA03416D48B25f8C97D1CC
11461,15627908,259520,11651942082,256256,3264,1034,2,0x68b3465833fb72A70ecDF485E0e4C7bD8665Fc45,0x3af7bd79BDaf5E4aA5eeeaCAD2df9dB41793c5a2
11462,15627908,306904,11618450220,304520,2384,522,27,0x283Af0B28c62C092C9727F1Ee09c02CA627EB7F5,0x375613Dd7A028aFb7D865FF5f015b5A62474171b
11463,15627908,142848,11618450220,136324,6524,1746,1126,0x00000000006c3852cbEf3e08E8dF289169EdE581,0xe6354edB3D71A675210eAf9e007f37b82A04DDf6
11464,15627908,55950,11618450220,55006,944,138,832,0x6097004C68F7B350d72226003226Ac089597D579,0xb19AD65C65C6c12C6dCe444F740449714A488A7F
11465,15627908,21000,11618450220,21000,0,2,690,0x055B27da717e632b9074BfB1cD556c6d3057BE8b,0xF40E6Ae609aFb91b82B9864D20fD337E9e7D3C2A
11466,15627908,149709,11618450220,143045,6664,1810,129,0x00000000006c3852cbEf3e08E8dF289169EdE581,0xb03cB3d3df64c627096A497362792Ea01A38E1F2
11467,15627908,72878,11618450220,71006,1872,458,112,0xFbdDaDD80fe7bda00B901FbAf73803F2238Ae655,0xdBCa2AA02BC73d7D681c013d7c34391d07eaFD39
11468,15627908,21000,11618450220,21000,0,2,544,0x29f889fAc52A05386073bBa0e047F4873c6e0e0b,0x4075823E2B9b47A53281fafFB10eC9581aAE8296
11469,15627908,51458,11618450220,50970,488,138,14,0x7F9306FC1978938d5C1C57Bf6044dc67E07eeB8a,0x146C11014Edec5705e08568Ea90734F1076db3C6
11470,15627908,388031,11618450220,374103,13928,4242,25,0xDef1C0ded9bec7F1a1670819833240f027b25EfF,0x8785Bd90b0d0ee06C8D33dF8Ccbf57BF5dBd7C0C
11471,15627908,181476,11618450220,179912,1564,394,25,0x1Fa8559e873f698292766790AeCf8080A66433F6,0x55fd78E19b164514846B2DBD62fdCBF53529E33A
11472,15627908,21000,11618450220,21000,0,2,10,0xD54177EF31de7183c7a617F37E89Cf6f62Fd0cd5,0x9D41bECeeBf3E441713C34A483465aB1D57e9CB1
11473,15627908,134401,11618450220,127777,6624,1802,515,0x00000000006c3852cbEf3e08E8dF289169EdE581,0x364DA6FC06c67b246086eDd0Ba5650f420fe10a3
11474,15627908,21000,11618450220,21000,0,2,419,0xD12EF7C6A70659BB97f5669cafe22a1eF575112A,0xD12EF7C6A70659BB97f5669cafe22a1eF575112A
11475,15627908,21000,11618450220,21000,0,2,6,0xA1A252e4e9B8dfaE6b58C6C88a04791dc6B9E558,0xA1F33a82f05b7214A143C97D4A4A73259c0EF26A
11476,15627908,175110,11618450220,173546,1564,394,209,0x1Fa8559e873f698292766790AeCf8080A66433F6,0x36622dfFDc34fDb3D124123181BEeD65188BbB30
11477,15627908,29712,11618450220,29044,668,138,342,0x454BD9E2B29EB5963048cC1A8BD6fD44e89899Cb,0xc8312f842c20BFC59301cb6fE0e7683A9107FDED
11478,15627908,142015,11618450220,135451,6564,1802,5,0x00000000006c3852cbEf3e08E8dF289169EdE581,0xAEB97f1a4e6855D0e7729425A3240019F3c18247
11479,15627908,45399,11618450220,44447,952,202,404,0xC86664e7d2608f881f796ee8E24FA9d4d7598406,0x7D3E5dD617EAF4A3d42EA550C41097086605c4aF
11480,15627908,27938,11618450220,27874,64,10,113,0xC02aaA39b223FE8D0A0e5C4F27eAD9083C756Cc2,0x81a2c6f2676cb7a2E17cA83cf702a633c71619b9
11481,15627908,21000,11618450220,21000,0,2,18,0x688c7Ca99807dE1509D1F100eF46D4B843228Ee4,0x682Cad157D79d73Eb1D93d036B438d6F05084736
11482,15627908,99226,11618450220,98630,596,138,147,0xA0b86991c6218b36c1d19D4a2e9Eb0cE3606eB48,0xD976cB6ca3224faDB54474b1c4AB1B5AC4f82EF2
11483,15627908,137594,11618450220,134318,3276,1034,36,0x0000000000c2d145a2526bD8C716263bFeBe1A72,0xA0b1852234aA69c7377077Bf541304ae2b2Afa68
11484,15627908,146788,11618450220,140188,6600,1802,103,0x00000000006c3852cbEf3e08E8dF289169EdE581,0x48653786839D8eC253D7833DBE9492F346CF488A
11485,15627908,159599,11618450220,156347,3252,1034,4,0x0000000000c2d145a2526bD8C716263bFeBe1A72,0x1eA67003aB749a39b01a7DD5a25CA8463ede1E3D
11486,15627908,93234,11618450220,93170,64,10,367,0xD057B63f5E69CF1B929b356b579Cba08D7688048,0x180C60E5937916C6bcA43a1E404D27559deBc87C
11487,15627908,46135,11618450220,45647,488,138,415,0x1Fa8559e873f698292766790AeCf8080A66433F6,0x0DE9a66f0F9b714c5b987BDCb37A5E2EF1bDA67A
11488,15627908,21000,11618450220,21000,0,2,383,0xcfaEfe6E1a5A8d97F561fBA29fa6dA9552d1A1cA,0xe341d077a0cfba74f492cd0d06F6be3b7C0aF1C9
11489,15627908,60748,11618450220,59816,932,138,3,0xA0b86991c6218b36c1d19D4a2e9Eb0cE3606eB48,0x4aFbA42b2Ad424c8492E67EA915CbF77Ab38ac98
11490,15627908,110739,11618450220,109787,952,202,1781,0xD73ACd7F5099fdd910215Dbff029185F21ffBCf0,0xB972C02761e51C9C502636c5DBF56635b41c1C26
11491,15627908,27938,11618450220,27874,64,10,80,0xC02aaA39b223FE8D0A0e5C4F27eAD9083C756Cc2,0x17ff38F48f36bd691B5322DDb68792000440fdd6
11492,15627908,67472,11618450220,67268,204,74,16,0x8a657ec8f1739e9db5e338eD1b0C3a58324787a4,0xF7A04146F81B7092c04EdFBB1F598a9254C01da3
11493,15627908,178503,11618450220,175719,2784,842,11,0x68b3465833fb72A70ecDF485E0e4C7bD8665Fc45,0x9AFbfC0AD50c707ecBddF0916427eD37819fc941
11494,15627908,58676,11618450220,57732,944,138,9,0xdAC17F958D2ee523a2206206994597C13D831ec7,0x83a375f6FDE8dBf5f8C874c701d7a57f48D030f1
11495,15627908,504708,11618450220,503608,1100,330,882,0xF3E778F839934fC819cFA1040AabaCeCBA01e049,0x7dc6E4BC93b3Cc85f38eD6bF72D2530D245B369B
11496,15627908,21000,11618450220,21000,0,2,345,0xdC6ebFBC41d38534ad69B567CD79C273c5cfd581,0x6c2aeAD097129f346dE7FB0E564A27FC442a0DAD
11497,15627908,229603,11618450220,226843,2760,842,825,0x68b3465833fb72A70ecDF485E0e4C7bD8665Fc45,0x3FFc0798104E28AaA7B8d4F05C6193035d2916E3
11498,15627908,36015,11618450220,35751,264,74,459,0xC02aaA39b223FE8D0A0e5C4F27eAD9083C756Cc2,0x03d276d40979a7DBcdE3af4Df3543d253c11771B
11499,15627908,220546,11618450220,218130,2416,586,191,0xd9e1cE17f2641f24aE83637ab66a2cca9C378B9F,0x6BfE59e8fEaDDfBdBb97F7Da8c6B4550a8bD4ffd
11500,15627908,72878,11618450220,71006,1872,458,113,0xFbdDaDD80fe7bda00B901FbAf73803F2238Ae655,0xdBCa2AA02BC73d7D681c013d7c34391d07eaFD39
11501,15627908,169628,11618450220,163204,6424,1738,345,0x00000000006c3852cbEf3e08E8dF289169EdE581,0xd643aD32B6A7A8b14ecb6c4A5C0eFbFa7379e8D6
11502,15627908,191658,11618450220,172094,19564,4690,1161,0x00000000006c3852cbEf3e08E8dF289169EdE581,0xEd04eff2e061f1FFF5F04bfd97E3B9A07B698855
11503,15627908,46547,11618450220,46059,488,138,703,0xaE351b8Ae55B69A5007618E598dDe89d0a092c37,0x5932Fe40c0c5F1bf781ccC553baa19Be3b846a34
11504,15627908,21000,11618450220,21000,0,2,4,0xF83aa7596C2c0eD33Ee2022f9DCE38F5B724BA44,0x7A0DD67577D580d15271970E2C909c6f14294837
11505,15627908,131198,11618450220,125114,6084,1682,35,0x00000000006c3852cbEf3e08E8dF289169EdE581,0x7d0cbbF6f53aEE1Bd2CeB5CE410336A0265CAF71
11506,15627908,48764,11618450220,47820,944,138,394,0x7D1AfA7B718fb893dB30A3aBc0Cfc608AaCfeBB0,0xf0D55F2476bb2b7CE8e9b1F924444A364D6fb731
11507,15627908,203361,11618450220,202613,748,202,190,0xa218c4f6814d18B8B6db1dAE854a6EEe92DC3769,0x91cd3aE885C86B8d840282f637F8BBefe3565050
11508,15627908,46135,11618450220,45647,488,138,377,0x1Fa8559e873f698292766790AeCf8080A66433F6,0x092AC7F06be7e2a4Dd1Bc49D0F6F44a08CAC12f1
11509,15627908,46135,11618450220,45647,488,138,9,0x1Fa8559e873f698292766790AeCf8080A66433F6,0x84E210b896B982A6C6cCD6775F3F3328b8178AeE
11510,15627908,76984,11618450220,76388,596,138,0,0x083D41d6DD21EE938f0c055CA4fb12268DF0EfaC,0x1402DD78e67E3B7984270123e154D1Fd1F0725e5
11511,15627908,472000,11618450220,470764,1236,224,768,0x57C1e0C2ADf6EECDb135BcF9ec5F23b319be2c94,0xaF9Df30242b311F6C4C8F34A33adA2E783E74ADE
11512,15627908,141893,11618450220,135293,6600,1802,1641,0x00000000006c3852cbEf3e08E8dF289169EdE581,0x8f4f597e38e93084ecdc60878fdaE3767836A91E
11513,15627908,181458,11618450220,179906,1552,394,542,0x1Fa8559e873f698292766790AeCf8080A66433F6,0x11bA2058C71c681e6995B45DB3D3b3a43F8032dF
11514,15627908,21000,11618450220,21000,0,2,40,0x8f63A3f918d9184D76A774faA6efB98cef60995f,0x26AD3414ba5e37De393aAD7A9A633ebEe0a92aD1
11515,15627908,65300,11618450220,64348,952,202,322,0x19b86299c21505cdf59cE63740B240A9C822b5E4,0xa4606Bb11264E40A912dD4cde577986013562d23
11516,15627908,46302,11618450220,45814,488,138,1563,0xBD4455dA5929D5639EE098ABFaa3241e9ae111Af,0x1a9ed0935b8D6790Fd176Ba864fA5330d4AfcAD7
11517,15627908,81484,11618450220,80836,648,266,823,0x63d85ec7B1561818Ec03E158ec125a4113038A00,0xAC197A3Dad2742ea06384A4937C6Fc3d1264729F
11518,15627908,21000,11618450220,21000,0,2,4,0x5d59Bf9677B5936776E6510cDd56937bde19Ad72,0x26d00A4Fd877ED9ECAC3A5987c162eD3a9B7Bd39
11519,15627908,99244,11618450220,98636,608,138,2435,0xA0b86991c6218b36c1d19D4a2e9Eb0cE3606eB48,0x30AeE7a692427143BA7e65eFb7db35D360a0ac51
11520,15627908,28974,11618450220,28414,560,138,491,0x6B175474E89094C44Da98b954EedeAC495271d0F,0x2EceCf5a33d038694133BbF3A22AEAFBc96d4B04
11521,15627908,135599,11618450220,128835,6764,1698,37,0x00000000006c3852cbEf3e08E8dF289169EdE581,0x23e99C8530bD38bE0b73f374d5b4dD30691a1Cb2
11522,15627908,46638,11618450220,46150,488,138,1462,0xCF3bc939f9B2487092936F21cC0757b2b523B7aA,0xc5C096a642bAB3a435485F4E1864dF179670D4cA
11523,15627908,190662,11618450220,184034,6628,1810,44,0x00000000006c3852cbEf3e08E8dF289169EdE581,0xCB52aE567A639b3e57C2CA64399320b50b1Bf312
11524,15627908,181476,11618450220,179912,1564,394,23,0x1Fa8559e873f698292766790AeCf8080A66433F6,0x39A1ab9720a3057F14fa3B0116405D4Ab81Bac1d
11525,15627908,67544,11618450220,66068,1476,458,19,0x9D7743B79e2baCe101E62b189F51D7e1eb097616,0x030ce9d143332f6D9c287414f08e22c145c43c58
11526,15627908,72878,11618450220,71006,1872,458,114,0xFbdDaDD80fe7bda00B901FbAf73803F2238Ae655,0xdBCa2AA02BC73d7D681c013d7c34391d07eaFD39
11527,15627908,61423,11618450220,53271,8152,2506,43,0x00000000006c3852cbEf3e08E8dF289169EdE581,0x88D5c00A887F5242DE709E38EB48dFfB28373871
11528,15627908,181476,11618450220,179912,1564,394,277,0x1Fa8559e873f698292766790AeCf8080A66433F6,0x755C8d16D5298395922d791db8EAEf7294de0Cd4
11529,15627908,46547,11618450220,46059,488,138,712,0xaE351b8Ae55B69A5007618E598dDe89d0a092c37,0x943d4ee3C1f207895E726136198F42b474FF5CCA
11530,15627908,46722,11618450220,46150,572,138,1463,0xCF3bc939f9B2487092936F21cC0757b2b523B7aA,0xc5C096a642bAB3a435485F4E1864dF179670D4cA
11531,15627908,209748,11618450220,207000,2748,842,21,0x68b3465833fb72A70ecDF485E0e4C7bD8665Fc45,0x6EAEe718d196f58E7Cf55eeE746683D1b8f733e3
11532,15627908,21000,11618450220,21000,0,2,187,0xd823D2ea7EaC4D66d7e3cE76B8ccCc0b4C0b55cE,0xd18a1f265e7c6293a5f4244EE513CD5DEB26e5fB
11533,15627908,55950,11618450220,55006,944,138,155,0x6097004C68F7B350d72226003226Ac089597D579,0x4d7618a7a2A8CE5155986841ad09cb1e003D87Ef
11534,15627908,21000,11560000000,21000,0,2,38,0x2F5528B92F357F84156B578f9f39fA11AD207fA0,0x60f0A4747900A24618d0864D06b10F11d89b1d8e
11535,15627908,55861,11331301350,54917,944,138,1376,0xC5a9BC46A7dbe1c6dE493E84A18f02E70E2c5A32,0x24BC7357362cE96a0D38eC64f3216147A5AF8E54
11536,15627908,181476,11118450220,179912,1564,394,694,0x1Fa8559e873f698292766790AeCf8080A66433F6,0x22DbF32CCAE873EaBa60AbEe744ce7269b9c9ddb
11537,15627908,181476,11118450220,179912,1564,394,121,0x1Fa8559e873f698292766790AeCf8080A66433F6,0x83eC34a0D6E37914B381825aC96e4Ab349BAa830
11538,15627908,181458,11118450220,179906,1552,394,1076,0x1Fa8559e873f698292766790AeCf8080A66433F6,0x6C48930A7F215A004C657359bcC5964dA640611C
11539,15627908,181476,11118450220,179912,1564,394,451,0x1Fa8559e873f698292766790AeCf8080A66433F6,0x95Ef28c0d1c01279AffA193Cd4670b621BE06c75
11540,15627908,181476,11118450220,179912,1564,394,459,0x1Fa8559e873f698292766790AeCf8080A66433F6,0xCEEB990C2C87EB5a0E44d16CEc6b61CB5977ee2C
11541,15627908,181476,11118450220,179912,1564,394,1563,0x1Fa8559e873f698292766790AeCf8080A66433F6,0xA745BeF759F71037dAdd3f41CE6D87467217FC72
11542,15627908,181458,11118450220,179906,1552,394,1894,0x1Fa8559e873f698292766790AeCf8080A66433F6,0xE5cF73F96F57d56d6E44BD82D8AF95727A2FAb04
11543,15627908,550000,11118450220,548152,1848,458,90,0x7a250d5630B4cF539739dF2C5dAcb4c659F2488D,0x00804aD8aa538E852f5Bb4A49f8957a783ac132f
11544,15627908,181476,11118450220,179912,1564,394,64,0x1Fa8559e873f698292766790AeCf8080A66433F6,0x2B9A0D776252ACF9b08137be93A358138B736Ce9
11545,15627908,181476,11118450220,179912,1564,394,4978,0x1Fa8559e873f698292766790AeCf8080A66433F6,0x78be4A225dF959a0C2BA8D57430E9b10a3e10338
11546,15627908,181476,11118450220,179912,1564,394,113,0x1Fa8559e873f698292766790AeCf8080A66433F6,0x538A99c0158B9D038b9d7a54295675793A14A5d8
11547,15627908,181476,11118450220,179912,1564,394,122,0x1Fa8559e873f698292766790AeCf8080A66433F6,0x3DC742c3fd93694f0e940d38431C4369d8284D4d
11548,15627908,21000,11118450220,21000,0,2,1,0xe10494a7cc7B1954CA42ed186be75f680A122094,0xfe36860f0Ac143BFf0Bf61D0f741aFA0CBD03adb
11549,15627908,288642,11118450220,286902,1740,458,644,0x7a250d5630B4cF539739dF2C5dAcb4c659F2488D,0xCf9d36AFcD640fDaF482Cd0FD2740FE35E149F8b
11550,15627908,181476,11118450220,179912,1564,394,21,0x1Fa8559e873f698292766790AeCf8080A66433F6,0x6BEaA0599214E6384CA51b668C083E87b45d912A
11551,15627908,157391,11118450220,155355,2036,522,264,0x07F72839D7A71A117fA859cBA643c9291EEba921,0x1B352185145d1aEBCB151F7C28257682c3375336
11552,15627908,181476,11118450220,179912,1564,394,53,0x1Fa8559e873f698292766790AeCf8080A66433F6,0xEC4CF455c9C3e4F4ec97B6612CeAF026bD56a9f7
11553,15627908,181458,11118450220,179906,1552,394,751,0x1Fa8559e873f698292766790AeCf8080A66433F6,0xca404E9190399Bb60e6E907bC22C889E945c1011
11554,15627908,524286,11118450220,521998,2288,390,26586,0xC8046263d5B5544F6413a98B4693488499195A46,0xEf5a3745F822f8F83693564c54904d7FF156CFb2
11555,15627908,181476,11118450220,179912,1564,394,2241,0x1Fa8559e873f698292766790AeCf8080A66433F6,0x2EcfB2F430cAcB4b8361e8F5a08e6c76E42410bE
11556,15627908,313695,11118450220,308731,4964,1674,39472,0x7Ed7382D0EcfeE9Bf1085671CCe4b0A5774a6E89,0x79b7a69d90c82E014Bf0315e164208119B510FA0
11557,15627908,175092,11118450220,173540,1552,394,38,0x1Fa8559e873f698292766790AeCf8080A66433F6,0x74b48ea8e134Ef270E9f75Ac62F33A7f82387c2D
11558,15627908,150756,11118450220,150692,64,10,2,0x65c2e54a4c75ff6da7b6B32369c1677250075fb2,0x473eb485A3af9767E1c68d84E7D59e2270FE0596
11559,15627908,175110,11118450220,173546,1564,394,962,0x1Fa8559e873f698292766790AeCf8080A66433F6,0xB9C1cd3fC666285D3aFFfff4ae4a721E69445DdD
11560,15627908,175110,11118450220,173546,1564,394,288,0x1Fa8559e873f698292766790AeCf8080A66433F6,0xfE77Ae23291F3015b40735EC2891C401780E55B0
11561,15627908,55950,11118450220,55006,944,138,27,0x6097004C68F7B350d72226003226Ac089597D579,0x2fA0B9742959a087C4B2451442725bd251E10dE7
11562,15627908,181476,11118450220,179912,1564,394,132,0x1Fa8559e873f698292766790AeCf8080A66433F6,0xB4510c3128921FFDF5d04e27eD68489FB30334eE
11563,15627908,181476,11118450220,179912,1564,394,157,0x1Fa8559e873f698292766790AeCf8080A66433F6,0x26c8a2C7175F53fc85438D343B5d5C2cC5F46751
11564,15627908,181476,11118450220,179912,1564,394,7,0x1Fa8559e873f698292766790AeCf8080A66433F6,0x0517B9bd7EDd8e30901DDe8E0c52DBB44329b776
11565,15627908,94813,11118450220,94205,608,138,2,0xdAC17F958D2ee523a2206206994597C13D831ec7,0xd35A3dc146d9238B12E9868280448B1019BA0522
11566,15627908,689781,11118450220,686141,3640,1162,473,0x68b3465833fb72A70ecDF485E0e4C7bD8665Fc45,0x2c7Ba425f07c11fc685fC4F4B82632f9782F4930
11567,15627908,181476,11118450220,179912,1564,394,215,0x1Fa8559e873f698292766790AeCf8080A66433F6,0xAE3eD8a340fB76b47621bC03244b1321D39C6de2
11568,15627908,181476,11118450220,179912,1564,394,155,0x1Fa8559e873f698292766790AeCf8080A66433F6,0xde40131e0d03104F86Adc112798e8D460880A84b
11569,15627908,181476,11118450220,179912,1564,394,427,0x1Fa8559e873f698292766790AeCf8080A66433F6,0x9bCF50d39D15b15623E3A57628E3CEAD75890207
11570,15627908,181476,11118450220,179912,1564,394,615,0x1Fa8559e873f698292766790AeCf8080A66433F6,0xc64AaA34Cf9DcE746A4C5dA2A0732CAf86BBDA5d
11571,15627908,181476,11118450220,179912,1564,394,881,0x1Fa8559e873f698292766790AeCf8080A66433F6,0x9c414b57d64Ace933fFBB66CA88ede71E84f97C5
11572,15627908,181476,11118450220,179912,1564,394,383,0x1Fa8559e873f698292766790AeCf8080A66433F6,0x9b029e725CfB7D5dE4A7628Ea6948d55A5F811F0
11573,15627908,303619,11118450220,299991,3628,1162,385,0x68b3465833fb72A70ecDF485E0e4C7bD8665Fc45,0x1453169a1B1Fb2160B4c64E573c2296CB131143A
11574,15627908,334944,11118450220,333036,1908,458,18,0x7a250d5630B4cF539739dF2C5dAcb4c659F2488D,0x0cB5B5C356FcE965b26683E0B3854a6f098108aC
11575,15627908,150756,11118450220,150692,64,10,5,0x65c2e54a4c75ff6da7b6B32369c1677250075fb2,0x9B40c539eF01a8Cb4534A78fb57cE566be3704f1
11576,15627908,55906,11118450220,54962,944,138,350,0x6274f70C1C366Fff461245d5a900D962B2F32cf7,0xAF4572dBDacdAB64c30a3bE96214103e32eFdb0E
11577,15627908,181476,11118450220,179912,1564,394,258,0x1Fa8559e873f698292766790AeCf8080A66433F6,0x84F5EaAB08Ef8f0C48B58f8586B1e66f39fa0f0B
11578,15627908,181476,11118450220,179912,1564,394,630,0x1Fa8559e873f698292766790AeCf8080A66433F6,0x2Ea9A81eF9F2E1615B1D27526a745d72d592CE15
11579,15627908,181476,11118450220,179912,1564,394,1021,0x1Fa8559e873f698292766790AeCf8080A66433F6,0x7B17fF234a0C625a454ebBdBcbF2DcC34c341CD8
11580,15627908,238963,11118450220,236167,2796,842,431,0x68b3465833fb72A70ecDF485E0e4C7bD8665Fc45,0x974Ac046dEB027e5939Cf48A087561A99d7Ad477
11581,15627908,181476,11118450220,179912,1564,394,0,0x1Fa8559e873f698292766790AeCf8080A66433F6,0xA5e08D8846C914aD985fC05f9E6fd6B1C0144DB9
11582,15627908,181476,11000000000,179912,1564,394,109,0x1Fa8559e873f698292766790AeCf8080A66433F6,0xbB5adeD238318e9BF0a35e9F07B4F093262E9563
11583,15627908,21000,11000000000,21000,0,2,6,0x2EeC31e27674E53b10181fE83Fc3fd58C228b6B6,0xfEaD7c34628f43f5810522338B8cA39c68736781
11584,15627908,305739,10872091647,304627,1112,144,291,0xdb7A53E6AE058E1Dcf4502341E2ADFA522E2B29F,0xa23cABeCa2145Ce4e6fdD81a45be8fB53A4F9535
11585,15627908,600000,10856620170,599392,608,138,138586,0xdAC17F958D2ee523a2206206994597C13D831ec7,0x974CaA59e49682CdA0AD2bbe82983419A2ECC400
11586,15627908,105000,10856620170,105000,0,2,138587,0x8a8C6E80E33b1fc2A4d82E0Cc24c22B33f52eCCe,0x974CaA59e49682CdA0AD2bbe82983419A2ECC400
11587,15627908,21000,11743284631,21000,0,2,138588,0xd350FD242AF1c5469e196A9776373176c9838dBB,0x974CaA59e49682CdA0AD2bbe82983419A2ECC400
11588,15627908,191077,10856620170,190177,900,266,156,0xd588b586D61C826A0e87919b3D1a239206d58bf2,0xFF714e5735424170352E19f0Fcd4Ccb87E86BF2C
11589,15627908,216211,10856620170,214327,1884,458,1655,0xEfF92A263d31888d860bD50809A8D171709b7b1c,0x3d26b43dD2181471b46cF484dd8c06C47c050d4C
11590,15627908,21000,10722455636,21000,0,2,7,0xd5FBDa4C79F38920159fE5f22DF9655FDe292d47,0xD4Ea889c0f692E565F302F9C2f992553E5C8f01b
11591,15627908,21000,10381697994,21000,0,2,2,0xd952bEECffC6Bc1228E83d0457d25D5a39555abf,0xfdB30EA04fB4e77809A949f95cD961a247e88933
11592,15627908,46364,10354372045,45420,944,138,4,0xC02aaA39b223FE8D0A0e5C4F27eAD9083C756Cc2,0x08FAB9B2d5d34bEA9f50F20dE8b7D3085d9E0282
11593,15627908,65000,10354372045,64392,608,138,157061,0xdAC17F958D2ee523a2206206994597C13D831ec7,0x8C8D7C46219D9205f056f28fee5950aD564d7465
11594,15627908,120000,10354372045,120000,0,2,118858,0xF76eC352793Eb2836f83DD22bAC72Fa68Cd82871,0x86D3E894b5CDb6a80affFd35eD348868fb98DD3f
11595,15627908,323280,10354372045,158460,164820,20810,183257,0x5E4e65926BA27467555EB562121fac00D24E9dD2,0x6887246668a3b87F54DeB3b94Ba47a6f63F32985
11596,15627908,63197,10284203750,62601,596,138,2,0xdAC17F958D2ee523a2206206994597C13D831ec7,0x6Dd7230B29b68Ff85f711a1c64B6d76624b3A7aA
11597,15627908,2000000,10197138133,1997940,2060,522,220,0x7a250d5630B4cF539739dF2C5dAcb4c659F2488D,0x3537c0a9D538c9dDA35CC8864e28075efbA5D698
11598,15627908,1250222,10157094596,1165414,84808,10900,0,,0x38834189F1F92BF15ad38DAe4cE58DBE52D28681
11599,15627909,278685,10627835264,277201,1484,240,8824,0x57C1e0C2ADf6EECDb135BcF9ec5F23b319be2c94,0x479Bc00624e58398f4Cf59D78884d12Fb515790A
11600,15627909,188863,10627835264,188219,644,90,103252,0x01FF6318440f7D5553a82294D78262D5f5084EFF,0x5AA17fC7F2950ECa85376C3A8CB1509e8e4B39dF
11601,15627909,319338,15627835264,317418,1920,458,219,0x7a250d5630B4cF539739dF2C5dAcb4c659F2488D,0x11cE31192602A36f4203b264da3132D2a5A9BF17
11602,15627909,188043,287504147466,187079,964,130,103253,0x01FF6318440f7D5553a82294D78262D5f5084EFF,0x5AA17fC7F2950ECa85376C3A8CB1509e8e4B39dF
11603,15627909,483078,70627835264,481138,1940,522,55,0x7a250d5630B4cF539739dF2C5dAcb4c659F2488D,0xC77f80824C97073b9afcF679eD8D5BD1489C4dc6
11604,15627909,300000,53000000000,299000,1000,202,73090,0x759C24a5c3B2aB72715124D9BD6a318F24476da8,0xa270F3ad1a7a82E6a3157F12a900f1E25BC4FbFD
11605,15627909,300001,10627835264,298249,1752,458,224462,0x98C3d3183C4b8A650614ad179A1a98be0a8d6B8E,0x91aaE0aAfd9D2d730111b395c6871f248d7Bd728
11606,15627909,255244,10627835264,253108,2136,650,106639,0xA69babEF1cA67A37Ffaf7a485DfFF3382056e78C,0x9AAb3F81604c683a1a0D14019FBfe15bef7aA1ee
11607,15627909,320460,21158084249,318144,2316,650,100940,0xA69babEF1cA67A37Ffaf7a485DfFF3382056e78C,0x431B5A84aCC1297Eda88259f300262F1bc3A74f3
11608,15627909,278042,21158084248,275054,2988,842,93490,0x4A137FD5e7a256eF08A7De531A17D0BE0cc7B6b6,0x00dEe1F836998bcc736022f314dF906588d44808
11609,15627909,126531,20000000000,126327,204,74,1837,0x9b9D659D4f2cF68b6616Cc0a65683f1951Eb725C,0xBa367A8c44f0E814c02c28c5029b4ff2039c03B8
11610,15627909,21000,18892159605,21000,0,2,0,0x2Ea6cbFE1391CB84d386286E69Bc687c3345f9eB,0xA9FCa503047ef10086CDE3aaa914E6DB68014171
11611,15627909,181476,18000000000,179912,1564,394,75,0x1Fa8559e873f698292766790AeCf8080A66433F6,0x37Bf54A1bAA1C555B1F89c12A66EA25f898CC8aC
11612,15627909,49234,17000000000,48282,952,202,17,0x1Fa8559e873f698292766790AeCf8080A66433F6,0x6322f7909063507a4839655bDFD340285970E0B4
11613,15627909,69560,17000000000,68608,952,202,24,0x1Fa8559e873f698292766790AeCf8080A66433F6,0x6705E582716b0cFf433f1a568623B6FBA41ebB82
11614,15627909,69560,17000000000,68608,952,202,27,0x1Fa8559e873f698292766790AeCf8080A66433F6,0xa3F5B86b24359F4CCfB3710C56e7880eb166bc18
11615,15627909,275439,16627835264,273687,1752,458,96,0x7a250d5630B4cF539739dF2C5dAcb4c659F2488D,0x728441FE041422D6Ce3b2094C25FD3B00D190bcF
11616,15627909,50719,15808835367,50111,608,138,60,0xdAC17F958D2ee523a2206206994597C13D831ec7,0x78f6F56aDb70198C0B355190846607975cf3b2AE
11617,15627909,181476,15627835264,179912,1564,394,705,0x1Fa8559e873f698292766790AeCf8080A66433F6,0xEa14CDe8D7CB82681e11582A7F5d851FaB7a34A8
11618,15627909,202268,15627835264,199508,2760,842,1687,0x68b3465833fb72A70ecDF485E0e4C7bD8665Fc45,0x8b5E270C19eb8f28050a561D0bE08690cc33e73D
11619,15627909,750000,15627835264,749056,944,138,99,0x6097004C68F7B350d72226003226Ac089597D579,0x68226A002D6747905457273473204cbb9694a38d
11620,15627909,194365,15476639263,192769,1596,230,2314,0x9507c04B10486547584C37bCBd931B2a4FeE9A41,0x728140D4902eD52bA6708b8788c31F50AB3a145D
11621,15627909,194195,15031835263,192599,1596,230,17368,0x9507c04B10486547584C37bCBd931B2a4FeE9A41,0x69E906c33722F61b854929cd2c6f3427dea9f090
11622,15627909,238334,10627835264,237630,704,144,70418,0x46C4128981525aA446e02FFb2FF762F1D6A49170,0x607BD5bBC7C6A2111273b28d4309e5C04b024f00
11623,15627909,352660,12127835264,347240,5420,1482,133,0x68b3465833fb72A70ecDF485E0e4C7bD8665Fc45,0xb344e7a081Cf19524B569b9365E7E1dB3edCbD54
11624,15627909,224535,24059962917,223819,716,144,70419,0x46C4128981525aA446e02FFb2FF762F1D6A49170,0x607BD5bBC7C6A2111273b28d4309e5C04b024f00
11625,15627909,63000,14501829534,63000,0,2,2710066,0x7E68FAD0DB5f91Ce699515089a6814c49D7022c7,0xC098B2a3Aa256D2140208C3de6543aAEf5cd3A94
11626,15627909,21000,14129021454,21000,0,2,1,0x26548295A561C359eb33fAF53554161aE1296f49,0x282f3914471189B20A1D80FFE70411829aF95baB
11627,15627909,100000,14000000000,100000,0,2,270673,0xa617e65683Dec55E718Fa3528b580844cf07b0F3,0x23f4569002a5A07f0Ecf688142eEB6bcD883eeF8
11628,15627909,222222,14000000000,220658,1564,394,394,0x1Fa8559e873f698292766790AeCf8080A66433F6,0x594183C914743d1B47CedfC0dca936b354bac4e1
11629,15627909,800000,13627835264,798036,1964,522,349,0x7a250d5630B4cF539739dF2C5dAcb4c659F2488D,0x6d0eAC7b3c985Fc2c3eA8f80a2f4B6Cd3894Eddd
11630,15627909,800000,13627835264,798048,1952,522,199,0x7a250d5630B4cF539739dF2C5dAcb4c659F2488D,0xb17FBECC70004c298A6b69a06C9ba3ce9cb4Bd11
11631,15627909,750000,13627835264,747904,2096,522,1382,0x9bC6369a2D947BdfAEdd74207d3589dbaFc48b52,0xDc1D18df7182b285a69502aB7C08d9a2AA2BDfae
11632,15627909,181476,13627835264,179912,1564,394,1205,0x1Fa8559e873f698292766790AeCf8080A66433F6,0x4548a77b3833cd410a05f60e9A21E39B7aa055a3
11633,15627909,297242,13127835264,296586,656,138,459,0x2b95A1Dcc3D405535f9ed33c219ab38E8d7e0884,0x9a679F16A53a7b353c4879E40Cf50082d6ebc5ab
11634,15627909,21000,13127835264,21000,0,2,67397,0xA89822087358D3531CfD8DF45a401DD0B73342f7,0x963737C550E70FFe4D59464542a28604eDb2eF9a
11635,15627909,751291,13052000000,736435,14856,4682,19,0x3b3ae790Df4F312e745D270119c6052904FB6790,0x1BeFAe6a5EcdeC7f7095f0a9f590633680243785
11636,15627909,90000,13000000000,90000,0,2,449983,0x266aB32E4D498DDf73340Cf270d4110520992EDd,0x077D360f11D220E4d5D831430c81C26c9be7C4A4
11637,15627909,85000,12827835264,84332,668,138,614729,0x016ee7373248a80BDe1fD6bAA001311d233b3CFa,0x3C02290922a3618A4646E3BbCa65853eA45FE7C6
11638,15627909,21000,12628835264,21000,0,2,195481,0xd5ABb7f978ABB356E75A6d5266a8DB45677b378B,0xB287eaC48aB21c5FB1d3723830d60b4c797555B0
11639,15627909,269196,12627835264,264940,4256,1098,4,0xe66B31678d6C16E9ebf358268a790B763C133750,0xE49267D0F0e1b9a0D7B9398FE20f9490A66d69CC
11640,15627909,181476,12627835264,179912,1564,394,298,0x1Fa8559e873f698292766790AeCf8080A66433F6,0xDFc946bdd0Ec165d8865A133223C4589C81c1099
11641,15627909,207128,12627835264,206472,656,138,4468973,0x320623b8E4fF03373931769A31Fc52A4E78B5d70,0x21a31Ee1afC51d94C2eFcCAa2092aD1028285549
11642,15627909,181476,12627835264,179912,1564,394,448,0x1Fa8559e873f698292766790AeCf8080A66433F6,0x710AbAA993F7EEE4b80CD2Bc80eED5B4ae99165F
11643,15627909,36003,12627835264,35751,252,74,109,0xC02aaA39b223FE8D0A0e5C4F27eAD9083C756Cc2,0x2BD29af09c6743C7B1CD3358C2ecE9582e20eF09
11644,15627909,122551,12627835264,121011,1540,394,83,0x1Fa8559e873f698292766790AeCf8080A66433F6,0xbB72f6fC4450000821EcB5Ce641a7faDfC2687d9
11645,15627909,21000,12627835264,21000,0,2,8265761,0x59903649100C022850f2a121637c29f3193701b6,0xb5d85CBf7cB3EE0D56b3bB207D5Fc4B82f43F511
11646,15627909,21000,12627835264,21000,0,2,1783216,0xc45A08301f75a00F94ae6A128409109d04d58C38,0x503828976D22510aad0201ac7EC88293211D23Da
11647,15627909,21000,12627835264,21000,0,2,52384,0x13E68Fbf8c6734fe95281fDFf3AC5AA6247fE469,0x7c195D981AbFdC3DDecd2ca0Fed0958430488e34
11648,15627909,21000,12627835264,21000,0,2,1783217,0xA61AeAEF0df5963A0BbC4C43599723D127508364,0x503828976D22510aad0201ac7EC88293211D23Da
11649,15627909,21000,12627835264,21000,0,2,8804471,0xF42BDFE11A236D981d0Dbd5FDA5A8916215608D0,0x3cD751E6b0078Be393132286c442345e5DC49699
11650,15627909,21000,12627835264,21000,0,2,8804472,0x500232c378dD40B2186B4aBeb819aE49C471c3f1,0x3cD751E6b0078Be393132286c442345e5DC49699
11651,15627909,21000,12627835264,21000,0,2,52385,0x90E18a6920985DBACc3d76Cf27a3F2131923C720,0x7c195D981AbFdC3DDecd2ca0Fed0958430488e34
11652,15627909,21000,12627835264,21000,0,2,1783218,0x9f828c3653D95c3e3431B2E176CCC21f6A165EC1,0x503828976D22510aad0201ac7EC88293211D23Da
11653,15627909,122564,12627835264,121012,1552,394,84,0x1Fa8559e873f698292766790AeCf8080A66433F6,0x000992eF35C3A2bdff63c85b32C0FaF38c11FD78
11654,15627909,159001,12627835264,156181,2820,842,14,0x68b3465833fb72A70ecDF485E0e4C7bD8665Fc45,0x0500DabCcdB66C0eE1f28FE9385Fc5349E6F94fb
11655,15627909,122577,12627835264,121013,1564,394,78,0x1Fa8559e873f698292766790AeCf8080A66433F6,0xF89De73b47FCb46be4dd97249Aef8Ed442e1CabB
11656,15627909,181476,12627835264,179912,1564,394,1750,0x1Fa8559e873f698292766790AeCf8080A66433F6,0x3359CaF7070784ccE146985E0fd4f54008C888FE
11657,15627909,122564,12627835264,121012,1552,394,87,0x1Fa8559e873f698292766790AeCf8080A66433F6,0xB710A8f74341643A2A48E862879C6097A142d598
11658,15627909,122577,12627835264,121013,1564,394,75,0x1Fa8559e873f698292766790AeCf8080A66433F6,0x507E71a963010cC6bCc49F56BFC4afbBd58048Cd
11659,15627909,181476,12627835264,179912,1564,394,0,0x1Fa8559e873f698292766790AeCf8080A66433F6,0x456706AbB9ea755Bd99B34cea2236f20c19CDc03
11660,15627909,122577,12627835264,121013,1564,394,77,0x1Fa8559e873f698292766790AeCf8080A66433F6,0x360161022a60f79E6418095465B44F51EDC02201
11661,15627909,122577,12627835264,121013,1564,394,76,0x1Fa8559e873f698292766790AeCf8080A66433F6,0x6Bc5ffc2E3876Bc790ffdD2Dd81ba34a57244b69
11662,15627909,122564,12627835264,121012,1552,394,71,0x1Fa8559e873f698292766790AeCf8080A66433F6,0x003a2B399e17666fD0B4D8A4B6BCe4b95175174D
11663,15627909,181476,12627835264,179912,1564,394,162,0x1Fa8559e873f698292766790AeCf8080A66433F6,0x77160dB4c22BAE0D73F1E09703220203b083F0bD
11664,15627909,286615,12627835264,283499,3116,906,1429,0x68b3465833fb72A70ecDF485E0e4C7bD8665Fc45,0x94B72e712bfB3eF89DC4979800d2146BBF6B5DEB
11665,15627909,53620,12627835264,52676,944,138,2897,0xeE3FC268418f54cFEb7817cc52C642489A5DF098,0xf27Fc78282c865f34a5D3BBdA59238D9B65BcAb6
11666,15627909,122577,12627835264,121013,1564,394,76,0x1Fa8559e873f698292766790AeCf8080A66433F6,0xF0a16D2fB8c4BE77A79A549543d352605902e6ce
11667,15627909,21000,12627835264,21000,0,2,984,0x4d538f80550Daf4b04E4a16E52F541B4A7eB526d,0xc99E67A7B8A111b312dB956E715Ab169eeC1e7e5
11668,15627909,42000,12627835264,42000,0,2,329563,0x484A9A1eaA6B4e76947F47DFff804CCF63f6F19A,0x9430801EBAf509Ad49202aaBC5F5Bc6fd8A3dAf8
11669,15627909,246416,12627835264,243596,2820,842,21,0x68b3465833fb72A70ecDF485E0e4C7bD8665Fc45,0xb02547Dada182468408FC5348026Ce4f3101bfC1
11670,15627909,58188,12627835264,57244,944,138,29,0x95aD61b0a150d79219dCF64E1E6Cc01f0B64C4cE,0xc487246CA3d5Cf090D516DECD77e0AC554363709
11671,15627909,332586,12627835264,327782,4804,1162,30,0xe66B31678d6C16E9ebf358268a790B763C133750,0xc487246CA3d5Cf090D516DECD77e0AC554363709
11672,15627909,181476,12627835264,179912,1564,394,159,0x1Fa8559e873f698292766790AeCf8080A66433F6,0x7aCB27B14d0C030488677635Bf0a8cb6d733c80d
11673,15627909,55950,12627835264,55006,944,138,566,0x6097004C68F7B350d72226003226Ac089597D579,0xd1Cd6e571a6b9106552464c0e47210EF397E5571
11674,15627909,53319,12627835264,52375,944,138,142,0xC02aaA39b223FE8D0A0e5C4F27eAD9083C756Cc2,0x0B86b1bccBb0222c8d877EfAD8fB06c4116AFA08
11675,15627909,122577,12627835264,121013,1564,394,68,0x1Fa8559e873f698292766790AeCf8080A66433F6,0x47CFf80C60AbEb172e8F5A5F4DB741286d70Ee74
11676,15627909,249397,12627835264,244069,5328,1484,35,0x881D40237659C251811CEC9c364ef91dC08D300C,0xfB7C4FE356c119E460Efb5B509C6902320a595Fc
11677,15627909,122577,12627835264,121013,1564,394,67,0x1Fa8559e873f698292766790AeCf8080A66433F6,0xEc32E67070E17B83FC1Fb21E80867E1823Ae8814
11678,15627909,122577,12627835264,121013,1564,394,66,0x1Fa8559e873f698292766790AeCf8080A66433F6,0x0FaFE422dB337C57B122972bD80943D019EC8BF6
11679,15627909,39617,12627835264,39353,264,74,6,0xC02aaA39b223FE8D0A0e5C4F27eAD9083C756Cc2,0x4d6DCBEA6bDE4C7D80392a68E093a1EF949764d6
11680,15627909,122577,12627835264,121013,1564,394,64,0x1Fa8559e873f698292766790AeCf8080A66433F6,0xf88ccFFB69fc76209BBb8D635Bcc7E21363C3b14
11681,15627909,122577,12627835264,121013,1564,394,49,0x1Fa8559e873f698292766790AeCf8080A66433F6,0xd708a6D15D407E5572708D0351cf1FD73165Cac8
11682,15627909,77338,12627835264,76730,608,138,1019,0x467719aD09025FcC6cF6F8311755809d45a5E5f3,0x27CccC678b2F6C374d7a57862d96378C87e1E3F2
11683,15627909,122577,12627835264,121013,1564,394,58,0x1Fa8559e873f698292766790AeCf8080A66433F6,0x59A650aCeAd1E6918Ba0d4506b1F9702c0FEAC71
11684,15627909,100000,12500000000,99024,976,202,259900,0xdAC17F958D2ee523a2206206994597C13D831ec7,0x292f04a44506c2fd49Bac032E1ca148C35A478c8
11685,15627909,40105,12336877965,40105,0,2,48497,0x4dC9e781Fef18fa4Dc5217A5Ee1156f668B5aF55,0x4dC9e781Fef18fa4Dc5217A5Ee1156f668B5aF55
11686,15627909,241973,12308719129,235445,6528,1874,46631,0x1111111254fb6c44bAC0beD2854e76F90643097d,0x839d4641F97153b0ff26aB837860c479E2Bd0242
11687,15627909,21000,12277835264,21000,0,2,214,0x52579f87Cc8565E5AA3766328eEF015aa8797D15,0x52579f87Cc8565E5AA3766328eEF015aa8797D15
11688,15627909,121822,12237835264,119558,2264,594,11,0xDef1C0ded9bec7F1a1670819833240f027b25EfF,0x3461D827fE4a6eA5fcFEcAa3F6fc941D892703cb
11689,15627909,21000,12185835264,21000,0,2,102644,0x26eD93a05a6e00395bd40619FB2b1f96E5ab5045,0x2Db1D8CdF1Abe8C70b531a790CDf2FF38aecF652
11690,15627909,120000,12185835264,119392,608,138,57308,0xdAC17F958D2ee523a2206206994597C13D831ec7,0xCfC0F98f30742B6d880f90155d4EbB885e55aB33
11691,15627909,21000,12177835264,21000,0,2,77,0x86fcAf22786EdCc5cE9e89e6D64826919675be95,0xa7de08C1fF5Bf1ff3475f8bCF70Ff1D2352463e9
11692,15627909,210796,12127835264,207988,2808,842,652,0x68b3465833fb72A70ecDF485E0e4C7bD8665Fc45,0xE6C67fb2661f0AC632cAF72845c6A803dfaF8ce2
11693,15627909,49726,12127835264,49238,488,138,7,0xAe833d9846385eC4a84465e33DC1A25401148B2c,0xFb0C2B9739F96313f6370E0862E2D683d0F2F25A
11694,15627909,172905,12127835264,171337,1568,330,18,0x84c2b16FA6877a8fF4F3271db7ea837233DFd6f0,0xE1Aa547c12611F2956D4a741198D30d38664792C
11695,15627909,21000,12127835264,21000,0,2,3072,0xc320F572166e7BB58aCcf31d760e65bf33967134,0xd653971FA19ef68BC80BECb7720675307Bfb3EE6
11696,15627909,174475,12127835264,171739,2736,842,235,0x68b3465833fb72A70ecDF485E0e4C7bD8665Fc45,0x6b09CA1ec26824D744445FcDD0112bBe5E7CafA9
11697,15627909,99244,12127835264,98636,608,138,46,0xA0b86991c6218b36c1d19D4a2e9Eb0cE3606eB48,0x6D646848C2D43A38d382140d2C3D81fFdA336206
11698,15627909,21000,12127835264,21000,0,2,126,0xcD136eD15581bb542D14317A6066e25BF62c2600,0x9C4C8539FbDc0A1ab8d461E192d20c554fEb9B99
11699,15627909,21000,12127835264,21000,0,2,246,0x0DC87F37Acb9E6653991Fd365Cd92C142d07D43a,0x2f4668c4c093537BacF6E3aA39c93848fE3aC937
11700,15627909,21000,12127835264,21000,0,2,59,0x1423FaBfB9DF071cb3f60698bbcF0BF0357DA192,0x6862E6a70830d8961195f6C7532B08Aac91ff205
11701,15627909,21000,12127835264,21000,0,2,5,0xA1A252e4e9B8dfaE6b58C6C88a04791dc6B9E558,0x912F0F7753E4f714359374F893B6280F1ED700d1
11702,15627909,47556,12127835264,46080,1476,458,3,0x406C60C2e8038a0E90D2f28efF7260CC7Af84EE6,0x86Cd0944013e2B852DA7AFa6C8b7ad76d0B35a67
11703,15627909,242474,12127835264,239738,2736,842,214,0x68b3465833fb72A70ecDF485E0e4C7bD8665Fc45,0x4f102e320c8046242eEbaD43A6174678CCe1e8CC
11704,15627909,177236,12127835264,175548,1688,330,10,0xb5d2A992442988D0E4bFd1447eba4b8dC1D1A362,0x7eA5C91565a1104bc3227248a7c5E34dAa848a6E
11705,15627909,55950,12127835264,55006,944,138,1481,0x6097004C68F7B350d72226003226Ac089597D579,0xa12B0Fa4104569906c018Eb3541e6605ffe8e54b
11706,15627909,77320,12127835264,76724,596,138,119,0x467719aD09025FcC6cF6F8311755809d45a5E5f3,0x0A50e162d6DEA861Fe0197B681379f8D491edd5d
11707,15627909,235550,12127835264,231958,3592,1162,156,0x68b3465833fb72A70ecDF485E0e4C7bD8665Fc45,0x1e09556B986e0771133466b224370903051F24d7
11708,15627909,181476,12127835264,179912,1564,394,223,0x1Fa8559e873f698292766790AeCf8080A66433F6,0xE35Cd1C1dF2E1d5d3922B955Dc5dA6807621f730
11709,15627909,238948,12127835264,236164,2784,842,461,0x68b3465833fb72A70ecDF485E0e4C7bD8665Fc45,0x87eaA58fEF2C5180e48152E1E469E90bFb3e7b9C
11710,15627909,46135,12127835264,45647,488,138,8,0x1Fa8559e873f698292766790AeCf8080A66433F6,0x27a96DCe5A1146628E5F0Bc99f005c4997Af9459
11711,15627909,53818,12127835264,53330,488,138,276,0xe2ddf03ba8cDafd2Bb4884E52f7FB46df4FC7DC1,0xE4cAf123F8E81466bDD2358f8BFcf60bAdA82Ae3
11712,15627909,163828,12127835264,157264,6564,1802,229,0x00000000006c3852cbEf3e08E8dF289169EdE581,0xC4B0dc090E87345151D1E486B5b8eb49aE4fFF2F
11713,15627909,21000,12127835264,21000,0,2,1956,0x3A72982f0CEf60C558ad5Aa627Ba82038A40db0B,0x51feE9bf45C5DAb188B57048658696edAB9d72Cf
11714,15627909,21000,12127835264,21000,0,2,13,0xfc01549762ab9Dd704c4b9d914d03B3C90C5F0a9,0xB349e1DEce468D6552345Ec929D8E0BDfb55EBe8
11715,15627909,48229,12127835264,47277,952,202,190,0x61CEcE14E222385D5aC83f3d0cbd518f5fEB3559,0x0e662b85D7Fd9F677758bC2fC11f668CDf05f33f
11716,15627909,55926,12127835264,54982,944,138,5,0x1Ec6475f5C7F1b1C77284302f68e165d78FCBDe2,0x478AEC926aA00D69F004874f08558d1819c30848
11717,15627909,545920,12127835264,541264,4656,1226,98,0xC36442b4a4522E871399CD717aBDD847Ab11FE88,0xC9F77e99E83d93ed1E7E07Cb431E56F10ad1458C
11718,15627909,46103,12127835264,45615,488,138,21,0x346378C67d0F71343F80299ed8C0407aC2Df05eB,0x24E6279AD2E7b1dd7Bfd82744D7793166e29FA3C
11719,15627909,176383,12127835264,165363,11020,3466,27,0x74312363e45DCaBA76c59ec49a7Aa8A65a67EeD3,0xD49C4eab9b614bF8AE0c21D9e9b751ad3Cae900a
11720,15627909,196114,12127835264,189526,6588,1802,47,0x00000000006c3852cbEf3e08E8dF289169EdE581,0x32E1953C3B4E96D3990fe21F611501150566FFB9
11721,15627909,21000,12127835264,21000,0,2,1983,0x154c7bFa1df595F08FfD758385Eb7BDb035ca14B,0x6AF71b3aD135d102e08139B15D507303CBFe6EcF
11722,15627909,46103,12127835264,45615,488,138,165,0x346378C67d0F71343F80299ed8C0407aC2Df05eB,0x5B187c84b31C243202959aB4B54f8396E5DBaf32
11723,15627909,740000,12127835264,729016,10984,2506,59363,0xbd6C554554834ee97828B6DA732dCa7461DDf9d4,0xF07131F578a5F708AE2CCB9faF98458099E0FFB4
11724,15627909,45038,12127835264,44974,64,10,983,0xC02aaA39b223FE8D0A0e5C4F27eAD9083C756Cc2,0x004eccB6fD0dab797aeb0Eb1045c4fA523D78B91
11725,15627909,207015,12127835264,203739,3276,1034,402,0x68b3465833fb72A70ecDF485E0e4C7bD8665Fc45,0x4140B0BE326a07C4ad3D24A39B404A02B2dE4aC3
11726,15627909,210671,12127835264,198539,12132,3794,323,0x00000000006c3852cbEf3e08E8dF289169EdE581,0xc20b23462377bea7A7C1253057F8Ce1a74406Fcf
11727,15627909,270904,12127835264,267616,3288,1034,152,0x68b3465833fb72A70ecDF485E0e4C7bD8665Fc45,0xFE658a23826cF481255b8082904494b3d39FA9D2
11728,15627909,259897,12127835264,253497,6400,1738,80,0x00000000006c3852cbEf3e08E8dF289169EdE581,0xC9b704465A27edf2123c186C6468E127e6F9789D
11729,15627909,399198,12127835264,393678,5520,1610,146,0x68b3465833fb72A70ecDF485E0e4C7bD8665Fc45,0x5fF9206d88ebd668e0869efd9cFFd9cb60387169
11730,15627909,21000,12127835264,21000,0,2,541,0x26b14EBa75A6b3234C8aAdF9FAb7F5774583e103,0xaD5efb0A72254eCe67BAfdB22F18E439c42Bb02C
11731,15627909,21000,12127835264,21000,0,2,787,0x2bF8F06adC558fb713fA2CCC221c9BCc72DbF75d,0x8ee55f30B24E42827cB4AAd0B75454B92B99f106
11732,15627909,99244,12127835264,98636,608,138,150,0xA0b86991c6218b36c1d19D4a2e9Eb0cE3606eB48,0x913c9Cd8dF10a53057B92FE452Bc5B0F7A5Dea4D
11733,15627909,21000,12127835264,21000,0,2,0,0x4FF9d55A47Fa930feB03fa52086D437539217777,0xb658f563E13624Af677d24BDBd8870632bB86961
11734,15627909,46135,12127835264,45647,488,138,1071,0x1Fa8559e873f698292766790AeCf8080A66433F6,0xF4D631fa4CB9322366bD5eBC25eA94dFCe1DDf09
11735,15627909,46135,12127835264,45647,488,138,93,0x1Fa8559e873f698292766790AeCf8080A66433F6,0x3fE1515f84A90925F2407b6da5E7C998c5b32a9c
11736,15627909,50470,12127835264,50406,64,10,2233,0x49128CF8ABE9071ee24540a296b5DED3F9D50443,0x4dc583548a3407a5c5F6468Ccc964523cB14E9d1
11737,15627909,186005,12127835264,179341,6664,1810,163,0x00000000006c3852cbEf3e08E8dF289169EdE581,0xd3864619f41126760A213da2499cc55A25020683
11738,15627909,21000,12127835264,21000,0,2,4,0xc445B4268D41293F986De7d276186e2d3AFBA543,0x4fF9f5C87bbb11DbfcFf016307BD5A1D24127FfD
11739,15627909,52906,12127835264,52250,656,138,13,0x12b6893cE26Ea6341919FE289212ef77e51688c8,0xdF6245A7448Ca5Ac0A2F0695539f6C33d4C44482
11740,15627909,46274,12127835264,45642,632,138,20,0x1EA48B9965bb5086F3b468E50ED93888a661fc17,0x2D8084c08F9Ec0995B20fbC3c32864dE691cd987
11741,15627909,125066,12127835264,124802,264,74,16,0x8Bc3702c35D33E5DF7cb0F06cb72a0c34Ae0C56F,0xaaFA6b898A43b61F576bc71513A0ac23Ca0220b7
11742,15627909,46135,12127835264,45647,488,138,211,0x1Fa8559e873f698292766790AeCf8080A66433F6,0x53AA4b81B3F5028658161c4522b9DFFdA83e821c
11743,15627909,230820,12127835264,228160,2660,714,39,0xb2e7C59e3BFec19bBBb0e33c0899BE7F15667f95,0x75F651de1A7746c2c658E06753681CE16a21D9F0
11744,15627909,46619,12127835264,46131,488,138,6,0xDfe3AC769b2d8E382cB86143E0b0B497E1ED5447,0x7B2C05FDdd0d3d9179226Ca3dEd46A130338444F
11745,15627909,52872,12127835264,51920,952,202,32,0x83565d91809Ab9c0D4d4d5a74610095264aBa4Ce,0x7542eB9FA33Cd07EFf75D20F0dC4015321546F85
11746,15627909,314936,12030000000,289556,25380,8714,1632,0x83C8F28c26bF6aaca652Df1DbBE0e1b56F8baBa2,0x31A24a5f32E92963B57f95F85B276F6145be575f
11747,15627909,84354,12000000000,84150,204,74,29,0x9b9D659D4f2cF68b6616Cc0a65683f1951Eb725C,0xD53201419A0cFfA2d2ca48E8b285e309b90dDF6e
11748,15627909,84354,12000000000,84150,204,74,47,0x9b9D659D4f2cF68b6616Cc0a65683f1951Eb725C,0xFDb77d738Abd8DC53611226EFC09C11f0eBadB2b
11749,15627909,79396,11800000000,78788,608,138,2,0xA0b86991c6218b36c1d19D4a2e9Eb0cE3606eB48,0xC5573ab533b83F763555D931d26A9a03f5159f88
11750,15627909,21000,11757983622,21000,0,2,5612,0xc8c62329aE33730B4c8A0208d95072b6A36A1cE3,0x2Cc3941D7E7a3Fa5d55D75b25748e497e4F83C46
11751,15627909,21000,11757983622,21000,0,2,2286,0x0E90687B87E1Bf60CF14d09a3176DA9B0d15E20D,0x4f24d8f60e0a6b8E2D51c23358a711b8212e71D0
11752,15627909,178398,11627835264,178194,204,74,2362,0x645E9324f4be25be581BB62163cfa86c40b01D07,0xc5009AFEd2D6DA219538aD165998F63B553185B1
11753,15627909,175110,11627835264,173546,1564,394,3751,0x1Fa8559e873f698292766790AeCf8080A66433F6,0x63748140C409b490952c37daE5a60715Bf915129
11754,15627909,175110,11627835264,173546,1564,394,18,0x1Fa8559e873f698292766790AeCf8080A66433F6,0xc0E23761699f66a980B4dF63E336BdD9BfD257aA
11755,15627909,181476,11627835264,179912,1564,394,24,0x1Fa8559e873f698292766790AeCf8080A66433F6,0x652bBb29cED3e11CC2B21921fAF766B87A2838de
11756,15627909,46185,11627835264,45697,488,138,5,0x9b3B6974531d8AA15A87908FFd821A64863Ede5B,0x78539a263e8280D0b409d64098288009A2B7416E
11757,15627909,175110,11627835264,173546,1564,394,231,0x1Fa8559e873f698292766790AeCf8080A66433F6,0x82A4ae53F9883f7beA6d771A7d5B3ac6e93278Ba
11758,15627909,181476,11627835264,179912,1564,394,470,0x1Fa8559e873f698292766790AeCf8080A66433F6,0xc5Ef260415F8592835D6bde27e5172DACC135F54
11759,15627909,181476,11627835264,179912,1564,394,1372,0x1Fa8559e873f698292766790AeCf8080A66433F6,0x4c951EcB11400e3a3AfB50ea9ee40eC8573ca289
11760,15627909,181476,11627835264,179912,1564,394,207,0x1Fa8559e873f698292766790AeCf8080A66433F6,0x834C352f2C4Fc1d4d45a175c4F843B46865C185D
11761,15627909,181476,11627835264,179912,1564,394,2055,0x1Fa8559e873f698292766790AeCf8080A66433F6,0x98991B99A5B40aE84B21b6676246C761177bc487
11762,15627909,181476,11627835264,179912,1564,394,324,0x1Fa8559e873f698292766790AeCf8080A66433F6,0xCcDCF5Df80AeADcEE066bD2A6eaDDcb45d8E9a62
11763,15627909,181476,11627835264,179912,1564,394,12,0x1Fa8559e873f698292766790AeCf8080A66433F6,0x119df459e71563bAa5fc1dC237aB6377EE492a05
11764,15627909,181476,11627835264,179912,1564,394,367,0x1Fa8559e873f698292766790AeCf8080A66433F6,0xD9438b70844D74FfD91b7208D0813a9b289F7216
11765,15627909,181476,11627835264,179912,1564,394,139,0x1Fa8559e873f698292766790AeCf8080A66433F6,0xb33DaFFAB5A4819cdC26B9E0Dfdb6b0764660D30
11766,15627909,181476,11627835264,179912,1564,394,11,0x1Fa8559e873f698292766790AeCf8080A66433F6,0x50163F45BE02508E294b4D34aCBd294254de7Ce8
11767,15627909,181476,11627835264,179912,1564,394,1,0x1Fa8559e873f698292766790AeCf8080A66433F6,0xBCD3F2b0e5EF44fb57Ca0746e40b7d76A673574D
11768,15627909,175092,11627835264,173540,1552,394,17,0x1Fa8559e873f698292766790AeCf8080A66433F6,0xBa9dfe65e1fC38cDaD5175336b915aAF430B884B
11769,15627909,181440,11627835264,179900,1540,394,117,0x1Fa8559e873f698292766790AeCf8080A66433F6,0x98a6efE554D8Ca9EBCA76560885253fBeD4Ef94f
11770,15627909,181458,11627835264,179906,1552,394,1719,0x1Fa8559e873f698292766790AeCf8080A66433F6,0x24F65FA44edd3165c221B370c055111c9AEdE2DE
11771,15627909,181476,11627835264,179912,1564,394,1608,0x1Fa8559e873f698292766790AeCf8080A66433F6,0x28e58A14A39c6BD994e4864119A0348f233992c0
11772,15627909,121018,11627835264,120446,572,138,46,0x1748B24faf9780B74E5A9f3Feb41553E712E94aa,0x6819eA7792CC89394fEEE84FC70d54a67cD0B765
11773,15627909,181476,11627835264,179912,1564,394,31,0x1Fa8559e873f698292766790AeCf8080A66433F6,0xB486C8046657Ca2102bbF80Ea46DDD66158E5b44
11774,15627909,181476,11627835264,179912,1564,394,56,0x1Fa8559e873f698292766790AeCf8080A66433F6,0x0Cf7346288133F4E48313FDf31e283628D68230e
11775,15627909,181476,11627835264,179912,1564,394,133,0x1Fa8559e873f698292766790AeCf8080A66433F6,0x7027BECCAa66Ea88B3b15372940C21C334292e8c
11776,15627909,181476,11627835264,179912,1564,394,74,0x1Fa8559e873f698292766790AeCf8080A66433F6,0x167F3b8E6c6E54f22f24E01b6635EEf1E4856fE3
11777,15627909,181458,11627835264,179906,1552,394,241,0x1Fa8559e873f698292766790AeCf8080A66433F6,0xe03Bf6ae18Fa0DD228aD6bf77A9E9D48d225589e
11778,15627909,181476,11627835264,179912,1564,394,540,0x1Fa8559e873f698292766790AeCf8080A66433F6,0xf974768FcA1249e6a33Ea9ca1a20E26F0161F9aC
11779,15627909,143796,11627835264,143592,204,74,0,0x7F9306FC1978938d5C1C57Bf6044dc67E07eeB8a,0xd444eccbD61f2233981b3D2261E2FDB3Db1e0393
11780,15627909,181476,11627835264,179912,1564,394,631,0x1Fa8559e873f698292766790AeCf8080A66433F6,0x2Ea9A81eF9F2E1615B1D27526a745d72d592CE15
11781,15627909,181476,11627835264,179912,1564,394,130,0x1Fa8559e873f698292766790AeCf8080A66433F6,0x5824b6961CD94960880f4b7Ce38DA269D5aA0A79
11782,15627909,181440,11627835264,179900,1540,394,346,0x1Fa8559e873f698292766790AeCf8080A66433F6,0x30277eF932D6212748932051080000C6a6E7551f
11783,15627909,181476,11627835264,179912,1564,394,198,0x1Fa8559e873f698292766790AeCf8080A66433F6,0xb802FB0F2E4c3d96e6b55686a8a617F28847f5FD
11784,15627909,69163,11440955359,68555,608,138,1,0xdAC17F958D2ee523a2206206994597C13D831ec7,0xa0C614a855cc7b476E4fc009972aed98e432382C
11785,15627909,75753,11176773037,71601,4152,842,3784,0x00000000219ab540356cBB839Cbe05303d7705Fa,0x5180db0237291A6449DdA9ed33aD90a38787621c
11786,15627909,80000,11176773037,79056,944,138,0,0xA0b86991c6218b36c1d19D4a2e9Eb0cE3606eB48,0x93130B2f422Af0CE8eE20A9c470FB792d6a38c56
11787,15627909,75735,11176773037,71595,4140,842,3785,0x00000000219ab540356cBB839Cbe05303d7705Fa,0x5180db0237291A6449DdA9ed33aD90a38787621c
11788,15627909,75753,11176773037,71601,4152,842,3786,0x00000000219ab540356cBB839Cbe05303d7705Fa,0x5180db0237291A6449DdA9ed33aD90a38787621c
11789,15627909,84354,11000000000,84150,204,74,9,0x9b9D659D4f2cF68b6616Cc0a65683f1951Eb725C,0x14CF7B3bce8C88BF88A7960bc591D7482F5cC97f
11790,15627909,84354,11000000000,84150,204,74,1,0x9b9D659D4f2cF68b6616Cc0a65683f1951Eb725C,0xa95af2846B7970f649935591647d1BB5F7bF4852
11791,15627909,84354,11000000000,84150,204,74,25,0x9b9D659D4f2cF68b6616Cc0a65683f1951Eb725C,0xA49578FD4EA031C1c99C1013F6632F516Ae560C0
11792,15627909,1314913,10863757089,818753,496160,62346,34651,0xBe5dAb4A2e9cd0F27300dB4aB94BeE3A233AEB19,0x473300df21D047806A082244b417f96b32f13A33
11793,15627909,79381,10680000000,78785,596,138,37,0xA0b86991c6218b36c1d19D4a2e9Eb0cE3606eB48,0x3c3820de9635c3a8E71CA4F6bFbC62C89eEA6DFE
11794,15627909,26000,10627835264,26000,0,2,12036,0x388C818CA8B9251b393131C08a736A67ccB19297,0xDAFEA492D9c6733ae3d56b7Ed1ADB60692c98Bc5
11795,15627910,188863,11145274185,188219,644,90,103254,0x01FF6318440f7D5553a82294D78262D5f5084EFF,0x5AA17fC7F2950ECa85376C3A8CB1509e8e4B39dF
11796,15627910,319320,12145274185,317412,1908,458,19,0x7a250d5630B4cF539739dF2C5dAcb4c659F2488D,0x0cB5B5C356FcE965b26683E0B3854a6f098108aC
11797,15627910,188055,312034942147,187079,976,130,103255,0x01FF6318440f7D5553a82294D78262D5f5084EFF,0x5AA17fC7F2950ECa85376C3A8CB1509e8e4B39dF
11798,15627910,173619,73670065192,172259,1360,190,5294,0x9507c04B10486547584C37bCBd931B2a4FeE9A41,0x56D0c33E5e8cB6390ceBd7369D2Fe7E7870a04E0
11799,15627910,100000,34500000000,99356,644,138,8837,0x514910771AF9Ca656af840dff83E8264EcF986CA,0xD1305FbDA97C035F86FdAA7785fb568C203174E1
11800,15627910,100000,34500000000,99356,644,138,2,0x514910771AF9Ca656af840dff83E8264EcF986CA,0xE9D5E1EfD89e4bEf83a739B2fE1da0cC30b41d57
11801,15627910,100000,34500000000,99356,644,138,7,0x6B175474E89094C44Da98b954EedeAC495271d0F,0x34356f2EF2929829BE38d095eEbeb868BB70477A
11802,15627910,90000,20000000000,89332,668,138,25986,0x5ab6A4F46Ce182356B6FA2661Ed8ebcAFce995aD,0x30741289523c2e4d2A62c7D6722686D14E723851
11803,15627910,253908,11145274185,251712,2196,650,93265,0xA69babEF1cA67A37Ffaf7a485DfFF3382056e78C,0xFF82BF5238637B7E5E345888BaB9cd99F5Ebe331
11804,15627910,49234,18000000000,48282,952,202,25,0x1Fa8559e873f698292766790AeCf8080A66433F6,0x6705E582716b0cFf433f1a568623B6FBA41ebB82
11805,15627910,49234,18000000000,48282,952,202,28,0x1Fa8559e873f698292766790AeCf8080A66433F6,0xa3F5B86b24359F4CCfB3710C56e7880eb166bc18
11806,15627910,69872,17145274185,68928,944,138,97,0xFDBf91A7F2d757A9815326af5E1e60319571984c,0x728441FE041422D6Ce3b2094C25FD3B00D190bcF
11807,15627910,5049304,17000000000,5042216,7088,1098,303,0x0a39DA505DfB5E0BBc6bd84428281A8ba1bC7753,0x495E889d1A6cEB447a57dcc1C68410299392380c
11808,15627910,181476,16145274185,179912,1564,394,202,0x1Fa8559e873f698292766790AeCf8080A66433F6,0x28EF4aA9d5B9F5eF70c7Eb0da2eDac8BcD58304e
11809,15627910,163443,16145274185,154243,9200,2826,51,0x00000000006c3852cbEf3e08E8dF289169EdE581,0x29e89033C311A6703307b7B86F6e5f744EF64698
11810,15627910,350000,16073710853,349392,608,138,6925079,0xdAC17F958D2ee523a2206206994597C13D831ec7,0x46340b20830761efd32832A74d7169B29FEB9758
11811,15627910,350000,16073710853,350000,0,2,6925080,0x3b8A8635A7eDdCf20e7cdA613c82AE328C0E4c8D,0x46340b20830761efd32832A74d7169B29FEB9758
11812,15627910,21000,15420000000,21000,0,2,23,0x702ABC3B4d5dFb4C393F36C8A06bf2Dd403E663a,0xB2DCFEDdc3F44c298eEDdFAad74e4f211dC0F666
11813,15627910,181476,15145274185,179912,1564,394,102,0x1Fa8559e873f698292766790AeCf8080A66433F6,0x0A0cf680Ed95c34545570e292DD5Be675Cfb84bF
11814,15627910,51706,14250000000,51098,608,138,114,0x467719aD09025FcC6cF6F8311755809d45a5E5f3,0x225C4aeB412B0253F5d663a6e7C02b41513b0e33
11815,15627910,51706,14250000000,51098,608,138,1161,0x467719aD09025FcC6cF6F8311755809d45a5E5f3,0x599e4F6a0B24Af263B212Fb731B733309A201C28
11816,15627910,51706,14250000000,51098,608,138,1828,0x467719aD09025FcC6cF6F8311755809d45a5E5f3,0x5cF78Da3A7c0F96eB6723b0DAd4AB1AA5B0da78E
11817,15627910,90000,14204422973,90000,0,2,784420,0x79dEc38fb7Ac4df2EaBFA5dC58c076dd8090A03b,0xcaD621da75a66c7A8f4FF86D30A2bF981Bfc8FdD
11818,15627910,181458,14145274185,179906,1552,394,291,0x1Fa8559e873f698292766790AeCf8080A66433F6,0x9aDa05A71C372e70a45819418CDCcfc7eA9B20B5
11819,15627910,55926,14145274185,54982,944,138,1383,0x6097004C68F7B350d72226003226Ac089597D579,0xDc1D18df7182b285a69502aB7C08d9a2AA2BDfae
11820,15627910,175110,14145274185,173546,1564,394,3638,0x1Fa8559e873f698292766790AeCf8080A66433F6,0x6104f6684F4F966E4B81CDf9a6B4836052CDa456
11821,15627910,245658,14145274185,239094,6564,1802,2153,0x00000000006c3852cbEf3e08E8dF289169EdE581,0x22e091333Eed4FD5Ec370992592B2A70E6042Ada
11822,15627910,229603,14142140264,226843,2760,842,136,0x68b3465833fb72A70ecDF485E0e4C7bD8665Fc45,0xE0be3112F71fee89cC14ef59F1F6C8840BC0b799
11823,15627910,50000,14122884215,50000,0,2,464127,0x12B738fF0d026F86c598DB83FDe216A52Df943fD,0x3B794929566e3Ba0f25e4263e1987828b5c87161
11824,15627910,100000,14000000000,100000,0,2,748023,0xE8989CAc9AC52A8F052d0da4698406b15D404F06,0xC88F7666330b4b511358b7742dC2a3234710e7B1
11825,15627910,100000,14000000000,100000,0,2,270674,0x92fb397c0Cf18F62218d31894fBB521A119D8740,0x23f4569002a5A07f0Ecf688142eEB6bcD883eeF8
11826,15627910,222222,14000000000,220658,1564,394,167,0x1Fa8559e873f698292766790AeCf8080A66433F6,0x607f3f72AEf179a4c6Bc359220B91a390f10A573
11827,15627910,160000,13645274185,159796,204,74,101,0xb967D2335A3879b7CAE42E085f88274EBff90Fc4,0x893053eD1645EaDDD80f7E1ab8685fBEF77783a9
11828,15627910,21000,13580000000,21000,0,2,0,0x6dfc34609a05bC22319fA4Cce1d1E2929548c0D7,0x88B0259B5998C21F820af1c8EE49C7b4F28B7138
11829,15627910,49672,13160000000,48264,1408,394,55,0x4E76Fc610dA679c9D07C7d640831AD6FF81E0252,0xd553f702C8F1012B3988458E14F41b2d4013a06A
11830,15627910,50000,13146274185,50000,0,2,58117,0x456fCF28253BA4814886111CB9Ed3eCb20Bce127,0x32143A02Fb6484D18C79Fa0401c9bF760DD3DE68
11831,15627910,21000,13145274185,21000,0,2,88945,0x03B3e5BceD08aD977aCd253599343383D8Ac0DD2,0x3018018c44338B9728d02be12d632C6691E020d1
11832,15627910,122577,13145274185,121013,1564,394,48,0x1Fa8559e873f698292766790AeCf8080A66433F6,0x9743f5A0782Ff0D940024941263d67e39517f677
11833,15627910,122577,13145274185,121013,1564,394,43,0x1Fa8559e873f698292766790AeCf8080A66433F6,0x6868C5Af6dE86a828B068b1d7e84bfEBC9D8d4c0
11834,15627910,252356,13145274185,247148,5208,1484,112,0x881D40237659C251811CEC9c364ef91dC08D300C,0xF2F0b060795C7377DD542DF84AdBe1cFd94e0B33
11835,15627910,122577,13145274185,121013,1564,394,43,0x1Fa8559e873f698292766790AeCf8080A66433F6,0x229db3CA752Bb69fFaF19665D3F9dA54EAcc4fA6
11836,15627910,122564,13145274185,121012,1552,394,60,0x1Fa8559e873f698292766790AeCf8080A66433F6,0xD21fA0539961c079807871365f40aC165Ea59cc3
11837,15627910,238963,13145274185,236167,2796,842,862,0x68b3465833fb72A70ecDF485E0e4C7bD8665Fc45,0xb079dfdC955Ff3930a079277c1bDC545cBa35B93
11838,15627910,207128,13145274185,206520,608,138,4708718,0xdAC17F958D2ee523a2206206994597C13D831ec7,0x28C6c06298d514Db089934071355E5743bf21d60
11839,15627910,181476,13145274185,179912,1564,394,852,0x1Fa8559e873f698292766790AeCf8080A66433F6,0x1eb2Cbd1c6D5B6d16aBf1b2760eDf296DE7a1e10
11840,15627910,207128,13145274185,207128,0,2,1679540,0x5e97eE794BF39Ae873520f3eea72159285c0620e,0x4976A4A02f38326660D17bf34b431dC6e2eb2327
11841,15627910,207128,13145274185,206484,644,138,4232352,0x7D1AfA7B718fb893dB30A3aBc0Cfc608AaCfeBB0,0xDFd5293D8e347dFe59E90eFd55b2956a1343963d
11842,15627910,207128,13145274185,207128,0,2,3199190,0x8134Ff13b73Ac047F8cbaD1f9EAcaC41C09187C4,0x9696f59E4d72E237BE84fFD425DCaD154Bf96976
11843,15627910,207128,13145274185,207128,0,2,4468974,0x322636d8025bD1b6F223cCBada2A9db0158Ff97A,0x21a31Ee1afC51d94C2eFcCAa2092aD1028285549
11844,15627910,21000,13145274185,21000,0,2,469173,0xC32C8Ef175a3606966e5Ff4A126Bd84D2C7B972c,0xb739D0895772DBB71A89A3754A160269068f0D45
11845,15627910,207128,13145274185,207128,0,2,4708719,0xFCFC7bfA8Ac6a0Ea544C925a2651bad5a0ebbb6e,0x28C6c06298d514Db089934071355E5743bf21d60
11846,15627910,181476,13145274185,179912,1564,394,620,0x1Fa8559e873f698292766790AeCf8080A66433F6,0x35E3feD8d066213652f67b8e9c99044B92D4a36e
11847,15627910,41690,13145274185,41022,668,138,8,0x6B175474E89094C44Da98b954EedeAC495271d0F,0xa3b7f0aF4E53E2BD0DCa89f79e063a0E97b19757
11848,15627910,42000,13145274185,42000,0,2,329564,0x9a6c7cB93Ce045929c7E727c53824E9Ed2b4902f,0x9430801EBAf509Ad49202aaBC5F5Bc6fd8A3dAf8
11849,15627910,278230,13145274185,275422,2808,842,1775,0x68b3465833fb72A70ecDF485E0e4C7bD8665Fc45,0x9f4A83475ef57F70c1A7754c3B381479626900EA
11850,15627910,21000,13145274185,21000,0,2,187,0xF668A4B45E8CeD85E44ff1E6Fd84d57fe6ec5D49,0x6a5e857D6Cf35083480224AE0619BB801acDC4BC
11851,15627910,191661,13145274185,191029,632,138,103,0xb0Fa2BeEe3Cf36a7Ac7E99B885b48538Ab364853,0xd5507e08e13304Ce9baEA9C856c5AAe3275C8643
11852,15627910,21000,13145274185,21000,0,2,97,0x7a44Bd8189FE02DdE5dDeB64BB50F8A13AE16715,0x5c4c7E87769f4544B63b3c6592E7Ed0Dc8A3a424
11853,15627910,21000,13145274185,21000,0,2,72349,0x134E5788ABa7DE10BA531500794D4703D9B4386A,0xab97925eB84fe0260779F58B7cb08d77dcB1ee2B
11854,15627910,151762,13145274185,150198,1564,394,145,0x1Fa8559e873f698292766790AeCf8080A66433F6,0x2BEc64a2327d17e21c2D31fb160E6014c1e8dD87
11855,15627910,139467,13145274185,114255,25212,8402,231,0x00000000006c3852cbEf3e08E8dF289169EdE581,0x3974E6b8d4d6FD094A514510f5f031575D170929
11856,15627910,207128,13145274185,207128,0,2,1312163,0x5C3799fBF63635a8C10A28522C5A2DCeF3b5497E,0xf60c2Ea62EDBfE808163751DD0d8693DCb30019c
11857,15627910,21000,13145274185,21000,0,2,6578040,0x6c6383f226Ce1275E4BFaD84F2dfcE5E17B648BD,0xeB2629a2734e272Bcc07BDA959863f316F4bD4Cf
11858,15627910,69579,13145274185,68635,944,138,4,0xE30B070e2C147715C64a58Ee51ef3E8A74061626,0xCCA6815482a886227eA5f751445505fbA516215a
11859,15627910,252260,13145274185,250400,1860,458,3929,0x25553828F22bDD19a20e4F12F052903Cb474a335,0x3A56b3b3f778aaA38beBd26d584A900BAbCCadB4
11860,15627910,21000,13145274185,21000,0,2,39,0x37B15cbc481032a45Bf1A54bedC0e9F448D64929,0x2F1404732c9e0CBBF92Ab3794947B520dFB9D433
11861,15627910,77764,13142140264,77168,596,138,5,0x467Bccd9d29f223BcE8043b84E8C8B282827790F,0xe9292bFD1AaB4e689E3C87723912A9F1d85c849a
11862,15627910,115534,13118450220,113746,1788,458,6,0x0BABA1Ad5bE3a5C0a66E7ac838a129Bf948f1eA4,0x8e428Fb268f889f99527C5865aa09c85c666dd66
11863,15627910,21000,13000000000,21000,0,2,25,0xBA6928897514440BA9D14900DD3A7b7591b6a000,0x92965060E73B18ae94473CeC1b0CE8EA30E3FD6B
11864,15627910,21000,12955260359,21000,0,2,1704,0x3a67d258F536389c9bBa3b8630C62E431041bEda,0x1D8371019faD402f6089Baf2B312defeA0825883
11865,15627910,55950,12678766047,55006,944,138,3,0x6097004C68F7B350d72226003226Ac089597D579,0x3af7bd79BDaf5E4aA5eeeaCAD2df9dB41793c5a2
11866,15627910,62259,12646274185,61603,656,138,10211,0x95aD61b0a150d79219dCF64E1E6Cc01f0B64C4cE,0xEdD91797204D3537fBaBDe0E0E42AaE99975f2Bb
11867,15627910,229617,12645274185,226845,2772,842,68,0x68b3465833fb72A70ecDF485E0e4C7bD8665Fc45,0xc6dCDC797d18C3B81Bc59B18F70E4bEC6FF9D504
11868,15627910,205578,12645274185,201962,3616,1162,266,0x68b3465833fb72A70ecDF485E0e4C7bD8665Fc45,0x26e35CDb264614d6843B57D444082EA62709c4f9
11869,15627910,48827,12645274185,47551,1276,202,1144,0x57f1887a8BF19b14fC0dF6Fd9B2acc9Af147eA85,0x4b1D61e2E9655Eae99D090fd42ba11dA7F85B52F
11870,15627910,181476,12645274185,179912,1564,394,14,0x1Fa8559e873f698292766790AeCf8080A66433F6,0x1C472542FB9bad7e21C1A8B6fed2Cb2F431028A6
11871,15627910,77880,12645274185,77272,608,138,5,0x15D4c048F83bd7e37d49eA4C83a07267Ec4203dA,0x7919EB0c1D1B1841D1e57C9AEDAef3A7ff6878ff
11872,15627910,21000,12645274185,21000,0,2,77,0x2617CbBeC7D6358918C0494494d6b13a6024F97b,0xe147122Ae0092357960945e3b56aC8debF0458cf
11873,15627910,46336,12645274185,45680,656,138,206,0x67954768E721FAD0f0f21E33e874497C73ED6a82,0xDFbA83A810B3fCf66ece51EE5b0fD6998D0e8890
11874,15627910,51290,12645274185,50346,944,138,732,0x2b8beC81F648f327B7d8278EE74932845cDa3d19,0x4B90760Cb2174939934e8AAC629E49C75624485D
11875,15627910,121874,12645274185,118598,3276,1034,10,0x0000000000c2d145a2526bD8C716263bFeBe1A72,0x84E210b896B982A6C6cCD6775F3F3328b8178AeE
11876,15627910,46267,12645274185,45691,576,74,15,0x283Af0B28c62C092C9727F1Ee09c02CA627EB7F5,0x69a28644001eCA50420ef6B5Cb30D886936AeDAB
11877,15627910,225354,12645274185,218754,6600,1802,2,0x00000000006c3852cbEf3e08E8dF289169EdE581,0x0A9c4BDEe89a9318881441f6a99105fbdda0A025
11878,15627910,55950,12645274185,55006,944,138,324,0x6097004C68F7B350d72226003226Ac089597D579,0xf18c47E22aB2352C6fbF39Ed87F53F54Bd476ffF
11879,15627910,178758,12645274185,171590,7168,1930,63,0x00000000006c3852cbEf3e08E8dF289169EdE581,0xBeEa584B3F032D0cA801202832E731d6F53C1A79
11880,15627910,21000,12645274185,21000,0,2,1217,0xA45684D3dA5787db547e2ec0D0467238dFF8052A,0x12FebA52718411C91f0df6f77b84fc21bdeA31Db
11881,15627910,21000,12645274185,21000,0,2,6,0x539d8E3250a6955336c413d440FE3BBb7B9B13ee,0x404583ebd340981AfD4D03abC0476C2bb593281b
11882,15627910,131098,12645274185,125114,5984,1674,24,0x00000000006c3852cbEf3e08E8dF289169EdE581,0x17D8Db5920a271125632dfF1Ca7e792365826789
11883,15627910,315944,12645274185,300032,15912,5258,747,0x83C8F28c26bF6aaca652Df1DbBE0e1b56F8baBa2,0x14F64b652948Ed2FEBde2517858644d5C15a6d7f
11884,15627910,21000,12645274185,21000,0,2,86,0xA9870662B3C791b866E12C866478c1838a6144A1,0x209cB8Bc5E355eA6EfD301BdD65F31cdc52D252f
11885,15627910,194876,12645274185,188252,6624,1802,252,0x00000000006c3852cbEf3e08E8dF289169EdE581,0x2039e9e63105502767Ea352CBc4070A66a6CEac6
11886,15627910,73206,12645274185,72586,620,138,4,0xA0b86991c6218b36c1d19D4a2e9Eb0cE3606eB48,0xc73B7188C60796453Df1bEEA13cA718642cB3239
11887,15627910,181476,12645274185,179912,1564,394,50,0x1Fa8559e873f698292766790AeCf8080A66433F6,0x906f99cf7C0dd401Fd8a242119d06A9C774eb9fE
11888,15627910,147848,12645274185,141196,6652,1810,230,0x00000000006c3852cbEf3e08E8dF289169EdE581,0x8ACa1662a0d84309E5afbD935e10d909A4187bc8
11889,15627910,96222,12645274185,93874,2348,522,120,0x2d1715fb980665ef9d95992FB3467634e848691B,0xB8B6888B3339692f97d158764c8f651D6D4BF9ed
11890,15627910,21000,12645274185,21000,0,2,335,0x769a7307378C41BDF43C4AB27d71fE711AA5a83b,0xc82Df81f2549f24F8023936eae26DEb71a87033E
11891,15627910,175110,12645274185,173546,1564,394,100,0x1Fa8559e873f698292766790AeCf8080A66433F6,0x074AF7f2a498a5DE6614af375Ba3be7c4E43247C
11892,15627910,21000,12645274185,21000,0,2,1957,0xB0E56acF3c2973b61aD92eA456858221489e5355,0x51feE9bf45C5DAb188B57048658696edAB9d72Cf
11893,15627910,245929,12645274185,242289,3640,1162,4030,0x68b3465833fb72A70ecDF485E0e4C7bD8665Fc45,0x1541681a72632143E412e918dA772DEaDF6DbC76
11894,15627910,21000,12645274185,21000,0,2,145,0x9844872fEb6619004C7eA7A89e65714700e93B68,0x3d2996Ae16006101Abd515B11b6A836Ce254507c
11895,15627910,21000,12645274185,21000,0,2,207,0x8fAa1Be89609Cf840FeC67aE56996a7388f73a48,0xA5DdaA3bE7d38bA490C6820C26e0530a7AcEa82F
11896,15627910,21000,12645274185,21000,0,2,4,0x0ea6B1e6Fe034691C57524C37A007f617d47fFd7,0x0955E81191821276160F5dC1F55eEE806DD962e1
11897,15627910,100933,12645274185,91205,9728,1674,92,0x0554f068365eD43dcC98dcd7Fd7A8208a5638C72,0x978D38D8C4389E3B3b6293AEBfBd71b719627Cf1
11898,15627910,21000,12645274185,21000,0,2,846,0x3fC571771ca7433058deA997beFe59c36B00E638,0xb689A89954C04C4a238697b64379810a666287ea
11899,15627910,21000,12645274185,21000,0,2,542,0xB70cA0a538E0e71bBCfcF6Df6286Ce9a9e25f209,0xaD5efb0A72254eCe67BAfdB22F18E439c42Bb02C
11900,15627910,51406,12645274185,50918,488,138,77,0xC29F534013a5d9566C206ec0060c192e57741a7d,0x791B61E3198bcFBf83530073F89B896DA85C56CA
11901,15627910,583622,12645274185,579970,3652,1162,2311,0x68b3465833fb72A70ecDF485E0e4C7bD8665Fc45,0xF0Ab80171d776E54840b1400F1e74f9ea6ba64B3
11902,15627910,163772,12645274185,157208,6564,1802,237,0x00000000006c3852cbEf3e08E8dF289169EdE581,0xd07834e20843843fBd3381CbBb970a0Ea5F64C64
11903,15627910,110408,12645274185,109676,732,266,82,0x283Af0B28c62C092C9727F1Ee09c02CA627EB7F5,0x68D1dE395f32aB89e66BC2c6f443C939d449F90E
11904,15627910,98320,12645274185,97380,940,202,430,0x575501e69A1E5512DeEEA8feC53989E84D03547C,0x216A023E0c19382D895a66A76dd92E898c9BE3a7
11905,15627910,46185,12645274185,45697,488,138,6,0x9b3B6974531d8AA15A87908FFd821A64863Ede5B,0x78539a263e8280D0b409d64098288009A2B7416E
11906,15627910,46135,12645274185,45647,488,138,64,0x1Fa8559e873f698292766790AeCf8080A66433F6,0x8F96256e438a09d846538C8610352e0cb75D8cF1
11907,15627910,178746,12645274185,171590,7156,1930,38,0x00000000006c3852cbEf3e08E8dF289169EdE581,0x1542e2A5CA9F89587281A10d4f47B93cA807Bb70
11908,15627910,181476,12645274185,179912,1564,394,125,0x1Fa8559e873f698292766790AeCf8080A66433F6,0xb00753fbF75217517F56026c93eFfbdcA4798607
11909,15627910,608002,12645274185,587678,20324,3594,797,0xBeCCB6bb0aa4ab551966A7E4B97cec74bb359Bf6,0xED9376094Ce37635827E0Cfddc23bFbb6D788469
11910,15627910,104467,12645274185,101191,3276,1034,212,0x0000000000c2d145a2526bD8C716263bFeBe1A72,0x53AA4b81B3F5028658161c4522b9DFFdA83e821c
11911,15627910,339822,12246274185,337566,2256,650,116844,0xA69babEF1cA67A37Ffaf7a485DfFF3382056e78C,0x6046945C5B5eF5933b8E73a98A6AD7bF3e031df7
11912,15627910,181476,12145274185,179912,1564,394,851,0x1Fa8559e873f698292766790AeCf8080A66433F6,0x07646C79De3c4451bf73B322b199b9977CC0Cd8d
11913,15627910,181476,12145274185,179912,1564,394,1373,0x1Fa8559e873f698292766790AeCf8080A66433F6,0x4c951EcB11400e3a3AfB50ea9ee40eC8573ca289
11914,15627910,181476,12145274185,179912,1564,394,909,0x1Fa8559e873f698292766790AeCf8080A66433F6,0xAe5Ed074a5727Ae41738C0482eD68719ad0baCe4
11915,15627910,175092,12145274185,173540,1552,394,489,0x1Fa8559e873f698292766790AeCf8080A66433F6,0x0014DB7A74Bb1F508cdBd49b14b2dadC7C4B0313
11916,15627910,181476,12145274185,179912,1564,394,1047,0x1Fa8559e873f698292766790AeCf8080A66433F6,0xf890Da5aB205741ebC49691eacFE127cfFD90599
11917,15627910,175110,12145274185,173546,1564,394,67,0x1Fa8559e873f698292766790AeCf8080A66433F6,0x3B6A09cE8ac81eA1Fd0b5B73192822f28Bede7cA
11918,15627910,181476,12145274185,179912,1564,394,315,0x1Fa8559e873f698292766790AeCf8080A66433F6,0x5c79F4B2535185D86d3A022b28FCCcA504c8B0D8
11919,15627910,181476,12145274185,179912,1564,394,25,0x1Fa8559e873f698292766790AeCf8080A66433F6,0xD06819622dfe25652daEE22561c2f70cF7b0165f
11920,15627910,181476,12145274185,179912,1564,394,466,0x1Fa8559e873f698292766790AeCf8080A66433F6,0x472fE6Ff89EE8EaF6b9d329F698919dF8658c323
11921,15627910,181476,12145274185,179912,1564,394,1374,0x1Fa8559e873f698292766790AeCf8080A66433F6,0x4c951EcB11400e3a3AfB50ea9ee40eC8573ca289
11922,15627910,181476,12145274185,179912,1564,394,31,0x1Fa8559e873f698292766790AeCf8080A66433F6,0x7C5F72c0273b31bdF87F81EA8638c180EC5ecf30
11923,15627910,181476,12145274185,179912,1564,394,4831,0x1Fa8559e873f698292766790AeCf8080A66433F6,0x8C15973356F0459950e30665F53b0E53b8C694E3
11924,15627910,181476,12145274185,179912,1564,394,532,0x1Fa8559e873f698292766790AeCf8080A66433F6,0x6e76D547aD9fFb5eC6152E6a08eA5c939911Cc06
11925,15627910,238948,12145274185,236164,2784,842,71,0x68b3465833fb72A70ecDF485E0e4C7bD8665Fc45,0x66f54Ca911390De3F6C92158a7c516B4B169fBd0
11926,15627910,269209,12145274185,265189,4020,1226,163,0x68b3465833fb72A70ecDF485E0e4C7bD8665Fc45,0xb46474ED447403367b6fB561B353C1C5995f059F
11927,15627910,181476,12145274185,179912,1564,394,595,0x1Fa8559e873f698292766790AeCf8080A66433F6,0xD78F0C99531DFC8F66ca37FA347962DC1452C281
11928,15627910,181458,12145274185,179906,1552,394,47,0x1Fa8559e873f698292766790AeCf8080A66433F6,0x1b4eFF68E2601B6F15eC2df209C6118dc26dBe3D
11929,15627910,181476,12145274185,179912,1564,394,3411,0x1Fa8559e873f698292766790AeCf8080A66433F6,0x6A4406F5be648B406c0c20334E8a5DE6B4999516
11930,15627910,181476,12145274185,179912,1564,394,9,0x1Fa8559e873f698292766790AeCf8080A66433F6,0x689c0199ac617bB832ee280795BD5fE3678E1c5E
11931,15627910,280862,12145274185,277030,3832,970,131300,0xa57Bd00134B2850B2a1c55860c9e9ea100fDd6CF,0x60b86AF869f23aEb552fB7F3CaBD11B829f6Ab2F
11932,15627910,175110,12145274185,173546,1564,394,394,0x1Fa8559e873f698292766790AeCf8080A66433F6,0x66208416CB1dAF88716af68E405fcC8994c059D2
11933,15627910,51842,12000000000,51186,656,138,0,0x6B175474E89094C44Da98b954EedeAC495271d0F,0x1aa34ba12e85f99BC03c219Dc7DBE41c92cEBaa9
11934,15627910,21000,12000000000,21000,0,2,31,0x8E289c5DC6d181d4084b5c06C3f1BA457217644c,0xc6632B19c8B0851Ba131e896af9d36B9b8554A40
11935,15627910,21000,12000000000,21000,0,2,70,0x7E508f108c0b2F988Aa200F807d539b30593711b,0x7F376a53606E7826eDacACFF79910E49cA5c0c6c
11936,15627910,54077,12000000000,53777,300,74,399,0xC02aaA39b223FE8D0A0e5C4F27eAD9083C756Cc2,0x4dCbB1fE5983ad5b44DC661273a4f11CA812f8B8
11937,15627910,78556,11958394280,77900,656,138,5,0x12b6893cE26Ea6341919FE289212ef77e51688c8,0xC75Eeb0F9D358B0BA7d916E843D55311416620Da
11938,15627910,54339,11807444389,53395,944,138,39,0x4b13006980aCB09645131b91D259eaA111eaF5Ba,0x40DE8c96A8119E1b6A611370F1599058adF6588f
11939,15627910,310238,11145274185,308042,2196,650,117903,0xA69babEF1cA67A37Ffaf7a485DfFF3382056e78C,0x26bce6eCb5b10138e4bf14aC0ffcc8727FEF3B2e
11940,15627910,83602,11381196010,80542,3060,650,131320,0x1531b6e3d51BF80f634957dF81A990B92dA4b154,0xCb6Ed7E78d27FDff28127F9CbD61d861F09a2324
11941,15627910,21000,11176800000,21000,0,2,55,0x2c0aAd76BF038bc11Cc8DBb0faA24EC0c6aBfEED,0x7C98A9d061d280481de819D31f49d8A494C7F4c3
11942,15627910,75735,11176773037,71595,4140,842,3787,0x00000000219ab540356cBB839Cbe05303d7705Fa,0x5180db0237291A6449DdA9ed33aD90a38787621c
11943,15627910,26000,11145274185,26000,0,2,12037,0x388C818CA8B9251b393131C08a736A67ccB19297,0xDAFEA492D9c6733ae3d56b7Ed1ADB60692c98Bc5
11944,15627911,188863,10959152379,188219,644,90,103256,0x01FF6318440f7D5553a82294D78262D5f5084EFF,0x5AA17fC7F2950ECa85376C3A8CB1509e8e4B39dF
11945,15627911,319338,11959152379,317418,1920,458,32,0x7a250d5630B4cF539739dF2C5dAcb4c659F2488D,0x8617d3B9f2C24a109BF18831fE358038AaB7034F
11946,15627911,188055,328611780916,187079,976,130,103257,0x01FF6318440f7D5553a82294D78262D5f5084EFF,0x5AA17fC7F2950ECa85376C3A8CB1509e8e4B39dF
11947,15627911,483078,70959152379,481138,1940,522,483,0x7a250d5630B4cF539739dF2C5dAcb4c659F2488D,0xe3691faBe650e4Ce0E2570BBd32ac1BAe8600E71
11948,15627911,256092,11959152379,252284,3808,970,111464,0xa57Bd00134B2850B2a1c55860c9e9ea100fDd6CF,0x065e3DbaFCb2C26A978720f9eB4Bce6aD9D644a1
11949,15627911,185906,64736888477,183690,2216,324,113,0xFd0000000100069aD1670066004306009B487AD7,0xECE773De275f2e57eD6eb537f8FDAce030F94601
11950,15627911,181458,41959152379,179906,1552,394,1877,0x1Fa8559e873f698292766790AeCf8080A66433F6,0x5fD8F613Be904b065E421F2e2f0FCb1A4f350559
11951,15627911,210000,32500000000,210000,0,2,843596,0xA912d194D7760f0F10b9b9784E18Bde67a4beb44,0xA7EFAe728D2936e78BDA97dc267687568dD593f3
11952,15627911,420000,32500000000,419332,668,138,2198555,0x6B175474E89094C44Da98b954EedeAC495271d0F,0x6cC5F688a315f3dC28A7781717a9A798a59fDA7b
11953,15627911,150000,32500000000,149344,656,138,4221,0xC011a73ee8576Fb46F5E1c5751cA3B9Fe0af2a6F,0x0E0dD4a9F1AE43300d537Ba7d62220774C9C8312
11954,15627911,146308,10959152379,145708,600,80,5190,0x00000000A991C429eE2Ec6df19d40fe0c80088B8,0x77ad3a15b78101883AF36aD4A875e17c86AC65d1
11955,15627911,183727,12459152379,180955,2772,842,6,0x68b3465833fb72A70ecDF485E0e4C7bD8665Fc45,0x960F560D882e89e783F2a5Ece445F8441dD96eC1
11956,15627911,113882,84632209491,112962,920,120,5191,0x00000000A991C429eE2Ec6df19d40fe0c80088B8,0x77ad3a15b78101883AF36aD4A875e17c86AC65d1
11957,15627911,231776,10959152379,231024,752,138,123120,0x000000000035B5e5ad9019092C665357240f594e,0x38563699560e4512c7574C8cC5Cf89fd43923BcA
11958,15627911,219267,12959152379,216507,2760,842,7425,0x68b3465833fb72A70ecDF485E0e4C7bD8665Fc45,0xBe23CbB62064b8B1550Ae5ADA59c39d45b1E2081
11959,15627911,221607,78719332340,220487,1120,202,123121,0x000000000035B5e5ad9019092C665357240f594e,0x38563699560e4512c7574C8cC5Cf89fd43923BcA
11960,15627911,88095,31700000000,87311,784,202,3467,0x1dd0C7cBF5b420648Fe37EDCdc64cBE30842E3b2,0x6EC9A24013aC5bB4B097e2659ee63467718ef770
11961,15627911,181458,20959152379,179906,1552,394,321,0x1Fa8559e873f698292766790AeCf8080A66433F6,0xaF25f948c1daa5Ed272345BbE355895F036eAa61
11962,15627911,21000,17071794015,21000,0,2,181441,0x058305214a636a5DF4dF06F5C47232Bc09C35C1E,0x6238872A0Bd9F0E19073695532a7Ed77ce93C69E
11963,15627911,175110,16959152379,173546,1564,394,41,0x1Fa8559e873f698292766790AeCf8080A66433F6,0x1C19Ff35553fE47A4d8980cCa5e06908c7048bEc
11964,15627911,55897,15959152379,54953,944,138,1688,0xFDBf91A7F2d757A9815326af5E1e60319571984c,0x8b5E270C19eb8f28050a561D0bE08690cc33e73D
11965,15627911,21000,15000000000,21000,0,2,32197,0xBed72B1b22D58D5131fc5591F033221F0D899547,0x4AD8d9cF9424B477E77a0d7c339c4de792B92Fc6
11966,15627911,63000,14859520519,63000,0,2,4709949,0x40AbC97EEB69E480AFB743e2286D1A0b9b9ef65c,0x2FAF487A4414Fe77e2327F0bf4AE2a264a776AD2
11967,15627911,76221,14826905346,75233,988,202,355162,0xdAC17F958D2ee523a2206206994597C13D831ec7,0x7abE0cE388281d2aCF297Cb089caef3819b13448
11968,15627911,50000,14795554813,50000,0,2,476124,0x8f6b5607124C53F2a16BC48A74772F09875D9F42,0x4d846dA8257BB0Ebd164EFf513DfF0F0c2C3c0ba
11969,15627911,21000,14751800439,21000,0,2,3,0x25eAff5B179f209Cf186B1cdCbFa463A69Df4C45,0x1664aF12A701D2D49d28c1D56F0facc8d68bb4B0
11970,15627911,90000,14018301167,90000,0,2,784421,0x5F278C6FEA190Aa1a714D35843C5D4aD043bd544,0xcaD621da75a66c7A8f4FF86D30A2bF981Bfc8FdD
11971,15627911,200000,14018301167,199332,668,138,1050392,0x320623b8E4fF03373931769A31Fc52A4E78B5d70,0xf16E9B0D03470827A95CDfd0Cb8a8A3b46969B91
11972,15627911,90000,14018301167,90000,0,2,784422,0x25CB07880b6310f5a2313BF1dFd0420FAD9a0790,0xcaD621da75a66c7A8f4FF86D30A2bF981Bfc8FdD
11973,15627911,21000,14000000000,21000,0,2,66,0x51D33275856E769e121459A2dDf7242E370FEA57,0x858448850D316537EAD10512d0802D36966f609f
11974,15627911,21000,13959152379,21000,0,2,1965,0x17831e4EB0E6DFDbF8B5fF132FCCA4D4a750A0a3,0xAA1bDB17eB516A6088Da0e7341FAAB2B310C372A
11975,15627911,181458,13959152379,179906,1552,394,495,0x1Fa8559e873f698292766790AeCf8080A66433F6,0xBb340B5A7de9080E32914Cf0779bec51887bfFC3
11976,15627911,21000,13580000000,21000,0,2,0,0x6dfc34609a05bC22319fA4Cce1d1E2929548c0D7,0x2D3F40Db7fA8b75bE90EAED4E1C769c9DFf7064A
11977,15627911,21000,13580000000,21000,0,2,0,0x6dfc34609a05bC22319fA4Cce1d1E2929548c0D7,0x08d25fBdf0e793Bb6C3aaa21786c0069C71BC79b
11978,15627911,305920,13459152379,298920,7000,970,67,0x9b3B6974531d8AA15A87908FFd821A64863Ede5B,0x34cf0fEC3C5fd086C91fc1AA9Cc8C472D85c92b1
11979,15627911,150756,13459152379,150692,64,10,4,0x65c2e54a4c75ff6da7b6B32369c1677250075fb2,0x7E68FAD0DB5f91Ce699515089a6814c49D7022c7
11980,15627911,69181,13142140264,68561,620,138,99,0xdAC17F958D2ee523a2206206994597C13D831ec7,0x974580f31BfaB7f61eE5f0B4f450f722342fd86c
11981,15627911,181476,12959152379,179912,1564,394,2653,0x1Fa8559e873f698292766790AeCf8080A66433F6,0xB235Ba58e93BA482b19e81d66eB001CD6fFD601b
11982,15627911,181476,12959152379,179912,1564,394,131,0x1Fa8559e873f698292766790AeCf8080A66433F6,0x0e1390FD9B1b6d5f930c54e240bF929d207e0BAb
11983,15627911,167010,12959152379,160434,6576,1802,985,0x00000000006c3852cbEf3e08E8dF289169EdE581,0xa04c72592849B57c6830B36C43f77faC9A7886B2
11984,15627911,181476,12959152379,179912,1564,394,278,0x1Fa8559e873f698292766790AeCf8080A66433F6,0xBC397672C3D6C6F4C1139Af7E4b3701F066e57e8
11985,15627911,181476,12959152379,179912,1564,394,5,0x1Fa8559e873f698292766790AeCf8080A66433F6,0xdC6ebFBC41d38534ad69B567CD79C273c5cfd581
11986,15627911,528483,12959152379,524867,3616,1162,146,0x68b3465833fb72A70ecDF485E0e4C7bD8665Fc45,0xDC6b0729994D827F1F4F32Abe52E72cC98485fDA
11987,15627911,247139,12959152379,242339,4800,1292,4,0x881D40237659C251811CEC9c364ef91dC08D300C,0x5D993569E0aD59A2a18be26E44a9bAe9Df42E8cf
11988,15627911,42000,12959152379,42000,0,2,329565,0x69D248FdCa5D9D50f810cf7f72D5249415D0d78b,0x9430801EBAf509Ad49202aaBC5F5Bc6fd8A3dAf8
11989,15627911,99244,12959152379,98636,608,138,15,0xA0b86991c6218b36c1d19D4a2e9Eb0cE3606eB48,0xCcB85037D536731CEf4DE24E16EE9A87E0718d21
11990,15627911,21000,12959152379,21000,0,2,6578041,0x0E65A3122F4bb1a07Fa0b5593470F50F8B19Cb58,0xeB2629a2734e272Bcc07BDA959863f316F4bD4Cf
11991,15627911,21000,12959152379,21000,0,2,102,0x4B7DcCf7003C8De993D227E4d744b13Bbb5Ea779,0xf201c24524Ee5131E00355695c35D5A650CbF19F
11992,15627911,21000,12959152379,21000,0,2,346926,0x0e057642f3C7ca359AAc31a2391E4776B4b9b461,0x77696bb39917C91A0c3908D577d5e322095425cA
11993,15627911,181476,12959152379,179912,1564,394,1539,0x1Fa8559e873f698292766790AeCf8080A66433F6,0x7fF146336b1835Cc65543f86c74a8C8FdaC79712
11994,15627911,49542,12959152379,49478,64,10,149,0xC02aaA39b223FE8D0A0e5C4F27eAD9083C756Cc2,0x091caFe937Cc446fCC45a87FCbB8d55590B862Dd
11995,15627911,181476,12959152379,179912,1564,394,2349,0x1Fa8559e873f698292766790AeCf8080A66433F6,0xCAe447432bb11BAA5170ccBB90D060b28479eC21
11996,15627911,21000,12959152379,21000,0,2,52386,0xE1Bc4791e5D5c478C47b06737431506cFEde63A0,0x7c195D981AbFdC3DDecd2ca0Fed0958430488e34
11997,15627911,21000,12959152379,21000,0,2,469174,0x8F44ace03bb5cF0129f42214CcbCd46Ff236903f,0xb739D0895772DBB71A89A3754A160269068f0D45
11998,15627911,21000,12959152379,21000,0,2,52387,0x32a790d833E8aA6888367D2B89a650DC8Ef5bBc7,0x7c195D981AbFdC3DDecd2ca0Fed0958430488e34
11999,15627911,21000,12959152379,21000,0,2,1228781,0xc76d0AbAc3334FE0fc4B6a5E3CC06bE54De24b6F,0x71660c4005BA85c37ccec55d0C4493E66Fe775d3
12000,15627911,271788,12959152379,271724,64,10,104,0xC25c37c387C5C909a94055F4f16184ca325D3a76,0xd5507e08e13304Ce9baEA9C856c5AAe3275C8643
12001,15627911,7500000,12959152379,7420820,79180,19594,2829,0xed136c7f420f35e43D43ff73FA2C0c259718749e,0x40D0F1c7979CD5E91f52a0FE00a1c61b466BAa15
12002,15627911,246430,12959152379,243598,2832,842,1565,0x68b3465833fb72A70ecDF485E0e4C7bD8665Fc45,0xaD14c24E1C816Fbc6F6A36C4d3F2790312893817
12003,15627911,122577,12959152379,121013,1564,394,50,0x1Fa8559e873f698292766790AeCf8080A66433F6,0x195CBA349C3203C8D2312919616D07d4f0b2b05F
12004,15627911,86811,12959152379,85859,952,202,641,0x1Fa8559e873f698292766790AeCf8080A66433F6,0x98BDd55fd7B988630fF2bFFB059CF20682a5a612
12005,15627911,86811,12959152379,85859,952,202,1198,0x1Fa8559e873f698292766790AeCf8080A66433F6,0xC9B44b591A92483445923F37E49C3c562316d2Cc
12006,15627911,23300,12959152379,23300,0,2,2,0xA9D1e08C7793af67e9d92fe308d5697FB81d3E43,0x07e85B082586d3c347662322c269a506a3e70226
12007,15627911,23300,12959152379,23300,0,2,1,0xA9D1e08C7793af67e9d92fe308d5697FB81d3E43,0x4d538f80550Daf4b04E4a16E52F541B4A7eB526d
12008,15627911,86811,12959152379,85859,952,202,256,0x1Fa8559e873f698292766790AeCf8080A66433F6,0x6A07A4A558AAB37bcf1eE7D8e9A3885018275a12
12009,15627911,23300,12959152379,23300,0,2,4,0xA9D1e08C7793af67e9d92fe308d5697FB81d3E43,0x6d794109409B0EaDb4428D8d2743d3922DaeA72e
12010,15627911,23300,12959152379,23300,0,2,1,0xA9D1e08C7793af67e9d92fe308d5697FB81d3E43,0x1232A18C318E5b33af9933edD81BB7BC8e6A1838
12011,15627911,86811,12959152379,85859,952,202,223,0x1Fa8559e873f698292766790AeCf8080A66433F6,0x1eE9572Ac7d3ba68Fa98c2537BB099675Acc107c
12012,15627911,23300,12959152379,23300,0,2,0,0xA9D1e08C7793af67e9d92fe308d5697FB81d3E43,0xF83aa7596C2c0eD33Ee2022f9DCE38F5B724BA44
12013,15627911,21000,12959152379,21000,0,2,446242,0x3cD751E6b0078Be393132286c442345e5DC49699,0xA090e606E30bD747d4E6245a1517EbE430F0057e
12014,15627911,21000,12959152379,21000,0,2,1,0x3cD751E6b0078Be393132286c442345e5DC49699,0xd823D2ea7EaC4D66d7e3cE76B8ccCc0b4C0b55cE
12015,15627911,21000,12959152379,21000,0,2,17,0x3cD751E6b0078Be393132286c442345e5DC49699,0x2F5528B92F357F84156B578f9f39fA11AD207fA0
12016,15627911,175110,12959152379,173546,1564,394,46,0x1Fa8559e873f698292766790AeCf8080A66433F6,0x0601f794CfD96C939d2F918f8a45a1Be1883ebDE
12017,15627911,122577,12959152379,121013,1564,394,48,0x1Fa8559e873f698292766790AeCf8080A66433F6,0x852C4301f3B82672B0CA5A3bc55B7e15d63f3d1d
12018,15627911,122577,12959152379,121013,1564,394,50,0x1Fa8559e873f698292766790AeCf8080A66433F6,0x67A92D91D506f1E5E0B54267A3b6c5fbB88bA805
12019,15627911,122577,12959152379,121013,1564,394,52,0x1Fa8559e873f698292766790AeCf8080A66433F6,0xdA0cCb8375D129199371662Ae04BE4176487c8B6
12020,15627911,232956,12959152379,229316,3640,1162,602,0x68b3465833fb72A70ecDF485E0e4C7bD8665Fc45,0xe2758DD76136e6bE2188D9076AC6BC02410cD148
12021,15627911,122564,12959152379,121012,1552,394,53,0x1Fa8559e873f698292766790AeCf8080A66433F6,0x6B055810032b35F3F85801D5B8F124849E6C8F6a
12022,15627911,28974,12459152379,28414,560,138,492,0x6B175474E89094C44Da98b954EedeAC495271d0F,0x2EceCf5a33d038694133BbF3A22AEAFBc96d4B04
12023,15627911,46255,12459152379,45691,564,74,52,0x283Af0B28c62C092C9727F1Ee09c02CA627EB7F5,0x30628B81bc8439549c5AbBB27D02b828b1EA93A4
12024,15627911,56950,12459152379,54450,2500,586,630,0x4976fb03C32e5B8cfe2b6cCB31c09Ba78EBaBa41,0x596A2B27BfC6862C2fFB53A2b1F4BF7F1a047342
12025,15627911,71949,12459152379,71281,668,138,343,0x454BD9E2B29EB5963048cC1A8BD6fD44e89899Cb,0xc8312f842c20BFC59301cb6fE0e7683A9107FDED
12026,15627911,521959,12459152379,494119,27840,10058,3,0x83C8F28c26bF6aaca652Df1DbBE0e1b56F8baBa2,0x7fBB922c1306047203C954a709417EE58BF11da8
12027,15627911,290359,12459152379,276399,13960,4618,3,0x83C8F28c26bF6aaca652Df1DbBE0e1b56F8baBa2,0x4b3bf42dfd03Ae4D50C92168508cE6a1aF3b5dd6
12028,15627911,46707,12459152379,46219,488,138,294,0x8943C7bAC1914C9A7ABa750Bf2B6B09Fd21037E0,0xA346C2615F70607F1973Caf6d45A26aF51089fe6
12029,15627911,61853,12459152379,61637,216,74,8,0x2Dd4b6Ee73Ab76D2381b5e43D166e836EE322033,0x1be06A045EA2e4949366e303ABcf41dEc9052976
12030,15627911,186555,12459152379,179955,6600,1802,2,0x00000000006c3852cbEf3e08E8dF289169EdE581,0x281cdF9aB30ee0609f84dC36F8DbB8983a5b8a9F
12031,15627911,175110,12459152379,173546,1564,394,117,0x1Fa8559e873f698292766790AeCf8080A66433F6,0xb4C9Cf1E19Ec844bd4507E7Cc122Eda3BF676dB8
12032,15627911,55779,12459152379,54835,944,138,99,0x26c8AFBBFE1EBaca03C2bB082E69D0476Bffe099,0x64CA6B425AC919A253a0074dc1A7DD8324E3b96c
12033,15627911,21000,12459152379,21000,0,2,757,0xE22F53B1e9381B140EB1D24b945100a43f8FcA92,0xdf9A0f367d21b0F85a106f3b15e8012a7C9C411b
12034,15627911,46135,12459152379,45647,488,138,2587,0x1Fa8559e873f698292766790AeCf8080A66433F6,0x4a87D1b71937F06Db976631BdFacC82A5cdd076A
12035,15627911,94463,12459152379,94031,432,74,1,0xA0c68C638235ee32657e8f720a23ceC1bFc77C77,0x3fCcc08A250a1c2e37cC4d6D2B22c7f0b7B132Ff
12036,15627911,21000,12459152379,21000,0,2,4509,0x3CdABa566F3a5106035237aa8F69D46cF97bE3d3,0x5F6D3d4F90aB31064E90046745F72E89eB38FF79
12037,15627911,72866,12459152379,71006,1860,458,165,0xFbdDaDD80fe7bda00B901FbAf73803F2238Ae655,0xB78F8440a21a3128439BE04ac257703EE549a41E
12038,15627911,238948,12459152379,236164,2784,842,369,0x68b3465833fb72A70ecDF485E0e4C7bD8665Fc45,0x94e3047aE5bbce0039B19b264120Ee9A350c7875
12039,15627911,176930,12459152379,170354,6576,1802,78,0x00000000006c3852cbEf3e08E8dF289169EdE581,0xaa69CD8502BE79c5DbBc4abf3f36Aa7774aC4755
12040,15627911,175110,12459152379,173546,1564,394,369,0x1Fa8559e873f698292766790AeCf8080A66433F6,0x790781E8985d51c60Aa141743B5E8080D22B4dC8
12041,15627911,169601,12459152379,159297,10304,3402,17,0x00000000006c3852cbEf3e08E8dF289169EdE581,0xC6DF6e7113979FCe34bd9F1f5eC0833552a0b6a9
12042,15627911,242090,12459152379,240266,1824,458,1,0x7a250d5630B4cF539739dF2C5dAcb4c659F2488D,0x5c9F061039D25543e82cB4eCBe0f038B0d44C571
12043,15627911,51406,12459152379,50918,488,138,176,0x7E07b65B5768792a23D283F3884615786Ea020FD,0xBc622C6bcc9200c68d525AdF5c8b1B9C3d1C6DE3
12044,15627911,177493,12459152379,173913,3580,1162,210,0x68b3465833fb72A70ecDF485E0e4C7bD8665Fc45,0x3193db2D06Ef42Ed7f517dAAC491bac9Ecd0E7c8
12045,15627911,46443,12459152379,45871,572,138,91,0x9eEeAF684E228C2D5C89435e010acC02c41Dc86B,0xe331Fb1EdBe0EA0256d957C4955245404d5Ae124
12046,15627911,55897,12459152379,54953,944,138,3376,0xFDBf91A7F2d757A9815326af5E1e60319571984c,0x2Dfd7946a6D8cA71ae48c307518ACC7aF5407dd5
12047,15627911,21000,12459152379,21000,0,2,2,0x401C9936245c5d424337099dD7bb92c813A9bc71,0x78a618B562AE0A781EA1b44BAF85108D7F5ac067
12048,15627911,186580,12459152379,178300,8280,2186,411,0x00000000006c3852cbEf3e08E8dF289169EdE581,0xAcC69f5119C490bB2c8CA4DC6d2ab55A112EB9e8
12049,15627911,99244,12459152379,98636,608,138,96,0xA0b86991c6218b36c1d19D4a2e9Eb0cE3606eB48,0xEEA80cBED6E6f4C4EfBE6bF9f13562e3C562257e
12050,15627911,119581,12459152379,107445,12136,2314,91,0x8B1631ab830d11531aE83725fDa4D86012eCCd77,0x07148984389eddf3A188943807310EA9E22Cef50
12051,15627911,285339,12459152379,282235,3104,906,999,0x68b3465833fb72A70ecDF485E0e4C7bD8665Fc45,0xB837943B6879579640285a20aA9bd34BCD548134
12052,15627911,153291,12459152379,148463,4828,1546,6,0x0000000000c2d145a2526bD8C716263bFeBe1A72,0x05AFc8485cB9675185d2986ca66bF2fdD9933B31
12053,15627911,46267,12459152379,45691,576,74,242,0x283Af0B28c62C092C9727F1Ee09c02CA627EB7F5,0x8694918FFA878B8b53c54c11DF41f7BC574Fb2fd
12054,15627911,67544,12459152379,66068,1476,458,20,0xce5472392F8F37a8972767e7f809cB812c660176,0x030ce9d143332f6D9c287414f08e22c145c43c58
12055,15627911,46135,12459152379,45647,488,138,133,0x1Fa8559e873f698292766790AeCf8080A66433F6,0x9e7Ab7F8e04916B48fB86C9CdE15C54E7DAF1a26
12056,15627911,21000,12459152379,21000,0,2,129,0x44E60964F9B749c7C8F025614e421eB4af9cCf1b,0xB95731D8960164cdF68484439c65A634e471AA60
12057,15627911,21000,12459152379,21000,0,2,119,0x78fEd80ac6Dee33C1eE92fe4D91DaBB775CC1048,0x8c8363EE1D5AE7E3931D8EfD302ea1bB39Ef0488
12058,15627911,46135,12459152379,45647,488,138,1067,0x1Fa8559e873f698292766790AeCf8080A66433F6,0xe713a75d8bc2f29F42b0d2C2BE3370E65A62b5Eb
12059,15627911,61423,12459152379,53271,8152,2506,44,0x00000000006c3852cbEf3e08E8dF289169EdE581,0x88D5c00A887F5242DE709E38EB48dFfB28373871
12060,15627911,243115,12459152379,240271,2844,842,592,0x68b3465833fb72A70ecDF485E0e4C7bD8665Fc45,0xCa1eE57390f16B67855D200Cebf59804277a9DDd
12061,15627911,181476,12000000000,179912,1564,394,405,0x1Fa8559e873f698292766790AeCf8080A66433F6,0x32f403ad8b2aD3197F12Bb54E067a44A16b449F2
12062,15627911,175092,11959152379,173540,1552,394,112,0x1Fa8559e873f698292766790AeCf8080A66433F6,0x5D98C78B334FF386c82D745A3ddC9b38B700DF24
12063,15627911,181476,11959152379,179912,1564,394,639,0x1Fa8559e873f698292766790AeCf8080A66433F6,0x44351a38AB7A510E8ce213A7D3314a515637b4Eb
12064,15627911,181476,11959152379,179912,1564,394,871,0x1Fa8559e873f698292766790AeCf8080A66433F6,0x0dFa971d29EF0d9540356a5B6D2F7CB9dc4Fe3Ba
12065,15627911,181476,11959152379,179912,1564,394,255,0x1Fa8559e873f698292766790AeCf8080A66433F6,0x6f58b9fac2E7847e43f61Ab50bb3C1dDaa84D249
12066,15627911,181476,11959152379,179912,1564,394,2168,0x1Fa8559e873f698292766790AeCf8080A66433F6,0x1c308bCdFfa3CDaFd2D2Eaa740ae5402C44F2448
12067,15627911,181476,11959152379,179912,1564,394,100,0x1Fa8559e873f698292766790AeCf8080A66433F6,0xb837C68ed7a8E9EC8353E3B99F760f29386C9606
12068,15627911,181458,11959152379,179906,1552,394,1108,0x1Fa8559e873f698292766790AeCf8080A66433F6,0x9a0Abcd57493935A1fD880B157A0f9784471BA89
12069,15627911,203991,11959152379,203787,204,74,41,0x5DAC20CEabd1cfC989Ab4C48AF95e563631556c9,0xa41d089D03A2CdCdc324F8F779E43457fC961150
12070,15627911,181476,11959152379,179912,1564,394,360,0x1Fa8559e873f698292766790AeCf8080A66433F6,0x43499A7C7Ff7321EfC5258C54A539Ccd75DD4eF0
12071,15627911,181476,11959152379,179912,1564,394,1602,0x1Fa8559e873f698292766790AeCf8080A66433F6,0x8ec27E9F5BAb92b94b15ab4F1DE164c5a5da2e99
12072,15627911,269208,11959152379,265388,3820,970,119384,0xa57Bd00134B2850B2a1c55860c9e9ea100fDd6CF,0x0cac3d1a887206e0f6169222C4504301A8b4b993
12073,15627911,267818,11959152379,265550,2268,650,119834,0xA69babEF1cA67A37Ffaf7a485DfFF3382056e78C,0xeCa2e2D894D19778939bD4DfC34D2a3C45E96456
12074,15627911,550000,11959152379,548152,1848,458,91,0x7a250d5630B4cF539739dF2C5dAcb4c659F2488D,0x00804aD8aa538E852f5Bb4A49f8957a783ac132f
12075,15627911,964997,11959152379,957749,7248,2762,327,0x267F73c996B501aF83d7989EA7f4dF859D9656b2,0x58C419CA3B2f574b3507445d01ABf37004b3Fb9f
12076,15627911,181476,11959152379,179912,1564,394,193,0x1Fa8559e873f698292766790AeCf8080A66433F6,0xE536FfBacbB00b6358dDAFC82603074a9a869d0f
12077,15627911,181476,11959152379,179912,1564,394,264,0x1Fa8559e873f698292766790AeCf8080A66433F6,0xe36d70fEC9AD96bea2AeA47dAe19Ae6dB79ceBbd
12078,15627911,181476,11959152379,179912,1564,394,3397,0x1Fa8559e873f698292766790AeCf8080A66433F6,0xcaB4aF915606304fAbD7AdeE53aCf501b1Fe6372
12079,15627911,181476,11959152379,179912,1564,394,498,0x1Fa8559e873f698292766790AeCf8080A66433F6,0xF4eC5E5f7D0BdcE9010Ba4440F827561d357Be14
12080,15627911,181476,11959152379,179912,1564,394,1689,0x1Fa8559e873f698292766790AeCf8080A66433F6,0xbD4A24389C3dad6033cECb7224f00Ed2CF630754
12081,15627911,181458,11959152379,179906,1552,394,4,0x1Fa8559e873f698292766790AeCf8080A66433F6,0xcD136eD15581bb542D14317A6066e25BF62c2600
12082,15627911,181476,11959152379,179912,1564,394,666,0x1Fa8559e873f698292766790AeCf8080A66433F6,0x10d82667C353f99D4F93462E6A149bEc2b5941ba
12083,15627911,181440,11959152379,179900,1540,394,208,0x1Fa8559e873f698292766790AeCf8080A66433F6,0x92c876a81118b9120227e79DBf84C6AD9526EB57
12084,15627911,181476,11959152379,179912,1564,394,2,0x1Fa8559e873f698292766790AeCf8080A66433F6,0x6dDF54D654d417c87ae3E056F3709317fE97EBeB
12085,15627911,181476,11959152379,179912,1564,394,121,0x1Fa8559e873f698292766790AeCf8080A66433F6,0xf8626c103cEF53371663653e249E7c16acfC51dF
12086,15627911,260875,11959152379,256935,3940,1162,6044,0xD7c09E006A2891880331b0F6224071C1e890A98A,0x6898B6ca04BEc2AFD7881Da4CE915D24c9d1f7B4
12087,15627911,408140,11959152379,406444,1696,292,26587,0xC8046263d5B5544F6413a98B4693488499195A46,0xEf5a3745F822f8F83693564c54904d7FF156CFb2
12088,15627911,268133,11959152379,262661,5472,1082,105726,0x0000000000007F150Bd6f54c40A34d7C3d5e9f56,0x60530f5Ca4CB9907e0FBE67cA3AFCbFE56D19A5c
12089,15627911,181476,11959152379,179912,1564,394,674,0x1Fa8559e873f698292766790AeCf8080A66433F6,0x670338d4347E8C544d885cd666b365A944D1A743
12090,15627911,242973,11769254880,240177,2796,842,229,0x68b3465833fb72A70ecDF485E0e4C7bD8665Fc45,0xB6D1aa613F99AcA09a4aE736C37B0d9073f0265F
12091,15627911,181476,11627835264,179912,1564,394,254,0x1Fa8559e873f698292766790AeCf8080A66433F6,0xFEe6b9d5e0802eB9519F1a2B3EBc7cAc3D630361
12092,15627911,288816,11195074204,287088,1728,458,5,0x7a250d5630B4cF539739dF2C5dAcb4c659F2488D,0x816Ab258b14839ef14201ef023d2eBD095Ce41F9
12093,15627911,46052,11000000000,45564,488,138,44,0xb967D2335A3879b7CAE42E085f88274EBff90Fc4,0x25e63dB482D92fafb301CDA23a0D83e1EFB4A5F2
12094,15627911,26000,10959152379,26000,0,2,12038,0xfFEE087852cb4898e6c3532E776e68BC68b1143B,0xDAFEA492D9c6733ae3d56b7Ed1ADB60692c98Bc5
12095,15627912,320000,27300000000,316732,3268,778,26743,0x14ff6EA1E1db3615a98f595443F831A8973311dd,0x30384F64308C37d8362Ca1795621d6B2769c5DE9
12096,15627912,90000,21000000000,89392,608,138,12623,0x05237E2bd2dfAb39a135d254cABAE94b183C8baD,0xFd25F5A3415e29f0AeeB5746E5D513DE67169225
12097,15627912,500000,20000000000,498092,1908,458,3741,0x7a250d5630B4cF539739dF2C5dAcb4c659F2488D,0x11286A8D9AB6C307Ce0681Ad66C1b588Ad85a03a
12098,15627912,5049304,17000000000,5042216,7088,1098,304,0x0a39DA505DfB5E0BBc6bd84428281A8ba1bC7753,0x495E889d1A6cEB447a57dcc1C68410299392380c
12099,15627912,319338,16040242891,317418,1920,458,220,0x7a250d5630B4cF539739dF2C5dAcb4c659F2488D,0x11cE31192602A36f4203b264da3132D2a5A9BF17
12100,15627912,181476,15000000000,179912,1564,394,321,0x1Fa8559e873f698292766790AeCf8080A66433F6,0xe18113fD595d7A4CcD037d8c6E85028ac32aC2Cd
12101,15627912,181476,15040242891,179912,1564,394,941,0x1Fa8559e873f698292766790AeCf8080A66433F6,0xe04C4a474ca4591B476084aC2699Be10aa3Ce76E
12102,15627912,63000,14940611031,63000,0,2,2710067,0x3090c2CA58b08a9BAD990B10B2203C3F618eEDAc,0xC098B2a3Aa256D2140208C3de6543aAEf5cd3A94
12103,15627912,63000,14914237161,63000,0,2,183634,0x4eCCB4B0D7b79AFa968c257c6cEf888037672aca,0x25eAff5B179f209Cf186B1cdCbFa463A69Df4C45
12104,15627912,222222,14000000000,220658,1564,394,146,0x1Fa8559e873f698292766790AeCf8080A66433F6,0xd606E1800eC831F9e63dd53DcFB8a53583faA533
12105,15627912,200000,13657435212,198656,1344,266,40071,0x5a54fe5234E811466D5366846283323c954310B2,0x6eCe61d29b90642941C41240da924690da145696
12106,15627912,200000,13434089044,198656,1344,266,35385,0x5a54fe5234E811466D5366846283323c954310B2,0x1A8ed0D3Ad42c9019CC141aAce7e5Fb6E576B917
12107,15627912,154755,13000000000,153499,1256,330,400,0xA0c68C638235ee32657e8f720a23ceC1bFc77C77,0x4dCbB1fE5983ad5b44DC661273a4f11CA812f8B8
12108,15627912,50000,13041242891,50000,0,2,57819,0xead874c33388683049D9A7BFb34d254E1b7F3f6C,0xDF1553A2130cbAFA70a35e68eFC6cCF67F0A278C
12109,15627912,50000,13041242891,50000,0,2,57965,0x83438f80AF17F296d240f1941AC2A4e49Bd5aEE1,0xa9Bd318A4Ca1747E6068D100e18711B529386e29
12110,15627912,144000,13041242891,143392,608,138,17912,0xdAC17F958D2ee523a2206206994597C13D831ec7,0x7563758243A262E96880F178aeE7817DcF47Ab0f
12111,15627912,122577,13040242891,121013,1564,394,54,0x1Fa8559e873f698292766790AeCf8080A66433F6,0x0a0A4C7d49a370C3a2A2c0615362448d16897b1F
12112,15627912,122577,13040242891,121013,1564,394,52,0x1Fa8559e873f698292766790AeCf8080A66433F6,0x7E1869F1D3BE825aaE90c0dDbac386bEeFbB9f4D
12113,15627912,50000,13040242891,50000,0,2,170063,0xc762ac942218B97B969e9536B03507C553c0b53D,0x8D56f551b44a6dA6072a9608d63d664ce67681a5
12114,15627912,122577,13040242891,121013,1564,394,52,0x1Fa8559e873f698292766790AeCf8080A66433F6,0xc2D457F8773b1eE165D7900EDCf1Cb6eF0358628
12115,15627912,122577,13040242891,121013,1564,394,51,0x1Fa8559e873f698292766790AeCf8080A66433F6,0xFA364ceB10a8e2AE7D9781D18cE5262543242f53
12116,15627912,191674,13040242891,185070,6604,1810,125,0x00000000006c3852cbEf3e08E8dF289169EdE581,0x8b17E329f3319Ed862c89cE702953AABB1FD7BE2
12117,15627912,182982,13040242891,179378,3604,1162,1543,0x68b3465833fb72A70ecDF485E0e4C7bD8665Fc45,0x35286E024c086601Fa55A468b7F35A7b9436cee0
12118,15627912,140088,13040242891,138524,1564,394,23,0x1Fa8559e873f698292766790AeCf8080A66433F6,0x73d051afc8243feAF6d20eb29d0b6795eCB4a53E
12119,15627912,151746,13040242891,150194,1552,394,52,0x1Fa8559e873f698292766790AeCf8080A66433F6,0x1919086C1792bEFc2AAA6262262bb3B199a3f3C3
12120,15627912,151762,13040242891,150198,1564,394,41,0x1Fa8559e873f698292766790AeCf8080A66433F6,0x2C6e174ad2E0D6aBc68B8b7aCf79FdA955F71393
12121,15627912,270691,13040242891,266375,4316,1098,92,0xe66B31678d6C16E9ebf358268a790B763C133750,0x15C7FD66aA8EfEd0bA52a3d10306D018016693eD
12122,15627912,151762,13040242891,150198,1564,394,71,0x1Fa8559e873f698292766790AeCf8080A66433F6,0x3c3242d324A69C5d30aB85CB5534f3e9F210bDDf
12123,15627912,151762,13040242891,150198,1564,394,58,0x1Fa8559e873f698292766790AeCf8080A66433F6,0x50478fA10D475ECd19d157F263468746A894c5c6
12124,15627912,151762,13040242891,150198,1564,394,1127,0x1Fa8559e873f698292766790AeCf8080A66433F6,0x6861698B928562e396b9B6db2c0AbB17C4c729cd
12125,15627912,151746,13040242891,150194,1552,394,44,0x1Fa8559e873f698292766790AeCf8080A66433F6,0x4BF931C8eA3742f480047f559155152A35571300
12126,15627912,140088,13040242891,138524,1564,394,26,0x1Fa8559e873f698292766790AeCf8080A66433F6,0x838cDc9480e0c1cBA1B3a67cD8E887A1d917C4E9
12127,15627912,151746,13040242891,150194,1552,394,98,0x1Fa8559e873f698292766790AeCf8080A66433F6,0x20DAEda545d1Cc616d4a40179Fc7356914c5a114
12128,15627912,140088,13040242891,138524,1564,394,26,0x1Fa8559e873f698292766790AeCf8080A66433F6,0xedA6A7fe0C35988879323cd3797d86E72eedb1B8
12129,15627912,151762,13040242891,150198,1564,394,28,0x1Fa8559e873f698292766790AeCf8080A66433F6,0x0b69285aFab15B5cFa0394d659Edc37696ebaD39
12130,15627912,151762,13040242891,150198,1564,394,74,0x1Fa8559e873f698292766790AeCf8080A66433F6,0xb8454b20d5A72C573F0f5d650C5D8316386fA158
12131,15627912,140088,13040242891,138524,1564,394,22,0x1Fa8559e873f698292766790AeCf8080A66433F6,0x46343f18C44f897492B2ec8A05ecccFe1DC953E3
12132,15627912,140073,13040242891,138521,1552,394,25,0x1Fa8559e873f698292766790AeCf8080A66433F6,0x0dF21f5Dac50505E3dc2e3D09a5bAaB77521d818
12133,15627912,151762,13040242891,150198,1564,394,58,0x1Fa8559e873f698292766790AeCf8080A66433F6,0x8b94F76865A63131a605Df4d36082348a55E5eDE
12134,15627912,151762,13040242891,150198,1564,394,42,0x1Fa8559e873f698292766790AeCf8080A66433F6,0xFcBe5a2063c436aC1AB3AFF6928E84CB029E1e2c
12135,15627912,151762,13040242891,150198,1564,394,103,0x1Fa8559e873f698292766790AeCf8080A66433F6,0x58e86C575D3dAE9DCF7E460201F697ab7b57035a
12136,15627912,46563,13040242891,45619,944,138,153,0x4d224452801ACEd8B2F0aebE155379bb5D594381,0xf372F5B54d293990c639B531a16206246FC17680
12137,15627912,140088,13040242891,138524,1564,394,23,0x1Fa8559e873f698292766790AeCf8080A66433F6,0x6437dF61e275CccD5f34A2F0C66f70861AAe9b31
12138,15627912,326592,13040242891,320672,5920,1738,124,0x68b3465833fb72A70ecDF485E0e4C7bD8665Fc45,0x2A047a1B8704f5ac99A8f7025ace1c1a07e84097
12139,15627912,39617,13040242891,39353,264,74,2658,0xC02aaA39b223FE8D0A0e5C4F27eAD9083C756Cc2,0xD65919ef50cab25946d5b663211e9BeBcAA1de94
12140,15627912,151762,13040242891,150198,1564,394,752,0x1Fa8559e873f698292766790AeCf8080A66433F6,0x2E0dad2eB999e8eb7E024eFcE3C3ec7915bc3d99
12141,15627912,551559,13040242891,550951,608,138,151,0x467719aD09025FcC6cF6F8311755809d45a5E5f3,0x35F28F94a987C6c4027d3f5b34C340cd52B722b6
12142,15627912,151762,13040242891,150198,1564,394,61,0x1Fa8559e873f698292766790AeCf8080A66433F6,0x6d3915f1AF8965f5dD2cCbc2Bd8BEC4c272d4E2e
12143,15627912,151762,13040242891,150198,1564,394,31,0x1Fa8559e873f698292766790AeCf8080A66433F6,0xABEA64100E359DdE0b69E84DB9a641CD7ecF9829
12144,15627912,42000,13040242891,42000,0,2,329566,0x64d9Fe46e6B249Fe69Dc3cb93B91b4BB47b7391B,0x9430801EBAf509Ad49202aaBC5F5Bc6fd8A3dAf8
12145,15627912,140088,13040242891,138524,1564,394,24,0x1Fa8559e873f698292766790AeCf8080A66433F6,0x8A496eE28570eb1BA256216658B254Cb6760509a
12146,15627912,140088,13040242891,138524,1564,394,24,0x1Fa8559e873f698292766790AeCf8080A66433F6,0xeB99cd01bab31D066A0ABE9B03843ba7653ea750
12147,15627912,140088,13040242891,138524,1564,394,23,0x1Fa8559e873f698292766790AeCf8080A66433F6,0x0Ff06D03bcFa0Eda1eeA24e3446aE2074cBb0A41
12148,15627912,69844,13040242891,68900,944,138,4,0x4d224452801ACEd8B2F0aebE155379bb5D594381,0xd218F88353C5537Dbd83F06FE796BDa6b9f9271d
12149,15627912,233668,13040242891,229328,4340,1098,5,0xe66B31678d6C16E9ebf358268a790B763C133750,0xd218F88353C5537Dbd83F06FE796BDa6b9f9271d
12150,15627912,151762,13040242891,150198,1564,394,124,0x1Fa8559e873f698292766790AeCf8080A66433F6,0xD25aA0B57b314A5fEdFa115984851D44b284A219
12151,15627912,151762,13040242891,150198,1564,394,32,0x1Fa8559e873f698292766790AeCf8080A66433F6,0x1138230ec23059080C5231e460aa2ae2e196a789
12152,15627912,283978,13040242891,279226,4752,1484,88,0x881D40237659C251811CEC9c364ef91dC08D300C,0x99f5Fe71aBD1E3bDf00C5934689Fe50146471a14
12153,15627912,151762,13040242891,150198,1564,394,26,0x1Fa8559e873f698292766790AeCf8080A66433F6,0xeeB70cCa9dc02F81B7826eB044d342f3d26B85BC
12154,15627912,140088,13040242891,138524,1564,394,26,0x1Fa8559e873f698292766790AeCf8080A66433F6,0x564d0D06534BADeEcc75a3a4dC1ad10286172CB0
12155,15627912,151762,13040242891,150198,1564,394,40,0x1Fa8559e873f698292766790AeCf8080A66433F6,0x94e775930DfAe9eDdbf07729e90821B20F788b55
12156,15627912,39643,13040242891,39355,288,74,324,0xC02aaA39b223FE8D0A0e5C4F27eAD9083C756Cc2,0xc20b23462377bea7A7C1253057F8Ce1a74406Fcf
12157,15627912,151762,13040242891,150198,1564,394,33,0x1Fa8559e873f698292766790AeCf8080A66433F6,0xD57A19B96CCf06A891C5A12e4599746f882f46c9
12158,15627912,151762,13040242891,150198,1564,394,33,0x1Fa8559e873f698292766790AeCf8080A66433F6,0x6a18CF632e66471A0633bC335CA006aE4265A40E
12159,15627912,443340,13040242891,438776,4564,1162,18,0xe66B31678d6C16E9ebf358268a790B763C133750,0x28451a1Dbf3B94873A422d2E9df2E7A32440f74e
12160,15627912,151730,13040242891,150190,1540,394,30,0x1Fa8559e873f698292766790AeCf8080A66433F6,0xA669fD54561bd2e4250F2489d6034fd56069B03F
12161,15627912,264373,13040242891,259045,5328,1292,154,0x881D40237659C251811CEC9c364ef91dC08D300C,0xf372F5B54d293990c639B531a16206246FC17680
12162,15627912,151762,13040242891,150198,1564,394,26,0x1Fa8559e873f698292766790AeCf8080A66433F6,0x90B46e5249b615139240d17244600B7F8A08e00D
12163,15627912,151730,13040242891,150190,1540,394,29,0x1Fa8559e873f698292766790AeCf8080A66433F6,0x9b66d3a4CA24f7c7012f7E1a18eb5b4A6b005600
12164,15627912,151762,13040242891,150198,1564,394,31,0x1Fa8559e873f698292766790AeCf8080A66433F6,0xF2544649cf592EcE453B3BD836553D60C795eD25
12165,15627912,122577,13040242891,121013,1564,394,57,0x1Fa8559e873f698292766790AeCf8080A66433F6,0xeF38d4BF06335741D2b72dB42939D09EeE061084
12166,15627912,134575,12650242891,129523,5052,1106,395,0xDef1C0ded9bec7F1a1670819833240f027b25EfF,0xf0D55F2476bb2b7CE8e9b1F924444A364D6fb731
12167,15627912,250392,12568743902,247716,2676,842,379,0x68b3465833fb72A70ecDF485E0e4C7bD8665Fc45,0x85406E863296508c235E35a640F39433aEF4701a
12168,15627912,586906,12573734753,570942,15964,5074,195,0x1111111254fb6c44bAC0beD2854e76F90643097d,0xd8DbAFaB8Abce36b8CF987e1800FBdEB07145216
12169,15627912,21000,12540242891,21000,0,2,147,0x7A191b38D87DD2beCaa24d90Cd7731BA879E722a,0x5FfFA5881532AD2a1F0f0A676d51A846143166Dd
12170,15627912,324162,12540242891,322514,1648,394,6,0x7a250d5630B4cF539739dF2C5dAcb4c659F2488D,0x478AEC926aA00D69F004874f08558d1819c30848
12171,15627912,268248,12540242891,265476,2772,842,15,0x68b3465833fb72A70ecDF485E0e4C7bD8665Fc45,0xA80F8E57bdE76748D16562C1c2A5dd1958e42A43
12172,15627912,21000,12540242891,21000,0,2,282,0x7DFCa68fbF14c2ecCB85e5a30a5bFdb10D6402be,0x1931d6E43D9bD38d628a1c8E3aB8F38f33714D33
12173,15627912,165296,12540242891,162572,2724,842,4,0x68b3465833fb72A70ecDF485E0e4C7bD8665Fc45,0xbE56C177E41a2B8a37216b7816231b1C19B20594
12174,15627912,153948,12540242891,153280,668,138,385,0x70236b36f86AB4bd557Fe9934E1246537B472918,0x4493bB7375442430afCCD32733d24ac722595ae6
12175,15627912,181476,12540242891,179912,1564,394,234,0x1Fa8559e873f698292766790AeCf8080A66433F6,0x3887E4FD28A3ddDCFE650b1C023fB4939C609745
12176,15627912,535485,12540242891,531833,3652,1162,25,0x68b3465833fb72A70ecDF485E0e4C7bD8665Fc45,0xd89006a631e6bC9902770E31f8555e7Ed0321082
12177,15627912,21000,12540242891,21000,0,2,14,0x4aB4d3724b876B19934ced898b50Bc4D56e34F93,0x4E97EB67321453a288a2F9f614204f3c53828163
12178,15627912,46318,12540242891,45662,656,138,18,0x89DcFF5Fd892f2bfc8B75dBA12804B651f769579,0xDB2C0733e0A8d202BD1246e02047FC59665Dd8D2
12179,15627912,113000,12540242891,112568,432,74,197,0xC18360217D8F7Ab5e7c516566761Ea12Ce7F9D72,0xa5f146cBd3eE13F482315dD0F873c2bFbBc5F2C4
12180,15627912,78769,12540242891,78565,204,74,27,0xC5622f143972A5Da6aaBC5F5379311eE5EB48568,0x619f32C16797B4FC7ec6609A1de42BA7E77cd8E2
12181,15627912,81838,12540242891,81190,648,266,824,0x17D084106C2f1C716ce39fa015AB022757d30C9A,0xAC197A3Dad2742ea06384A4937C6Fc3d1264729F
12182,15627912,55930,12540242891,54986,944,138,193,0x430EF9263E76DAE63c84292C3409D61c598E9682,0xD12EC12A77D3f30844a58c2E992273B8152A2eD5
12183,15627912,181476,12540242891,179912,1564,394,931,0x1Fa8559e873f698292766790AeCf8080A66433F6,0xE64d73155F955e4E56061032f013B066C8C5B0eb
12184,15627912,117533,12540242891,117341,192,74,49,0xfc33E8b6E160A81DdB442B07355D01DF711EFEee,0x6080c1d8a16dc3affF4589e99F73fE20bd9fE19e
12185,15627912,21000,12540242891,21000,0,2,2242,0x03990c4c96d04a39c61265EAB182229a5A3aA4A9,0x2EcfB2F430cAcB4b8361e8F5a08e6c76E42410bE
12186,15627912,46157,12540242891,45669,488,138,271,0x69d4584080EdC5d058D5C51Ac61ec0c14E417E70,0x01a3Ee906f482b90287C8f38043a01d58374065d
12187,15627912,21000,12540242891,21000,0,2,1748,0x8E6E547Fe0784940EC1A3d47A0BcE4234e91faA7,0xa26E6AFd9a12290e282f4Ab7E0FaE93B29fC8466
12188,15627912,36015,12540242891,35751,264,74,263,0xC02aaA39b223FE8D0A0e5C4F27eAD9083C756Cc2,0xf7303F4944A25237cDB7D0efb306afB5649Fad97
12189,15627913,100000,34000000000,99356,644,138,151,0x74232704659ef37c08995e386A2E26cc27a8d7B1,0x9F1c02B9158e534f6D88b44b841594dfB96D4551
12190,15627913,21000,20000000000,21000,0,2,153,0xA882156F6647F3B88615Dc99321C50afD4B386AB,0xA882156F6647F3B88615Dc99321C50afD4B386AB
12191,15627913,66661,19201365374,66065,596,138,0,0xdAC17F958D2ee523a2206206994597C13D831ec7,0x1912d75eA78b2fbD44eAA552ADA91589683c737C
12192,15627913,181458,18634128753,179906,1552,394,320,0x1Fa8559e873f698292766790AeCf8080A66433F6,0xe400A865C7D966418a9012fca020739943EF955a
12193,15627913,350000,16295635634,350000,0,2,6925081,0x1fBA68f6A3d6b6061142102b6050beDA18b9889e,0x46340b20830761efd32832A74d7169B29FEB9758
12194,15627913,350000,16295635634,350000,0,2,6925082,0xBaD68A070EfEc26d0AF284a0f85A7920e520bae8,0x46340b20830761efd32832A74d7169B29FEB9758
12195,15627913,21000,14634128753,21000,0,2,3,0xE94aE6ca671410D64961290AafD56c189b7826CD,0x044D8B7E7d10C2E312A83C69039fec810C79a547
12196,15627913,181458,14000000000,179906,1552,394,77,0x1Fa8559e873f698292766790AeCf8080A66433F6,0xB17122a97db5cD586BED0A062cDdedDa73893454
12197,15627913,106000,13634128753,106000,0,2,484,0xCac0F1A06D3f02397Cfb6D7077321d73b504916e,0xe3691faBe650e4Ce0E2570BBd32ac1BAe8600E71
12198,15627913,151736,13634128753,150324,1412,522,61,0x08038283d6710bF62C8Ac76E53E6dA8E8dc4f787,0x1Dc0BA9941847A96F096d25018Df844176066FCA
12199,15627913,751291,13052000000,736435,14856,4682,2,0x3b3ae790Df4F312e745D270119c6052904FB6790,0xa444DA422D8382A19761Dc10b15A11EDc6D5cAF3
12200,15627913,50000,13000000000,50000,0,2,719002,0x46484Ad770a27b283267c26C573F63B6567AA2D8,0xA4e5961B58DBE487639929643dCB1Dc3848dAF5E
12201,15627913,62420,12634128753,61468,952,202,642,0x1Fa8559e873f698292766790AeCf8080A66433F6,0x98BDd55fd7B988630fF2bFFB059CF20682a5a612
12202,15627913,62420,12634128753,61468,952,202,224,0x1Fa8559e873f698292766790AeCf8080A66433F6,0x1eE9572Ac7d3ba68Fa98c2537BB099675Acc107c
12203,15627913,62420,12634128753,61468,952,202,257,0x1Fa8559e873f698292766790AeCf8080A66433F6,0x6A07A4A558AAB37bcf1eE7D8e9A3885018275a12
12204,15627913,62420,12634128753,61468,952,202,1199,0x1Fa8559e873f698292766790AeCf8080A66433F6,0xC9B44b591A92483445923F37E49C3c562316d2Cc
12205,15627913,264910,12634128753,260570,4340,1098,371,0xe66B31678d6C16E9ebf358268a790B763C133750,0x52eFd3617F86070C1B1f17ed7961AaF205Ad3363
12206,15627913,80000,12634128753,79356,644,138,568594,0x514910771AF9Ca656af840dff83E8264EcF986CA,0xB02f1329d6a6AcEF07a763258f8509c2847A0a3E
12207,15627913,140088,12634128753,138524,1564,394,27,0x1Fa8559e873f698292766790AeCf8080A66433F6,0x502CC731Fed4328b8D70789F61c1E20eCAa6dB9F
12208,15627913,140000,12634128753,138448,1552,394,1911,0x01cc1bD2dece86e54481f1e6aEffC2FCC6915480,0xb39a6B4cb933AAB3c30dA765aCF26c4C00a4bF11
12209,15627913,278230,12634128753,275422,2808,842,1776,0x68b3465833fb72A70ecDF485E0e4C7bD8665Fc45,0x9f4A83475ef57F70c1A7754c3B381479626900EA
12210,15627913,39617,12634128753,39353,264,74,1109,0xC02aaA39b223FE8D0A0e5C4F27eAD9083C756Cc2,0x0b4534c69A278beaEC2CA225aE7F57a89B5DAf9D
12211,15627913,140000,12634128753,138448,1552,394,392,0x01cc1bD2dece86e54481f1e6aEffC2FCC6915480,0xF3397eC2321Fe1394ef2f4b13f5600a44E577BfB
12212,15627913,181476,12634128753,179912,1564,394,2943,0x1Fa8559e873f698292766790AeCf8080A66433F6,0x730Aba725664974eFB753ee72cA789541C733Db4
12213,15627913,140000,12634128753,138448,1552,394,323,0x01cc1bD2dece86e54481f1e6aEffC2FCC6915480,0x339F90A9af1354E128D7aE72f403bc2D9e4e58b2
12214,15627913,46529,12634128753,45585,944,138,7,0x2b591e99afE9f32eAA6214f7B7629768c40Eeb39,0x4d6DCBEA6bDE4C7D80392a68E093a1EF949764d6
12215,15627913,207128,12634128753,207128,0,2,1312164,0x5Ed339baBa6D4E3c7e341882B1C4B98B858090bB,0xf60c2Ea62EDBfE808163751DD0d8693DCb30019c
12216,15627913,46135,12314581625,45647,488,138,941,0x1Fa8559e873f698292766790AeCf8080A66433F6,0x35f82c76Bf78a17d5a844e116e0BEAbd7928A1B2
12217,15627913,600000,12262872106,598728,1272,458,59279,0xE544cF993C7d477C7ef8E91D28aCA250D135aa03,0x69f36eA1ebf4Ec9E53e3aaBF11CAF62b034ff3eE
12218,15627913,46135,12134128753,45647,488,138,212,0x1Fa8559e873f698292766790AeCf8080A66433F6,0xb17d16E71AbE10b644b339086d34aF6C8E8B2D77
12219,15627913,110945,12134128753,110225,720,266,596,0x283Af0B28c62C092C9727F1Ee09c02CA627EB7F5,0x761989CF4dB9d6a878F924c91B53a68e647f28fC
12220,15627913,255525,12134128753,251885,3640,1162,14,0x68b3465833fb72A70ecDF485E0e4C7bD8665Fc45,0xE50D14dAeA61F04432dea298a27232675F75A559
12221,15627913,401944,12134128753,398340,3604,1162,26,0x68b3465833fb72A70ecDF485E0e4C7bD8665Fc45,0x2FB99a34466DF30DecEF41E214700cf80022d072
12222,15627913,21000,12134128753,21000,0,2,0,0x9F109A85eC8f181F7a0471833050D63489c93A47,0xecA855f31A52250c546aA473eDF4b6D4a26e3E7d
12223,15627913,77292,12134128753,76636,656,138,368,0xDEf1CA1fb7FBcDC777520aa7f396b4E015F497aB,0x180C60E5937916C6bcA43a1E404D27559deBc87C
12224,15627913,236403,12134128753,232847,3556,1162,15,0x68b3465833fb72A70ecDF485E0e4C7bD8665Fc45,0xbB5c7A3d87C7623A02b3850aDc7aCa7CA541DA6b
12225,15627913,21000,12134128753,21000,0,2,330,0xbc36a29070806a9401B28Cb7FdF47170577272B9,0x9e743c7eCA2561EE3272cabeD03e9A76b8dF1d30
12226,15627913,289318,12134128753,286946,2372,522,216,0x283Af0B28c62C092C9727F1Ee09c02CA627EB7F5,0x1f854Ee78e4d4f5AACeC5004CBaDE1b0525321Ab
12227,15627913,125066,12134128753,124802,264,74,21,0x8Bc3702c35D33E5DF7cb0F06cb72a0c34Ae0C56F,0x2D8084c08F9Ec0995B20fbC3c32864dE691cd987
12228,15627913,167167,12134128753,166879,288,74,207,0x886a12483Babc4d0A8c422Dd4Ad2E50Eac1108db,0xDFbA83A810B3fCf66ece51EE5b0fD6998D0e8890
12229,15627913,70510,12134128753,70306,204,74,7,0xd5dF338F6C32476ef2A3FB341416ddA981c0F310,0x279802D50543Dd6C15a419aC7d2431C5423b8E59
12230,15627913,21000,12134128753,21000,0,2,6,0xc339C1B4AD0260EcBCa9c2928311675CA6de4bEa,0x984dCEfDB02A9300b5718faF85C005abf8627609
12231,15627913,357867,12134128753,355119,2748,842,1140,0x68b3465833fb72A70ecDF485E0e4C7bD8665Fc45,0x6d01af8711133DEE2B2edfC54DC6Ce38223f8396
12232,15627913,104601,12134128753,104397,204,74,959,0x55f1C36Bb7aE0d7D6caE97902E30A2306686Ec73,0xF717996A21C84a0Acaf56C5CAf5B745BCF07eE12
12233,15627913,122414,12134128753,121574,840,266,286,0x65c25FADd9b88df5c8C101A3b99a5D614B708596,0x921Fc6CF9334a6248D6B9F460AA32C5914778f82
12234,15627913,51406,12134128753,50918,488,138,78,0xF2a9904458d938be0a5B9410cE32af1b3eE00cEa,0x791B61E3198bcFBf83530073F89B896DA85C56CA
12235,15627913,92151,12134128753,92087,64,10,4,0x4Dbd4fc535Ac27206064B68FfCf827b0A60BAB3f,0x3f71d43f3E5999D7691472231b7ada3Ca186793c
12236,15627913,21000,12134128753,21000,0,2,5,0x3541AC3dde1858E74b275E0574604a30420D6785,0x54F6BB473c888620C97aCabA7A88c507C73E7d71
12237,15627913,182918,12134128753,176126,6792,1802,2,0x00000000006c3852cbEf3e08E8dF289169EdE581,0xd8f5f16DB9e4CE0565B35cAe3b8015723d650956
12238,15627913,21000,12134128753,21000,0,2,2,0xc445B4268D41293F986De7d276186e2d3AFBA543,0x63992eD3EC17B0ecce95a127312C9DE1511bCf22
12239,15627913,46231,12134128753,45743,488,138,124,0x61CEcE14E222385D5aC83f3d0cbd518f5fEB3559,0x35C6b2101a0fF4EAE5266b2EeF44e82286B1F06e
12240,15627913,46167,12134128753,45595,572,138,2025,0x79471Bb4CbB351a17Fa1EadB5B77AA76795c423a,0xb5309b284C23667c5Bd765f7d45Abb977621e61E
12241,15627913,92241,12134128753,92037,204,74,13,0x55f1C36Bb7aE0d7D6caE97902E30A2306686Ec73,0xccac5Ac4cB067e7e8c9b98ed64136e5A3892168C
12242,15627913,21000,12134128753,21000,0,2,525,0xd75d6ed8B21C2e9D58cf2a41746806e83f93Ff3a,0x55C9B965F09D51A73B23A55CfCC595a95c41965C
12243,15627913,21000,12134128753,21000,0,2,127,0x537f917CaDA5449C9f04171bCFCC8fCe06A8F780,0x9C4C8539FbDc0A1ab8d461E192d20c554fEb9B99
12244,15627913,200000,12134128753,198224,1776,458,113,0x765711A274E6022adCd148032042b84eF63AA2eF,0xF2F0b060795C7377DD542DF84AdBe1cFd94e0B33
12245,15627913,46109,12134128753,45501,608,138,8,0xdAC17F958D2ee523a2206206994597C13D831ec7,0xa1f0F2D744C1E4447618394B519C1E03F6AFA799
12246,15627913,46267,12134128753,45691,576,74,460,0x283Af0B28c62C092C9727F1Ee09c02CA627EB7F5,0x03d276d40979a7DBcdE3af4Df3543d253c11771B
12247,15627913,278230,12134128753,275422,2808,842,213,0x68b3465833fb72A70ecDF485E0e4C7bD8665Fc45,0x25991B064289F1341b0eEDCF536f3688100c3790
12248,15627913,28930,12134128753,28370,560,138,493,0x1cEB5cB57C4D4E2b2433641b95Dd330A33185A44,0x2EceCf5a33d038694133BbF3A22AEAFBc96d4B04
12249,15627913,211331,12134128753,204715,6616,1810,90,0x00000000006c3852cbEf3e08E8dF289169EdE581,0x7a48bF4Ac1AB4D793eA297335CC561D80443EaE3
12250,15627913,21000,12134128753,21000,0,2,76,0x8b9b5023F8eC36B1Da19bab47D955296cB87AFdA,0x12B738fF0d026F86c598DB83FDe216A52Df943fD
12251,15627913,217814,12134128753,214994,2820,842,4031,0x68b3465833fb72A70ecDF485E0e4C7bD8665Fc45,0x1541681a72632143E412e918dA772DEaDF6DbC76
12252,15627913,235947,12134128753,232807,3140,906,1,0x68b3465833fb72A70ecDF485E0e4C7bD8665Fc45,0x3c7F1E7D67f67a50A5D29899A7A5f486A30522b1
12253,15627913,181476,12134128753,179912,1564,394,1569,0x1Fa8559e873f698292766790AeCf8080A66433F6,0xc623483a440A6Fb5C0D41f8E30a9F3dF49a237Ad
12254,15627913,94795,12134128753,94199,596,138,8,0xdAC17F958D2ee523a2206206994597C13D831ec7,0x4cb64d2c07140CDa9f108daC119D8195a105C3D6
12255,15627913,181476,12134128753,179912,1564,394,91,0x1Fa8559e873f698292766790AeCf8080A66433F6,0xFC8D17422ed18afBC0aB246B94177117F98bDe78
12256,15627913,21000,12134128753,21000,0,2,15,0x36FaA6Cf486Ba9139ae22C36A7F37476aCfBb670,0xd28Ff6DD7d851371162489EC9B031B8DC0949F74
12257,15627913,181476,12134128753,179912,1564,394,49,0x1Fa8559e873f698292766790AeCf8080A66433F6,0xAAa39785EB1a2C3a6C7c95465aB367B84F78cb90
12258,15627913,184122,12134128753,177534,6588,1802,251,0x00000000006c3852cbEf3e08E8dF289169EdE581,0x68A1212E4FD8185800E3E5AEC2C5194Dd702631C
12259,15627913,181476,12000000000,179912,1564,394,1489,0x1Fa8559e873f698292766790AeCf8080A66433F6,0xe9c287150Bf3dcD724f1716951A052A1FdDF4240
12260,15627913,260846,11846329753,260846,0,2,96400,0xBbAD96336943A36E3e292D973B3382dd0bA4D1EF,0xBbAD96336943A36E3e292D973B3382dd0bA4D1EF
12261,15627913,62274,11800000000,61606,668,138,0,0x95aD61b0a150d79219dCF64E1E6Cc01f0B64C4cE,0x7488294c29cc0317be745cbA82E226fdaAa28fA2
12262,15627913,121018,11634128753,120446,572,138,47,0x1748B24faf9780B74E5A9f3Feb41553E712E94aa,0x6819eA7792CC89394fEEE84FC70d54a67cD0B765
12263,15627913,181476,11634128753,179912,1564,394,92,0x1Fa8559e873f698292766790AeCf8080A66433F6,0x9345ac21f12041fcE6F5Bc09cd9ce69E9f16BEcB
12264,15627913,181476,11634128753,179912,1564,394,588,0x1Fa8559e873f698292766790AeCf8080A66433F6,0x4c714A71b3b9FFfc1E6a9206AB692e4bc9FF7370
12265,15627913,181476,11634128753,179912,1564,394,446,0x1Fa8559e873f698292766790AeCf8080A66433F6,0x125C1823024bEfcCf795ad14D7D68b47B2970f80
12266,15627913,181476,11634128753,179912,1564,394,6,0x1Fa8559e873f698292766790AeCf8080A66433F6,0x15108e47452cE2122d8a895cD5783cc125E7934A
12267,15627913,260875,11634128753,256935,3940,1162,6045,0xD7c09E006A2891880331b0F6224071C1e890A98A,0x6898B6ca04BEc2AFD7881Da4CE915D24c9d1f7B4
12268,15627913,408140,11634128753,406444,1696,292,26588,0xC8046263d5B5544F6413a98B4693488499195A46,0xEf5a3745F822f8F83693564c54904d7FF156CFb2
12269,15627913,256092,11634128753,252284,3808,970,116845,0xa57Bd00134B2850B2a1c55860c9e9ea100fDd6CF,0x6046945C5B5eF5933b8E73a98A6AD7bF3e031df7
12270,15627913,332352,11634128753,327236,5116,1018,105727,0x0000000000007F150Bd6f54c40A34d7C3d5e9f56,0x60530f5Ca4CB9907e0FBE67cA3AFCbFE56D19A5c
12271,15627913,181476,11634128753,179912,1564,394,84,0x1Fa8559e873f698292766790AeCf8080A66433F6,0x988b97d30E7fdD5f67E07571676785b8bc41fD06
12272,15627913,181458,11634128753,179906,1552,394,57,0x1Fa8559e873f698292766790AeCf8080A66433F6,0xd95Ea698741E3a70d53536D748f1c105c8e52A1F
12273,15627913,239010,11634128753,236954,2056,466,30,0x1111111254fb6c44bAC0beD2854e76F90643097d,0xA4C143Ee11fC66C066BAB823c8972978785E7388
12274,15627913,126531,11634128753,126327,204,74,675,0x9b9D659D4f2cF68b6616Cc0a65683f1951Eb725C,0xb498cb5B46Fa217e8A6e8d8054c40b86EC595F42
12275,15627913,181476,11634128753,179912,1564,394,751,0x1Fa8559e873f698292766790AeCf8080A66433F6,0x5ff85db363945E021a96dc4396795E91576b732F
12276,15627913,122428,11634128753,120876,1552,394,249,0x1Fa8559e873f698292766790AeCf8080A66433F6,0xeC4A2742BBCfBA37234d91cF15224dc5e0dA1A9E
12277,15627913,181476,11634128753,179912,1564,394,204,0x1Fa8559e873f698292766790AeCf8080A66433F6,0x7288b58E07BdbA35eF611C5F9d8714e05A384b9f
12278,15627913,181476,11634128753,179912,1564,394,511,0x1Fa8559e873f698292766790AeCf8080A66433F6,0xCD217698A51dD25cA3926cBD7cd209FbB20B87Bf
12279,15627913,181476,11634128753,179912,1564,394,423,0x1Fa8559e873f698292766790AeCf8080A66433F6,0xcf4C74527F26dEE24CF9cFee6FAC9549136CE05A
12280,15627913,59056,11634128753,58092,964,394,2363,0x645E9324f4be25be581BB62163cfa86c40b01D07,0xc5009AFEd2D6DA219538aD165998F63B553185B1
12281,15627913,181476,11634128753,179912,1564,394,503,0x1Fa8559e873f698292766790AeCf8080A66433F6,0x87631B45877794f9cdd50a70c827403e3C36d072
12282,15627913,275023,11634128753,273687,1336,394,899,0x283Af0B28c62C092C9727F1Ee09c02CA627EB7F5,0x42E2f1c250d46e3d13102a2e1da6298bB8116F87
12283,15627913,181476,11634128753,179912,1564,394,2063,0x1Fa8559e873f698292766790AeCf8080A66433F6,0x62B4bCaFe045048916632a35A5DF563790eEBf81
12284,15627913,181476,11634128753,179912,1564,394,387,0x1Fa8559e873f698292766790AeCf8080A66433F6,0x66F0f6CEb06C4E90cC1796C8054f1B5F0aD541Da
12285,15627913,181476,11634128753,179912,1564,394,723,0x1Fa8559e873f698292766790AeCf8080A66433F6,0xa1cCa97078763789d6cBd296f82C53bF1Ee2858A
12286,15627913,150756,11634128753,150692,64,10,15,0x65c2e54a4c75ff6da7b6B32369c1677250075fb2,0x6C3D43694Aa77aF7cF5A28289a7ffFF39DFFE06C
12287,15627913,181476,11634128753,179912,1564,394,661,0x1Fa8559e873f698292766790AeCf8080A66433F6,0x61AD48A12f7d677725D1b78e1B133FC2b7a786F8
12288,15627913,181458,11627835264,179906,1552,394,7,0x1Fa8559e873f698292766790AeCf8080A66433F6,0x666A7A6fC7205f30E327294a1c7eE5658e7700db
12289,15627913,351022,11444231254,350378,644,138,2,0x7Fc66500c84A76Ad7e9c93437bFc5Ac33E2DDaE9,0xF912b912a932a776b16A40FFD6199d0227EE0613
12290,15627913,203559,11444231254,201883,1676,402,29,0x1111111254fb6c44bAC0beD2854e76F90643097d,0xB164FbA6B8570cAb99e065aE8AcA949c3B346DA5
12291,15627913,191041,11000000000,190165,876,266,1405,0xd588b586D61C826A0e87919b3D1a239206d58bf2,0xC22d03e13B888Dabb33A1575e4F6542f0e996622
12292,15627913,120000,10940827125,119320,680,138,515,0x95aD61b0a150d79219dCF64E1E6Cc01f0B64C4cE,0xF2067aBFaB8BC621211935431519d41825d2f344
12293,15627913,325044,10870050578,160536,164508,20774,183258,0x5E4e65926BA27467555EB562121fac00D24E9dD2,0x6887246668a3b87F54DeB3b94Ba47a6f63F32985
12294,15627913,72787,10863757089,72215,572,138,0,0xdAC17F958D2ee523a2206206994597C13D831ec7,0x79A3fa90208Fd404116f471Ec3c9A3548C630B60
12295,15627913,21000,10863757089,21000,0,2,4,0xB811d6bc94741F68C5cEFD80dA4F1461dD17f9e8,0x1813C0D2e035B868BBEF9AACE15ef740110995F4
12296,15627913,181476,10863757089,179912,1564,394,18,0x1Fa8559e873f698292766790AeCf8080A66433F6,0x7bFdABea32100ff443Fa3CCE7eb88735D26d7Fe3
12297,15627913,21000,10863757089,21000,0,2,5,0xd952bEECffC6Bc1228E83d0457d25D5a39555abf,0xA23b27d1585d76f3138Abc34234f9162f82241a1
12298,15627913,225863,10863757089,223791,2072,522,48,0xEfF92A263d31888d860bD50809A8D171709b7b1c,0xc18C24d43ee5cE1064941A563E096B7e882c0a7f
12299,15627913,21000,10863757089,21000,0,2,47,0xEA36f975A4e3b4E76A7B48fB8669d0De1497b078,0x843b8bA3Ad6E61E983702C22D1FD7fD80900236F
12300,15627914,100000,50000000000,99404,596,138,0,0xdAC17F958D2ee523a2206206994597C13D831ec7,0x16c9dd1EDD52630e79156239a1a2D4F6fa590EA0
12301,15627914,100000,34000000000,99320,680,138,121,0x12BB890508c125661E03b09EC06E404bc9289040,0xF9E2eC68f4781B0Db11745dFb1499ffc9A8cBaed
12302,15627914,239395,31298029227,236575,2820,842,442,0x68b3465833fb72A70ecDF485E0e4C7bD8665Fc45,0xd978284426E4b8F7A36724527CDdced79f373E7d
12303,15627914,85035,18540242891,84379,656,138,2188252,0x22987407FD1fC5A971e3FDA3B3e74C88666cDa91,0x75e89d5979E4f6Fba9F97c104c2F0AFB3F1dcB88
12304,15627914,94831,18540242891,94223,608,138,2188253,0xdAC17F958D2ee523a2206206994597C13D831ec7,0x75e89d5979E4f6Fba9F97c104c2F0AFB3F1dcB88
12305,15627914,85053,18540242891,84385,668,138,2188254,0x22987407FD1fC5A971e3FDA3B3e74C88666cDa91,0x75e89d5979E4f6Fba9F97c104c2F0AFB3F1dcB88
12306,15627914,21000,17046108073,21000,0,2,3,0x7B8F872a7C0819e73B716622B045FFC697E58700,0x813B5209155625D0628Bf7A8Eb33F0FAeD594c5C
12307,15627914,175110,16298029227,173546,1564,394,22,0x1Fa8559e873f698292766790AeCf8080A66433F6,0xA07Ae7B1f8A8B5ABA4A13A096C73127d3987CDE0
12308,15627914,175110,16298029227,173546,1564,394,55,0x1Fa8559e873f698292766790AeCf8080A66433F6,0xf187D6c732C88158fA5bec0DF4d006B7284403fd
12309,15627914,21000,16000000000,21000,0,2,2327,0x7Df83B2Ce8F85BFb1b72aC94C2e5DF03C64e2A8A,0xce0df2BA6c2BD425F3Ffbbea708F0B5f21ae1e6a
12310,15627914,191925,15000000000,191237,688,202,13,0x084b1c3C81545d370f3634392De611CaaBFf8148,0x03cc71FBe5E1620f5a3D9aC2135642260ADC82bb
12311,15627914,175110,15000000000,173546,1564,394,3242,0x1Fa8559e873f698292766790AeCf8080A66433F6,0x9Cd9aefBd6D423F69F5c9Caf2fA9972381012b09
12312,15627914,181476,14298029227,179912,1564,394,7,0x1Fa8559e873f698292766790AeCf8080A66433F6,0x5cc8E247536d19Cd4fa8245eb84ce8677bB20c2E
12313,15627914,300014,14298029227,298806,1208,330,224463,0x98C3d3183C4b8A650614ad179A1a98be0a8d6B8E,0x91aaE0aAfd9D2d730111b395c6871f248d7Bd728
12314,15627914,21000,14210000000,21000,0,2,705895,0x61004D57c0a11849DedCf38d0D63145a7CB83E08,0x6dfc34609a05bC22319fA4Cce1d1E2929548c0D7
12315,15627914,100000,14300000000,99024,976,202,705896,0xdAC17F958D2ee523a2206206994597C13D831ec7,0x6dfc34609a05bC22319fA4Cce1d1E2929548c0D7
12316,15627914,100000,14300000000,99024,976,202,705897,0xdAC17F958D2ee523a2206206994597C13D831ec7,0x6dfc34609a05bC22319fA4Cce1d1E2929548c0D7
12317,15627914,21000,14205090061,21000,0,2,0,0xcDd37Ada79F589c15bD4f8fD2083dc88E34A2af2,0x2eC466A49B91FC0C8024c608Aaf2D20cae263676
12318,15627914,21000,14205090061,21000,0,2,155629,0xaCf2c35138C5Ce325CBf6ce24e0D839D6EBc47Ba,0xcDd37Ada79F589c15bD4f8fD2083dc88E34A2af2
12319,15627914,95611,14198397367,94955,656,138,4709950,0x68eb95Dc9934E19B86687A10DF8e364423240E94,0x2FAF487A4414Fe77e2327F0bf4AE2a264a776AD2
12320,15627914,97381,14198397367,96785,596,138,4709951,0xA0b86991c6218b36c1d19D4a2e9Eb0cE3606eB48,0x2FAF487A4414Fe77e2327F0bf4AE2a264a776AD2
12321,15627914,93836,14198397367,93240,596,138,4709952,0xdAC17F958D2ee523a2206206994597C13D831ec7,0x2FAF487A4414Fe77e2327F0bf4AE2a264a776AD2
12322,15627914,21000,14058393970,21000,0,2,10,0xE54b870bc0f2b944e2C1156f9AA826bF3C3556EC,0x86fcAf22786EdCc5cE9e89e6D64826919675be95
12323,15627914,21000,14058393970,21000,0,2,2,0x603d4bd58a38DF95e212a63ADD7B5f28880Cbbbb,0x1aFF1623cc2830aA600E35C2DcA5887394104142
12324,15627914,222222,14000000000,220670,1552,394,219,0x1Fa8559e873f698292766790AeCf8080A66433F6,0x009F40fE9cfb8b954F643238c095FB91b49aAade
12325,15627914,66175,13800000000,65555,620,138,1486,0xA0b86991c6218b36c1d19D4a2e9Eb0cE3606eB48,0x214763e383d7D78cD0B76Aee0dEfc8867F511697
12326,15627914,21000,13700000000,21000,0,2,0,0x6dfc34609a05bC22319fA4Cce1d1E2929548c0D7,0xD78e725b6F250FA93dDD25bb89c1fc6738cBbA25
12327,15627914,21000,13700000000,21000,0,2,0,0x6dfc34609a05bC22319fA4Cce1d1E2929548c0D7,0x5d48f6FCf3f368A9EB53956cb779320bFe83cDc8
12328,15627914,135994,13398029227,135790,204,74,129,0x5DAC20CEabd1cfC989Ab4C48AF95e563631556c9,0xB18A5eD2219A5F748A5Dacc1039C9D493D9e9775
12329,15627914,175110,13298029227,173546,1564,394,508,0x1Fa8559e873f698292766790AeCf8080A66433F6,0x62Ef8b356751612Ad33863c454825BF94998AF2E
12330,15627914,187456,13000000000,184648,2808,842,11,0x68b3465833fb72A70ecDF485E0e4C7bD8665Fc45,0x0516E71c2171535aC86eaC2D6B0fFd94aC2fA8bd
12331,15627914,21000,13000000000,21000,0,2,17,0x6E7913b6Da970C82A94B03b5003f12A7a92172B7,0x129e2265417d88b74C2C7d5A619d9d61448cA510
12332,15627914,135994,12798029227,135790,204,74,191,0x5DAC20CEabd1cfC989Ab4C48AF95e563631556c9,0x893DC5564fb60913Ef9660C276b629a0Ba545e68
12333,15627914,305899,12798029227,298923,6976,970,101,0x9b3B6974531d8AA15A87908FFd821A64863Ede5B,0xe07E7dA4227Ebf6f2bfAB62A3263F54dBD49dB4A
12334,15627914,507633,12698029227,505537,2096,522,260,0x7a250d5630B4cF539739dF2C5dAcb4c659F2488D,0xe6D3D38195499D1932d05a3121F5b1Be96AB1eBE
12335,15627914,135994,12408029227,135790,204,74,134,0x5DAC20CEabd1cfC989Ab4C48AF95e563631556c9,0x22a4508173212257F6085a2204dcF82598D04151
12336,15627914,135994,12408029227,135790,204,74,269,0x5DAC20CEabd1cfC989Ab4C48AF95e563631556c9,0x081c6dB67889a9CdEbE82069f812fe75964D3D12
12337,15627914,500000,12398029227,498000,2000,522,293,0x7a250d5630B4cF539739dF2C5dAcb4c659F2488D,0xA4F52138B57D3F3225D917dEF563300e35e81198
12338,15627914,233473,12348029227,229797,3676,1162,577,0x68b3465833fb72A70ecDF485E0e4C7bD8665Fc45,0x27fd27bb75B09b7173ca742A18fAeC13f1174D73
12339,15627914,21000,12299029227,21000,0,2,36162,0x0A3409035949C6D10DF0a644DC80A4432AEB6F05,0xDB044B8298E04D442FdBE5ce01B8cc8F77130e33
12340,15627914,21000,12299029227,21000,0,2,251066,0x82c10d08c5407cCDb29Ba2cA6fDbF5661AA5eEd3,0x8216874887415e2650D12D53Ff53516F04a74FD7
12341,15627914,122428,12298029227,120876,1552,394,909,0x1Fa8559e873f698292766790AeCf8080A66433F6,0x632DF214F78c98D6D627C60CcfcbA83Bc10029C1
12342,15627914,140000,12298029227,138448,1552,394,381,0x01cc1bD2dece86e54481f1e6aEffC2FCC6915480,0x347Ffc543566C4F079D918D290E90E8708B75C29
12343,15627914,242851,12298029227,239735,3116,906,68,0x68b3465833fb72A70ecDF485E0e4C7bD8665Fc45,0x1C95D028093B47754Ac1c0D4A9DCCEe8d556209c
12344,15627914,42000,12298029227,42000,0,2,329567,0x79f5Ab69b744ECe3Cdfd32db7BA53cb49e51b3E1,0x9430801EBAf509Ad49202aaBC5F5Bc6fd8A3dAf8
12345,15627914,207128,12298029227,206520,608,138,4468975,0xdAC17F958D2ee523a2206206994597C13D831ec7,0x21a31Ee1afC51d94C2eFcCAa2092aD1028285549
12346,15627914,207128,12298029227,207128,0,2,4708720,0xf5a370D4dCA539F700Ac56623Af7faCebf97d333,0x28C6c06298d514Db089934071355E5743bf21d60
12347,15627914,207128,12298029227,206484,644,138,4232353,0x0F5D2fB29fb7d3CFeE444a200298f468908cC942,0xDFd5293D8e347dFe59E90eFd55b2956a1343963d
12348,15627914,207128,12298029227,206520,608,138,3492295,0xdAC17F958D2ee523a2206206994597C13D831ec7,0x56Eddb7aa87536c09CCc2793473599fD21A8b17F
12349,15627914,207128,12298029227,207128,0,2,1679541,0xccD649893016C2880b50E7c72E9E2dD6Bc08e725,0x4976A4A02f38326660D17bf34b431dC6e2eb2327
12350,15627914,207128,12298029227,206520,608,138,3199191,0xdAC17F958D2ee523a2206206994597C13D831ec7,0x9696f59E4d72E237BE84fFD425DCaD154Bf96976
12351,15627914,207128,12298029227,207128,0,2,4468976,0x004F1e106dBA9D82C97C5D4A0d7Aff86BFA30Ac0,0x21a31Ee1afC51d94C2eFcCAa2092aD1028285549
12352,15627914,55950,12298029227,55006,944,138,955,0x6097004C68F7B350d72226003226Ac089597D579,0x28f4De1417252Ed727b228A94A8Cc5eB1652ad22
12353,15627914,207128,12298029227,207128,0,2,3492296,0xA68a4E821fDD1f871E176Df1c2a1D48bE623F7ff,0x56Eddb7aa87536c09CCc2793473599fD21A8b17F
12354,15627914,207128,12298029227,206520,608,138,4232354,0xdAC17F958D2ee523a2206206994597C13D831ec7,0xDFd5293D8e347dFe59E90eFd55b2956a1343963d
12355,15627914,207128,12298029227,207128,0,2,4232355,0x2c96B410574aE6A78083a33D193747d145BAA860,0xDFd5293D8e347dFe59E90eFd55b2956a1343963d
12356,15627914,313680,12298029227,300932,12748,4042,1237,0x11c91606fC27a55c6f0e8F847D2aC46Ec45b6E21,0x50aB2fA4341d85D37CB30b8f30E2B4aa7294EcC1
12357,15627914,207128,12298029227,206472,656,138,4232356,0x514910771AF9Ca656af840dff83E8264EcF986CA,0xDFd5293D8e347dFe59E90eFd55b2956a1343963d
12358,15627914,21000,12298029227,21000,0,2,88946,0xda04C3386Ab0666e3eD1538A8c0f619487f5F36C,0x3018018c44338B9728d02be12d632C6691E020d1
12359,15627914,140088,12298029227,138524,1564,394,24,0x1Fa8559e873f698292766790AeCf8080A66433F6,0xF8E72A25cDF813AD95df1e45c54aA595f0b26497
12360,15627914,140073,12298029227,138521,1552,394,27,0x1Fa8559e873f698292766790AeCf8080A66433F6,0x0047437e075ba3029dDAf8B5c089C8891b620946
12361,15627914,70182,12298029227,68878,1304,330,2076,0x4DC793e7D76BFc69B9AA93225E6aDA24A53D305F,0x681854a7C1d759AD8C23d1e8aAc92D5129dDE290
12362,15627914,181476,12298029227,179912,1564,394,294,0x1Fa8559e873f698292766790AeCf8080A66433F6,0x7F312CbF084229166d246d512CB36eDC4902953F
12363,15627914,251847,12298029227,249063,2784,842,124,0x68b3465833fb72A70ecDF485E0e4C7bD8665Fc45,0x2294CfFB1DfBa6C40b1c26AAFdb80Ceb781D04f7
12364,15627914,90000,12298029227,89392,608,138,4,0xdAC17F958D2ee523a2206206994597C13D831ec7,0xf2D226F8a35f67F0e494AC5f3517a1CdA86fC393
12365,15627914,73146,12298029227,72202,944,138,6,0x7D1AfA7B718fb893dB30A3aBc0Cfc608AaCfeBB0,0xd075155b1dA63ff3809FbE4BAa3f705C95c3991e
12366,15627914,140073,12298029227,138521,1552,394,26,0x1Fa8559e873f698292766790AeCf8080A66433F6,0x5Ad93F57005F044b46755946d049456974cb7d41
12367,15627914,262441,12298029227,257625,4816,1420,8,0x881D40237659C251811CEC9c364ef91dC08D300C,0x4d6DCBEA6bDE4C7D80392a68E093a1EF949764d6
12368,15627914,140088,12298029227,138524,1564,394,26,0x1Fa8559e873f698292766790AeCf8080A66433F6,0x6336Ee896f04a61D8Cd290476d48304Cb7F30675
12369,15627914,140088,12298029227,138524,1564,394,24,0x1Fa8559e873f698292766790AeCf8080A66433F6,0x2027C3172eAE871a30d385Aa62Db8Ea9B27e610F
12370,15627914,140088,12298029227,138524,1564,394,24,0x1Fa8559e873f698292766790AeCf8080A66433F6,0x1C734755CD2af9b49AcD6cf656C5a12EB10c7BB3
12371,15627914,140088,12298029227,138524,1564,394,24,0x1Fa8559e873f698292766790AeCf8080A66433F6,0xceB8a24F824c3Aa5ECAc530D98aF88e9ca46D148
12372,15627914,140088,12298029227,138524,1564,394,23,0x1Fa8559e873f698292766790AeCf8080A66433F6,0x9C7e6D22F2EfEea0c659A431861082F20a2a5f2E
12373,15627914,218750,12298029227,214538,4212,1418,7,0xc30141B657f4216252dc59Af2e7CdB9D8792e1B0,0xd075155b1dA63ff3809FbE4BAa3f705C95c3991e
12374,15627914,77745,12298029227,77089,656,138,4627,0x6B175474E89094C44Da98b954EedeAC495271d0F,0xE0B2026E3DB1606ef0Beb764cCdf7b3CEE30Db4A
12375,15627914,181476,12298029227,179912,1564,394,184,0x1Fa8559e873f698292766790AeCf8080A66433F6,0x2F98DaD29bdAbCB3AF039C7038A44F81b8Ec4b27
12376,15627914,159239,12298029227,152587,6652,1810,344,0x00000000006c3852cbEf3e08E8dF289169EdE581,0x5D79E00b20C96574e3C6d3f54DD15d61221eCBcB
12377,15627914,249131,12298029227,243491,5640,1676,20,0x881D40237659C251811CEC9c364ef91dC08D300C,0xd5ABb7f978ABB356E75A6d5266a8DB45677b378B
12378,15627914,21000,12298029227,21000,0,2,5,0x8D9458f516aFC753Ce3466090c77e27972896C59,0xeC869174D22e857CA94d699F3DF042AAdd1EeB07
12379,15627914,196360,12298029227,191236,5124,1418,922,0x68b3465833fb72A70ecDF485E0e4C7bD8665Fc45,0x5C7ca6A93a46aE786D99D91ED423A91d6fa13879
12380,15627914,21000,12298029227,21000,0,2,72350,0x113478641A02913Cf123bfF4f9C99Df6CEA4d267,0xab97925eB84fe0260779F58B7cb08d77dcB1ee2B
12381,15627914,21000,12298029227,21000,0,2,72351,0xB55982bEa848240314C8F2968b32FF3BF21aBb57,0xab97925eB84fe0260779F58B7cb08d77dcB1ee2B
12382,15627914,99226,12298029227,98630,596,138,11,0xA0b86991c6218b36c1d19D4a2e9Eb0cE3606eB48,0x7a44Bd8189FE02DdE5dDeB64BB50F8A13AE16715
12383,15627914,181476,12298029227,179912,1564,394,32,0x1Fa8559e873f698292766790AeCf8080A66433F6,0xBD75f3591275420e573934B065C635286CB37f8e
12384,15627914,92151,12298029227,92087,64,10,132,0x4Dbd4fc535Ac27206064B68FfCf827b0A60BAB3f,0xe8787b5a359c30318D9b805651D18275f33Fa1Bd
12385,15627914,251862,12298029227,249066,2796,842,902,0x68b3465833fb72A70ecDF485E0e4C7bD8665Fc45,0x1aa4bf5728Cd3a415D9aEcea807C1292d1C96f1C
12386,15627914,181476,12298029227,179912,1564,394,894,0x1Fa8559e873f698292766790AeCf8080A66433F6,0xee9a78d0DaE4b87ED4cF7Bb48b0D777763422cF6
12387,15627914,140088,12298029227,138524,1564,394,24,0x1Fa8559e873f698292766790AeCf8080A66433F6,0x678f95463d1DaDFE312BB6e4C8CF473472DFfF3f
12388,15627914,140088,12298029227,138524,1564,394,98,0x1Fa8559e873f698292766790AeCf8080A66433F6,0xa7DD88AE885868B2EEd39516D54f2741A84539FF
12389,15627914,140088,12298029227,138524,1564,394,24,0x1Fa8559e873f698292766790AeCf8080A66433F6,0xE1e0F6e883C5bB03C290597E812DEd72933c3563
12390,15627914,21000,12298029227,21000,0,2,4,0x8C1fdCC0D51ba6f51F811322fFb06B89aE71B87c,0x38dB2E88637D1A12DeB4494A1218bEd10B65b05E
12391,15627914,122564,12298029227,121012,1552,394,62,0x1Fa8559e873f698292766790AeCf8080A66433F6,0xF69e2D06B345B44A31096B9CA5510bD3373A4117
12392,15627914,54058,12298029227,53770,288,74,97,0xC02aaA39b223FE8D0A0e5C4F27eAD9083C756Cc2,0xE195D3Bd491696f574Ff4578eBD2Bbb98cf568BB
12393,15627914,85000,12298029227,84512,488,138,28,0xD27dcbcC8778a8AB33AAc529Df36a634567Be325,0x56A1D3CEA1e205b02F2c2CE8a57fCc1d90CB325e
12394,15627914,85000,12298029227,84512,488,138,34,0xD27dcbcC8778a8AB33AAc529Df36a634567Be325,0x4B2BBb0d175FfA7E33DF06Ff346F7f398128C6d6
12395,15627914,181476,12298029227,179912,1564,394,75,0x1Fa8559e873f698292766790AeCf8080A66433F6,0xce0257f48f3190363C0E9CD845AE7659Cc639f81
12396,15627914,122577,12298029227,121013,1564,394,63,0x1Fa8559e873f698292766790AeCf8080A66433F6,0x2D884611E2732c19A8ce38C1dEC91bd74C459BD3
12397,15627914,2000000,12053753702,1997940,2060,522,405,0x7a250d5630B4cF539739dF2C5dAcb4c659F2488D,0xC1604496e206B7ff546c602Fdd5Ab69cF15f3DA7
12398,15627914,181476,12000000000,179912,1564,394,261,0x1Fa8559e873f698292766790AeCf8080A66433F6,0x1efC335A0C0548A1fC531A571f4DE83D3A4e6ed1
12399,15627914,95551,12000000000,94599,952,202,11,0x590e4Dc50A3E76668D33620235A88dC3bEA7C8D1,0x3819b31151335a3dBcc9db79F6CeB511e5Af310D
12400,15627914,21000,11920000000,21000,0,2,46,0x8924da29eEAAaeF281454d588D9E570eF090F3A0,0x559722C975eB56cfa633AA021C61e7dF82CE177B
12401,15627914,132505,11798029227,125921,6584,1698,1328,0x00000000006c3852cbEf3e08E8dF289169EdE581,0x291362F270Db9bBFFF75ed70DfB07e54332810F0
12402,15627914,45399,11798029227,44447,952,202,405,0xC86664e7d2608f881f796ee8E24FA9d4d7598406,0x7D3E5dD617EAF4A3d42EA550C41097086605c4aF
12403,15627914,55897,11798029227,54953,944,138,225,0xFDBf91A7F2d757A9815326af5E1e60319571984c,0xceB7Bc1098138e850195698F4Ff2726031CDe545
12404,15627914,502806,11798029227,499846,2960,906,313,0x000000000000509081d6FCD3ee63e791aD1db763,0x8F1ce698746D93B06152066ED8DBE359245AbA65
12405,15627914,21000,11798029227,21000,0,2,213,0xf2E9db3c5D06015833Df31eD3C37172a2B34EE7F,0x53AA4b81B3F5028658161c4522b9DFFdA83e821c
12406,15627914,69145,11798029227,68549,596,138,14,0xdAC17F958D2ee523a2206206994597C13D831ec7,0x668265bfCaC477eb6c9caaE54ADa1675FcD70241
12407,15627914,189626,11798029227,181570,8056,1930,28,0x48c41D9e896846a68A6adA56a09c5bD5A4eC8Ee4,0x923871564569cB9D53b521f6fF2C7B7747e39A3a
12408,15627914,288820,11798029227,286472,2348,522,1565,0x283Af0B28c62C092C9727F1Ee09c02CA627EB7F5,0xD59d1EF7Dfd0D9C41DA1B12209722b5a0712Dd32
12409,15627914,21000,11798029227,21000,0,2,12,0x8DECF20376497a5d79f5783550Be4AB142b12C65,0x6eF314FE7C08Cb78D58Df1995dE6CdF2060435F9
12410,15627914,254277,11798029227,251037,3240,1034,157,0x68b3465833fb72A70ecDF485E0e4C7bD8665Fc45,0x1e09556B986e0771133466b224370903051F24d7
12411,15627914,55897,11798029227,54953,944,138,98,0xFDBf91A7F2d757A9815326af5E1e60319571984c,0x728441FE041422D6Ce3b2094C25FD3B00D190bcF
12412,15627914,21000,11798029227,21000,0,2,420,0xa6e9AFcb696fd1Ad4878384a2059dc290DEa2C98,0xD12EF7C6A70659BB97f5669cafe22a1eF575112A
12413,15627914,21000,11798029227,21000,0,2,2415,0xaabCEe8F090038AE706f5e466EBEca9d5c3046eB,0xfCF5B7d05bae6a12b02Dfb297EF8EB97EDDC8f52
12414,15627914,46135,11798029227,45647,488,138,287,0x1Fa8559e873f698292766790AeCf8080A66433F6,0x407060a47fB14bA0ABd40A657Ab9260588619489
12415,15627914,21000,11798029227,21000,0,2,1,0xe97d5419C74DB944B9307393dbC535372ae99026,0x007a298e8053c862Bd4b069DF148946b5314475A
12416,15627914,46135,11798029227,45647,488,138,104,0x1Fa8559e873f698292766790AeCf8080A66433F6,0x57DB78397F509F0F6597Cd3274669BB4Fc779ae0
12417,15627914,149645,11798029227,143045,6600,1802,31,0x00000000006c3852cbEf3e08E8dF289169EdE581,0x19443b60F0047551b16491a65e0A01486a2Cd9a0
12418,15627914,46663,11798029227,46175,488,138,578,0xE11AfbB703dC6c8c717ccEBA526d9568015e43D9,0x16be9CC6C13641Fdfe66868b3743E133A218E8A6
12419,15627914,175110,11798029227,173546,1564,394,185,0x1Fa8559e873f698292766790AeCf8080A66433F6,0x9eFFAC6BbEb661B3a964256999a128F4e43EEF1d
12420,15627914,21000,11798029227,21000,0,2,20,0x42274080309a6Ea30E1f5E9A0D9DA706ea00CcCA,0xAc68f409F57AE85eFf4224e2108aec464D4654e3
12421,15627914,238934,11798029227,236162,2772,842,462,0x68b3465833fb72A70ecDF485E0e4C7bD8665Fc45,0x87eaA58fEF2C5180e48152E1E469E90bFb3e7b9C
12422,15627914,126022,11798029227,125818,204,74,193,0x7246489fbd8B07Ec2394d8667c0137e962e5D6E9,0x18717190340A530A4b74BfA823CdC70fDC7d813B
12423,15627914,21000,11798029227,21000,0,2,3,0x5c50CfEF14e54Eb72804097641E9C5Ed7FebD12B,0x00938717e06AE4441647D270D939afDBD4D5d319
12424,15627914,277337,11798029227,257837,19500,4682,300,0x00000000006c3852cbEf3e08E8dF289169EdE581,0xe5ae2923a8E55421AcfD1e19679B2104540D2Eb7
12425,15627914,53025,11798029227,52537,488,138,4,0x7239F01C663f3c9fD7A44cB2BC8d19B67bdD1336,0xF8457CfB862D095e579D4cC0FF073697f9983e8d
12426,15627914,405756,11798029227,402400,3356,1098,251,0xC36442b4a4522E871399CD717aBDD847Ab11FE88,0x18C6a9cbF2F4a54a2C6B6eF2116392c7F9989Ed6
12427,15627914,247201,11798029227,243997,3204,1034,398,0x68b3465833fb72A70ecDF485E0e4C7bD8665Fc45,0xF6B91068C3d52A956ae682a250d89Ba2AC02D06c
12428,15627914,56322,11798029227,54974,1348,394,431,0xe4605d46Fd0B3f8329d936a8b258D69276cBa264,0x216A023E0c19382D895a66A76dd92E898c9BE3a7
12429,15627914,131198,11798029227,125114,6084,1682,25,0x00000000006c3852cbEf3e08E8dF289169EdE581,0x17D8Db5920a271125632dfF1Ca7e792365826789
12430,15627914,21000,11798029227,21000,0,2,2,0xc445B4268D41293F986De7d276186e2d3AFBA543,0xCB679ea467d8E1c237E72eCDaF2184222E44b60F
12431,15627914,97294,11798029227,82690,14604,4874,67,0x00000000006c3852cbEf3e08E8dF289169EdE581,0x12C0290a35FC87d0435FB782bdEF6a9B5881aA8f
12432,15627914,376089,11798029227,370585,5504,1482,335,0x68b3465833fb72A70ecDF485E0e4C7bD8665Fc45,0xa825aC21a697F26281177ca5cc7Bd4aEDD71A2E5
12433,15627914,56706,11798029227,55762,944,138,345,0x4850ea923E38d0427f3cA4bD543cB35dEb96f47e,0x40cA6bDc1b3Eb4AD28224Ca4B3811989d7eFbdB9
12434,15627914,127890,11798029227,127262,628,202,28,0x084b1c3C81545d370f3634392De611CaaBFf8148,0x375613Dd7A028aFb7D865FF5f015b5A62474171b
12435,15627914,269673,11798029227,250185,19488,4682,295,0x00000000006c3852cbEf3e08E8dF289169EdE581,0xA346C2615F70607F1973Caf6d45A26aF51089fe6
12436,15627914,936615,11798029227,852799,83816,25314,695,0x9EbFB53Fa8526906738856848A27cB11b0285C3f,0xdBfd836c989E1FE9586cB0D1BFB35E7849Be23a5
12437,15627914,21000,11798029227,21000,0,2,11,0xa8BF05B33c1d02C7CAA3061aC0D9CcC32eDcE883,0x84E210b896B982A6C6cCD6775F3F3328b8178AeE
12438,15627914,69163,11798029227,68555,608,138,263,0xdAC17F958D2ee523a2206206994597C13D831ec7,0x2d7F24188DF916c4793eeCd5FBA94B9870A325dc
12439,15627914,46859,11798029227,46371,488,138,26,0x197492CCB4B1acaAAcd43432657A17832E36AB49,0xd4f5c694b1d232AFB8642cC96386514a41741c58
12440,15627914,21000,11798029227,21000,0,2,211,0x5BBcc32EFB778a98Fc5d7657bf196749C1326aEF,0x3193db2D06Ef42Ed7f517dAAC491bac9Ecd0E7c8
12441,15627914,35819,11798029227,35755,64,10,134,0x241f1D6c3D0E5A95713E552BE4f103E638D9951c,0xC0723DcFBF60002b3B5b55Fca06F0414263ff111
12442,15627914,46267,11798029227,45691,576,74,40,0x283Af0B28c62C092C9727F1Ee09c02CA627EB7F5,0x8d1644c1fA4EbfF287946293612bF7bD1E5DD5e8
12443,15627914,289519,11798029227,281471,8048,1482,2314,0x21953192664867e19F85E96E1D1Dd79dc31cCcdB,0x68b53Aa18D1b8437B7CD9524040C776E2261e06d
12444,15627914,58676,11798029227,57732,944,138,3,0xdAC17F958D2ee523a2206206994597C13D831ec7,0x1E8502a21FAEaED3586767BDb831374Dd779dd6c
12445,15627914,55953,11798029227,55009,944,138,1566,0xb9f79C35C37695ec45851Cd6E29da8C1d0396c11,0xaD14c24E1C816Fbc6F6A36C4d3F2790312893817
12446,15627914,56714,11798029227,55770,944,138,30,0x2A4e05277e89DB1f0c589E8E8f49f20BD059EA02,0x4846826F8e260Ac8a13B6eeab5B6977D93074F65
12447,15627914,98786,11798029227,98582,204,74,215,0xbC0B652e9B165bA91476eC03437F1806804dc1B4,0xB00A93fF31217E49c3674e05b525f239a85bb78f
12448,15627914,21000,11798029227,21000,0,2,850,0x4c6A766e27726f084c41e2bA98d6dF8E78f8e6e1,0x4c6A766e27726f084c41e2bA98d6dF8E78f8e6e1
12449,15627914,175110,13298029227,173546,1564,394,851,0x1Fa8559e873f698292766790AeCf8080A66433F6,0x4c6A766e27726f084c41e2bA98d6dF8E78f8e6e1
12450,15627914,94813,11798029227,94205,608,138,5,0xdAC17F958D2ee523a2206206994597C13D831ec7,0xe13b81486f24B701c80DEd06927aBAc23aa34914
12451,15627914,21000,11798029227,21000,0,2,69,0x092a5217e51dF08fd5d6B7Cf8aa422d125200f71,0x1b4089a5DdBDBE1D958A22ee25C0c213DCc0e30A
12452,15627914,467304,11798029227,464176,3128,714,31,0xC36442b4a4522E871399CD717aBDD847Ab11FE88,0xc01f46f418B9D9BACDCaf9453E8F0f1ca818C925
12453,15627914,111243,11798029227,110511,732,266,12,0x283Af0B28c62C092C9727F1Ee09c02CA627EB7F5,0x81932Fbbb63c11Cfa2Acc33b227BB184578F20EC
12454,15627914,233360,11798029227,230564,2796,842,316,0x68b3465833fb72A70ecDF485E0e4C7bD8665Fc45,0xd873d47495e2c9f8b17580Cc322FA4A8057cAFae
12455,15627914,21000,11798029227,21000,0,2,105,0x1128473cfba4EAA11B4eB69418350a049e926225,0xf6e9b43969f52021bC920c635df3933bC01aB52c
12456,15627914,21000,11798029227,21000,0,2,256,0x01FaA4a40BAeA58c5Ebe62D54BaF08adb079472b,0x6f58b9fac2E7847e43f61Ab50bb3C1dDaa84D249
12457,15627914,872692,11798029227,867080,5612,1482,377,0x5DBC7B840baa9daBcBe9D2492E45D7244B54A2A0,0x16335De1D7a10bc485EEDBC5f820BaB7793CA398
12458,15627914,21000,11798029227,21000,0,2,494,0x51d5C4fF3D901c55F254fA0F3c29Be1afFba469d,0x05bF72a25e8A11895648f78c093cf2F38C2FEaE4
12459,15627914,527516,11798029227,525216,2300,390,26589,0xC8046263d5B5544F6413a98B4693488499195A46,0xEf5a3745F822f8F83693564c54904d7FF156CFb2
12460,15627914,21000,11798029227,21000,0,2,420,0x884857D786dAbBC9377b4ad35A4426F8B7a5E0b0,0x370318A773705B314D68f4d82cf4cc12D07B5E9e
12461,15627914,172782,11798029227,170698,2084,522,69,0xd9e1cE17f2641f24aE83637ab66a2cca9C378B9F,0x4fC70107D2B3eDD22c6dF9067D711a93ad4C3b77
12462,15627914,46187,11798029227,45615,572,138,2485,0x34Bc797F40Df0445c8429d485232874B15561728,0xba3c1983Fcb330D156Db75a14A14eb447CdDc7b2
12463,15627914,21000,11798029227,21000,0,2,199,0x7EFb82f18df863d518053396C49FE4bfF1B49Fa7,0xFCfe8671aE3f98280ebAFFbF96D7198C7db5DDc9
12464,15627914,55897,11477638352,54953,944,138,133,0xFDBf91A7F2d757A9815326af5E1e60319571984c,0xC730d85a7CeB1a1a865D4f6235078e4Be3EcaCc8
12465,15627914,168949,11477638352,167785,1164,338,143,0x1111111254fb6c44bAC0beD2854e76F90643097d,0x0B86b1bccBb0222c8d877EfAD8fB06c4116AFA08
12466,15627914,584563,11477638352,579859,4704,1418,4,0xa2398842F37465f89540430bDC00219fA9E4D28a,0xf8bb90EBF6CFb5D162777AEd13Cb7fd34B5881B6
12467,15627914,267682,11399029227,265426,2256,650,106640,0xA69babEF1cA67A37Ffaf7a485DfFF3382056e78C,0x9AAb3F81604c683a1a0D14019FBfe15bef7aA1ee
12468,15627914,21000,11364072049,21000,0,2,92743,0x105d453d30EC79F9A9E38a35aAf4746DdED6e0D9,0xF1300cc9c2Cf347f7902742fEC4dF9dbA952fD7b
12469,15627914,46745,11364072049,46745,0,2,150329,0x65A27dF4d063511680e39b51501D49687DCeFaC8,0x1C727a55eA3c11B0ab7D3a361Fe0F3C47cE6de5d
12470,15627914,181476,11364072049,179912,1564,394,135,0x1Fa8559e873f698292766790AeCf8080A66433F6,0x81a7c58111Ce03b605C91499211d57fCff7d3eD7
12471,15627914,21000,11298029227,21000,0,2,7100808,0x28f29912aeE5746725db40BF75A737893B3c1f72,0xddfAbCdc4D8FfC6d5beaf154f18B778f892A0740
12472,15627914,2000000,11298029227,1982804,17196,3914,171062,0xA9D1e08C7793af67e9d92fe308d5697FB81d3E43,0x7830c87C02e56AFf27FA8Ab1241711331FA86F43
12473,15627914,21000,11298029227,21000,0,2,469175,0x28BC9EcD0844Dd785c8D7FCC05D882Dd1122f72C,0xb739D0895772DBB71A89A3754A160269068f0D45
12474,15627914,2000000,11298029227,1989400,10600,2314,171063,0xA9D1e08C7793af67e9d92fe308d5697FB81d3E43,0x7830c87C02e56AFf27FA8Ab1241711331FA86F43
12475,15627914,21000,11298029227,21000,0,2,1228782,0x37405653ed712Ed94bE6d95a4A5Dd78DdDf167df,0x71660c4005BA85c37ccec55d0C4493E66Fe775d3
12476,15627914,175110,11298029227,173546,1564,394,158,0x1Fa8559e873f698292766790AeCf8080A66433F6,0xb851e1782b1c2cC6d26918942f5D2068BFcf9421
12477,15627914,181476,11298029227,179912,1564,394,1701,0x1Fa8559e873f698292766790AeCf8080A66433F6,0x6a29cAFc9dAE22b131d619716FfA1Ef6fd4bEc8F
12478,15627914,21000,11298029227,21000,0,2,96,0x8937Bc2F3Fa9b6941986Bf46e3613E3DF6F2547e,0x072B6AaC774fFe93371f8085D4a082EA8d92db3B
12479,15627914,181476,11298029227,179912,1564,394,592,0x1Fa8559e873f698292766790AeCf8080A66433F6,0x717bDf2A899e3e823d2120aE5A438e6563B007aD
12480,15627914,43192,11298029227,41464,1728,458,90,0x4976fb03C32e5B8cfe2b6cCB31c09Ba78EBaBa41,0x02fFC99ED8867340e2755D6ABd7f9F8FDc95c93B
12481,15627914,181476,11298029227,179912,1564,394,29,0x1Fa8559e873f698292766790AeCf8080A66433F6,0x59611D6792E7765bEaEaf3383C59fc445955F274
12482,15627914,159984,11298029227,157200,2784,842,121,0x68b3465833fb72A70ecDF485E0e4C7bD8665Fc45,0x7b719f9518F4DDCd341D28838a06A78395A7d5fC
12483,15627914,493491,11298029227,490351,3140,906,351,0x68b3465833fb72A70ecDF485E0e4C7bD8665Fc45,0xAF4572dBDacdAB64c30a3bE96214103e32eFdb0E
12484,15627914,175074,11298029227,173534,1540,394,412,0x1Fa8559e873f698292766790AeCf8080A66433F6,0x7AD6E6750a2Eb8e8d92E201f010526C3a62dffD5
12485,15627914,181476,11298029227,179912,1564,394,39,0x1Fa8559e873f698292766790AeCf8080A66433F6,0x1711D08DAc1BC9C01706Ac709f348c52DE7C9001
12486,15627914,181476,11298029227,179912,1564,394,201,0x1Fa8559e873f698292766790AeCf8080A66433F6,0x9Bf3a8d0d52cA1370a567dA1c47938De75604BBF
12487,15627914,181476,11298029227,179912,1564,394,67,0x1Fa8559e873f698292766790AeCf8080A66433F6,0xF5A875C445eb9c9Ff578326F6460E56508c7C83A
12488,15627914,181476,11298029227,179912,1564,394,744,0x1Fa8559e873f698292766790AeCf8080A66433F6,0x911133ed843DF23f9B8E5aB51933AA6248f27427
12489,15627914,181476,11298029227,179912,1564,394,821,0x1Fa8559e873f698292766790AeCf8080A66433F6,0x2abb5520B6b565503F76bD399Dba4c7B5179Ad5C
12490,15627914,175110,11298029227,173546,1564,394,1109,0x1Fa8559e873f698292766790AeCf8080A66433F6,0xC1923cAe3b5ff75c87A1CEfA8E80e2985E1232A8
12491,15627914,181476,11298029227,179912,1564,394,174,0x1Fa8559e873f698292766790AeCf8080A66433F6,0xd12d14bA65a9748D90Addc6630a6b46ed0197F5C
12492,15627914,55950,11298029227,55006,944,138,432,0x6097004C68F7B350d72226003226Ac089597D579,0x974Ac046dEB027e5939Cf48A087561A99d7Ad477
12493,15627914,181476,11298029227,179912,1564,394,143,0x1Fa8559e873f698292766790AeCf8080A66433F6,0xC9e924Fa44Bb12411881a6deF9fdB2f946ec9dDe
12494,15627914,256092,11298029227,252284,3808,970,91231,0xa57Bd00134B2850B2a1c55860c9e9ea100fDd6CF,0x4603180BBB8221157880AfaA84638E0fc467738D
12495,15627914,250000,11298029227,250000,0,2,45337169,0xA6eD7FAC6EDEe02Ef96770274570bcc6809D4516,0xEA674fdDe714fd979de3EdF0F56AA9716B898ec8
12496,15627914,181476,11298029227,179912,1564,394,738,0x1Fa8559e873f698292766790AeCf8080A66433F6,0xbcEa4F042Aa0F9964ec9fc1e7F808bCaA24db7C5
12497,15627914,175110,11298029227,173546,1564,394,450,0x1Fa8559e873f698292766790AeCf8080A66433F6,0x3CebE91f2440220E1DF82c25a3468389D0f0e9cC
12498,15627914,191140,11298029227,187888,3252,1034,1,0x68b3465833fb72A70ecDF485E0e4C7bD8665Fc45,0x9497F7B6942ad122c525D81047ee443cF55644E2
12499,15627914,181458,11298029227,179906,1552,394,28,0x1Fa8559e873f698292766790AeCf8080A66433F6,0x3AdE18A5119A4689881379FD31Fce01685b74EE8
12500,15627914,175110,11298029227,173546,1564,394,952,0x1Fa8559e873f698292766790AeCf8080A66433F6,0x34B717A47e02a0BA6D2AcF9E885b6673d0F2B3cC
12501,15627914,69400,11298029227,68824,576,74,108,0x283Af0B28c62C092C9727F1Ee09c02CA627EB7F5,0xc40456ee3Ce933b81D9be4D68d964Eeb1F684298
12502,15627914,133730,11298029227,128838,4892,1290,0,0x20F780A973856B93f63670377900C1d2a50a77c4,0x068A6304F670e1D01Df4285F009a56F56B26ECce
12503,15627914,181476,11298029227,179912,1564,394,90,0x1Fa8559e873f698292766790AeCf8080A66433F6,0xa065641e108451b9e9D258Bf29CB6f744f0aAFe3
12504,15627914,181476,11298029227,179912,1564,394,32,0x1Fa8559e873f698292766790AeCf8080A66433F6,0x1777Ac86301432f744FaA00F3267a6EAf821A327
12505,15627914,255492,11298029227,226712,28780,9610,8,0x00000000006c3852cbEf3e08E8dF289169EdE581,0xC4785bC20907175590196C8Ff233059E2b1cF93C
12506,15627914,175110,11298029227,173546,1564,394,3473,0x1Fa8559e873f698292766790AeCf8080A66433F6,0xEF39362f69f041F3057A02F4bBe673C6F59c0d40
12507,15627914,181476,11298029227,179912,1564,394,665,0x1Fa8559e873f698292766790AeCf8080A66433F6,0xFDFab2778B5576b693C5F71Ea069515BBBd164f0
12508,15627914,319320,11298029227,317412,1908,458,20,0x7a250d5630B4cF539739dF2C5dAcb4c659F2488D,0x0cB5B5C356FcE965b26683E0B3854a6f098108aC
12509,15627914,181476,11298029227,179912,1564,394,101,0x1Fa8559e873f698292766790AeCf8080A66433F6,0x133941087F02f74f6a3946B5C1Bf220d7a2a2D91
12510,15627914,121018,11298029227,120446,572,138,48,0x1748B24faf9780B74E5A9f3Feb41553E712E94aa,0x6819eA7792CC89394fEEE84FC70d54a67cD0B765
12511,15627914,181476,11298029227,179912,1564,394,41,0x1Fa8559e873f698292766790AeCf8080A66433F6,0x71cA775d142B25aC248530b056B310DB150da4da
12512,15627914,181476,11298029227,179912,1564,394,68,0x1Fa8559e873f698292766790AeCf8080A66433F6,0x055B27da717e632b9074BfB1cD556c6d3057BE8b
12513,15627914,69318,11195074204,68746,572,138,230,0xF26c762a9Fb1757050871DbDbd4fD6062eabFF5d,0xC4B0dc090E87345151D1E486B5b8eb49aE4fFF2F
12514,15627914,326245,11195074204,322989,3256,778,545,0x6fBF1b6A681307f86c2d212f0f6Ad72621309eF1,0xE2B18fF370BF86CB4A7fF7ce2B93DcE225A5a951
12515,15627914,21000,11176773037,21000,0,2,76,0x1243D01e42eEF90C72d88e665647dd50b0f49f6D,0x37Bf54A1bAA1C555B1F89c12A66EA25f898CC8aC
12516,15627914,247107,11108131728,243879,3228,1034,1526,0x68b3465833fb72A70ecDF485E0e4C7bD8665Fc45,0xBb860FEe33B6B3a2b15E469ADB8Fd5Be240A6012
12517,15627914,157974,11108131728,155178,2796,842,6,0x68b3465833fb72A70ecDF485E0e4C7bD8665Fc45,0xB024281dEEf2F08347AacF1cAbeB59bD10669a2d
12518,15627914,21000,11000000000,21000,0,2,5,0xe2bD46c85f053a28403EacAbf1db2c8d24860492,0xDeDDaC87b8C702742b92dc716d6BD7c2F15F114B
12519,15627914,250000,10500000000,249344,656,138,4084,0x0D8775F648430679A709E98d2b0Cb6250d2887EF,0x90f86774e792e91cf81B2Ff9F341EfcA649343A6
12520,15627914,80000,10354372045,79056,944,138,0,0xdAC17F958D2ee523a2206206994597C13D831ec7,0x14D6253C96181a37Dd682772316e77b220696701
12521,15627914,550698,10354372045,545422,5276,1674,5,0xf18aCC02628009231d7BAAF9a7a24C0860Dda6cb,0x08FAB9B2d5d34bEA9f50F20dE8b7D3085d9E0282
12522,15627914,351400,10354372045,349876,1524,458,3479124,0x5f65f7b609678448494De4C87521CdF6cEf1e932,0xd24400ae8BfEBb18cA49Be86258a3C749cf46853
12523,15627914,75753,10354372045,71601,4152,842,3788,0x00000000219ab540356cBB839Cbe05303d7705Fa,0x5180db0237291A6449DdA9ed33aD90a38787621c
12524,15627914,80235,10863757089,76071,4164,842,3789,0x00000000219ab540356cBB839Cbe05303d7705Fa,0x5180db0237291A6449DdA9ed33aD90a38787621c
12525,15627914,80235,10863757089,76071,4164,842,3790,0x00000000219ab540356cBB839Cbe05303d7705Fa,0x5180db0237291A6449DdA9ed33aD90a38787621c
12526,15627914,75771,10863757089,71607,4164,842,3791,0x00000000219ab540356cBB839Cbe05303d7705Fa,0x5180db0237291A6449DdA9ed33aD90a38787621c
12527,15627914,317793,10354372045,309933,7860,2378,7,0xc8d7899F22bc4995C8176e3f2a5Ba3F5e87D95E5,0x1B9Cc2c8987F0a721544864fCa75e9E1B080eC2d
12528,15627915,188863,11086201165,188219,644,90,103258,0x01FF6318440f7D5553a82294D78262D5f5084EFF,0x5AA17fC7F2950ECa85376C3A8CB1509e8e4B39dF
12529,15627915,319338,12086201165,317418,1920,458,33,0x7a250d5630B4cF539739dF2C5dAcb4c659F2488D,0x8617d3B9f2C24a109BF18831fE358038AaB7034F
12530,15627915,188055,526318684657,187079,976,130,103259,0x01FF6318440f7D5553a82294D78262D5f5084EFF,0x5AA17fC7F2950ECa85376C3A8CB1509e8e4B39dF
12531,15627915,224890,66395625643,223374,1516,220,5562,0xb9aa14b6774dbc9F84B15e7fF659c0dbA0D9ddF5,0xc4c162e5E2475675cf07f4c851659d0f4266c224
12532,15627915,271365,50000000000,259849,11516,3594,87,0x74312363e45DCaBA76c59ec49a7Aa8A65a67EeD3,0x94d90F31002F3857E59c8Ec2dBf9f0B8C098f251
12533,15627915,467472,42086201165,465520,1952,522,17,0x7a250d5630B4cF539739dF2C5dAcb4c659F2488D,0x76B7e3b26DcEc9c447193bE3073a260a4A9e2B7B
12534,15627915,467472,42086201165,465520,1952,522,20,0x7a250d5630B4cF539739dF2C5dAcb4c659F2488D,0x5074a22a19A9D35C4310851E5ea7a6A0F3fC5317
12535,15627915,181476,42086201165,179912,1564,394,162,0x1Fa8559e873f698292766790AeCf8080A66433F6,0xA6bfc0be1761f1978eD34c5B833C6652E04FDD40
12536,15627915,122446,37086201165,120882,1564,394,370,0x1Fa8559e873f698292766790AeCf8080A66433F6,0x790781E8985d51c60Aa141743B5E8080D22B4dC8
12537,15627915,546727,26668930677,539303,7424,1524,83035,0x0000000000007F150Bd6f54c40A34d7C3d5e9f56,0x0336E78E4D09b8A6A84D34d0fD103452dE57A7A3
12538,15627915,850000,25643546239,848116,1884,458,104,0x7a250d5630B4cF539739dF2C5dAcb4c659F2488D,0x18de54c850C959eDa854017De199e27c437635DF
12539,15627915,850000,25643546239,848116,1884,458,879,0x7a250d5630B4cF539739dF2C5dAcb4c659F2488D,0xdea76156e7ADC43a942931a90d55a573583a760d
12540,15627915,150306,25486931002,149442,864,134,13642,0x5C57Ac8dC5D8589DAB9d422993ED3DE8CC244151,0x4D521577f820525964C392352bB220482F1Aa63b
12541,15627915,239070,11086201165,236898,2172,650,100941,0xA69babEF1cA67A37Ffaf7a485DfFF3382056e78C,0x431B5A84aCC1297Eda88259f300262F1bc3A74f3
12542,15627915,445954,25217698129,440774,5180,840,16448,0xED77777586D73C58EB4D6BEBDF9c85C2d5F56C2d,0x5f0df4aE784dB40B2D5460Aa4415A662527e43Cf
12543,15627915,90000,25000000000,90000,0,2,104417,0x7bE64e73Aa178A4dc0Fabf9e2B1d2A9Ac0229dA5,0x83cc754DDA833a93f1c7d4e1566B4785C27522d4
12544,15627915,1000000,22086201165,998024,1976,522,102,0x7a250d5630B4cF539739dF2C5dAcb4c659F2488D,0x43F0BAF4d39468C654d07Ee46a10B9c0285F1bFE
12545,15627915,750000,21086201165,748212,1788,458,651,0x7a250d5630B4cF539739dF2C5dAcb4c659F2488D,0xE3Bf3e1e0516d21d62800f05aB4fF95c730AbfA7
12546,15627915,750000,21086201165,748212,1788,458,27,0x7a250d5630B4cF539739dF2C5dAcb4c659F2488D,0xB2cAa03F8e8abaf89186A8Ce30591CE4C36286A5
12547,15627915,750000,21086201165,748212,1788,458,46,0x7a250d5630B4cF539739dF2C5dAcb4c659F2488D,0x2dACB9CD9b7CF4c3F0b21EF2212cB3Ba085a52c3
12548,15627915,600000,18886201165,598036,1964,522,2045,0x7a250d5630B4cF539739dF2C5dAcb4c659F2488D,0x19F98944322036F391E5842c8b973473bC00a760
12549,15627915,600000,18886201165,598036,1964,522,2046,0x7a250d5630B4cF539739dF2C5dAcb4c659F2488D,0x19F98944322036F391E5842c8b973473bC00a760
12550,15627915,600000,18886201165,598024,1976,522,1159,0x7a250d5630B4cF539739dF2C5dAcb4c659F2488D,0x5b59fe5AC0C5e108c2f3ECD78B27c9847F4391Ae
12551,15627915,600000,18886201165,598024,1976,522,1058,0x7a250d5630B4cF539739dF2C5dAcb4c659F2488D,0x0C517c1DE86b49C2535236f181a220c0b55b7423
12552,15627915,600000,18886201165,598024,1976,522,696,0x7a250d5630B4cF539739dF2C5dAcb4c659F2488D,0x69b63ce04dBf9Bb21a3089b354a5d4f0c379536B
12553,15627915,600000,18886201165,598024,1976,522,1059,0x7a250d5630B4cF539739dF2C5dAcb4c659F2488D,0x0C517c1DE86b49C2535236f181a220c0b55b7423
12554,15627915,600000,18886201165,598024,1976,522,1160,0x7a250d5630B4cF539739dF2C5dAcb4c659F2488D,0x5b59fe5AC0C5e108c2f3ECD78B27c9847F4391Ae
12555,15627915,600000,18886201165,598024,1976,522,697,0x7a250d5630B4cF539739dF2C5dAcb4c659F2488D,0x69b63ce04dBf9Bb21a3089b354a5d4f0c379536B
12556,15627915,100000,17223908994,99392,608,138,206177,0xdAC17F958D2ee523a2206206994597C13D831ec7,0xD3E52099a6a48F132Cb23b1364B7dEE212d862F6
12557,15627915,350000,16914247074,349392,608,138,6925083,0xdAC17F958D2ee523a2206206994597C13D831ec7,0x46340b20830761efd32832A74d7169B29FEB9758
12558,15627915,350000,16914247074,350000,0,2,6925084,0x19b06761aA93529856414CB9EbF997e1654424C0,0x46340b20830761efd32832A74d7169B29FEB9758
12559,15627915,860039,16586201165,858063,1976,522,4613,0x7a250d5630B4cF539739dF2C5dAcb4c659F2488D,0x84Ab6D0401831896Fe2484f5eeeeb944B5BA95DB
12560,15627915,46219,16086201165,45647,572,138,2192,0x1Fa8559e873f698292766790AeCf8080A66433F6,0x16C992e55b4F0D8ebF5973DaEc2cEb882C86Fd17
12561,15627915,750000,16086201165,748000,2000,522,25,0x7a250d5630B4cF539739dF2C5dAcb4c659F2488D,0xB286776A207ddC1dF0033BA9323891F9309319BA
12562,15627915,181476,16086201165,179912,1564,394,25,0x1Fa8559e873f698292766790AeCf8080A66433F6,0x6552FD2d3fB7035C344958e616243A87CF45B9B8
12563,15627915,181476,16086201165,179912,1564,394,176,0x1Fa8559e873f698292766790AeCf8080A66433F6,0xd87eA7d32C4aA6Ae8a461faA1603cCe58E15f337
12564,15627915,500000,15086201165,498632,1368,266,141511,0xb8901acB165ed027E32754E0FFe830802919727f,0x710bDa329b2a6224E4B44833DE30F38E7f81d564
12565,15627915,860039,15046201165,858099,1940,522,7607,0x7a250d5630B4cF539739dF2C5dAcb4c659F2488D,0x7D29c4f95c009CE4B158f68f06D56f02f460c9Bb
12566,15627915,860039,15046201165,858087,1952,522,7019,0x7a250d5630B4cF539739dF2C5dAcb4c659F2488D,0x8FFdD83b2C1541e661c2437B1887844654E050c9
12567,15627915,860039,15046201165,858087,1952,522,5788,0x7a250d5630B4cF539739dF2C5dAcb4c659F2488D,0xf65760f5088902333FCDC50352781F8F82FB6F07
12568,15627915,90000,15045958274,90000,0,2,784423,0xa2AF66e585ed4e684dD76598dA1E1B6814B3aE37,0xcaD621da75a66c7A8f4FF86D30A2bF981Bfc8FdD
12569,15627915,63000,14986569305,63000,0,2,183635,0xD00d6f288b358768DB2a437584785a7E8c7fD90E,0x25eAff5B179f209Cf186B1cdCbFa463A69Df4C45
12570,15627915,21000,14840000000,21000,0,2,11,0x6615B81d6B014E6E7B19B29dcDEc8BE75ED34D3e,0x994cf915cA1987F4FEBfdf5004CbaB8f0d818869
12571,15627915,420000,14686201165,418012,1988,522,226,0x7a250d5630B4cF539739dF2C5dAcb4c659F2488D,0xceB7Bc1098138e850195698F4Ff2726031CDe545
12572,15627915,151736,14086201165,150324,1412,522,62,0xCd48eCd9110979D6e343Bc5AE4Cc8035339A35c9,0x1Dc0BA9941847A96F096d25018Df844176066FCA
12573,15627915,500000,14086201165,498028,1972,394,60933,0x585C3d4Da9b533C7e3dF8AC7356C882859298cEe,0xd5cf0Cb9a8DF9B46f077f561d8b76c34A69bD82F
12574,15627915,181458,14086201165,179906,1552,394,673,0x1Fa8559e873f698292766790AeCf8080A66433F6,0x7E5f2672Df12D9dDE49739447AAdA3362031dA66
12575,15627915,392625,14086201165,389733,2892,650,4,0x7a250d5630B4cF539739dF2C5dAcb4c659F2488D,0x9A4140FFB57D5272ea009c37a18D2A88B54e6063
12576,15627915,181458,14086201165,179906,1552,394,133,0x1Fa8559e873f698292766790AeCf8080A66433F6,0x563E5a6b1d5c92D6620011f406fA16b3eAD93858
12577,15627915,181476,14086201165,179912,1564,394,1120,0x1Fa8559e873f698292766790AeCf8080A66433F6,0xe86bC7A5E570d60cF375Ce288EBc127E0EebE633
12578,15627915,21000,13757866861,21000,0,2,0,0xAB15041Ce6859A3724044913111111b47496aAFe,0x44689685caCcc74eCE58133ACf8CdCA2119b8369
12579,15627915,21000,13700000000,21000,0,2,0,0x6dfc34609a05bC22319fA4Cce1d1E2929548c0D7,0x9FaEF23c094716c4be098f58E7132eB7DD23900b
12580,15627915,339997,13586201165,338773,1224,266,24,0x79bAB004d5DbAf80A73e1633800EC51BeEa5F1DF,0x41d04ff02Bb7b4C159E2D010e30eB70001579095
12581,15627915,112354,13586201165,108914,3440,906,173,0xD152f549545093347A162Dce210e7293f1452150,0x71fCE78Fe6C7a9EB03C16a0b16338e9C72134fcE
12582,15627915,21000,13237215600,21000,0,2,25038,0x2C1A71bdC96f263e88C7F6631B609476f6808Be8,0xf0458aAAf6d49192D3b4711960635D5FA2114E71
12583,15627915,222333,13171004870,219869,2464,472,53741,0x0000000000007F150Bd6f54c40A34d7C3d5e9f56,0x048Fde2d3d47F54d3E7bE0Be7A40e1cb5AfF5d72
12584,15627915,21000,13150000000,21000,0,2,255,0x292f04a44506c2fd49Bac032E1ca148C35A478c8,0xc36F3bBdb94Bf7fBFcBbA0c57476a42C9Db7AE97
12585,15627915,21000,13150000000,21000,0,2,27,0x292f04a44506c2fd49Bac032E1ca148C35A478c8,0x2d49312bC2d56E9b2F3Cb96b4CD2aB00a12dF6Bf
12586,15627915,21000,13087201165,21000,0,2,23548,0x42f76c174269B14687BDCe6C98631397900F599d,0x43fdA7708C97C4C40d5402c6392f0457f23c0b8e
12587,15627915,360000,13086201165,359380,620,138,93930,0xCE3f08e664693ca792caCE4af1364D5e220827B2,0xf89d7b9c864f589bbF53a82105107622B35EaA40
12588,15627915,90000,13086201165,90000,0,2,93931,0xaF589b5BbA5113e9733e44DAdFf8AdeC1438F8Fc,0xf89d7b9c864f589bbF53a82105107622B35EaA40
12589,15627915,55930,13086201165,54986,944,138,12,0xd075e95423C5c4BA1E122CaE0f4CdFA19b82881b,0xf8263E3f88D3e8454a0DD46d0D96A67190Ba7c51
12590,15627915,122564,13086201165,121012,1552,394,66,0x1Fa8559e873f698292766790AeCf8080A66433F6,0xE33299ff00b3F69DE1E8E1FB46AE8FAb5C6A4496
12591,15627915,122577,13086201165,121013,1564,394,67,0x1Fa8559e873f698292766790AeCf8080A66433F6,0xC546bD9281f8d005A80CAa360501F34d684495b4
12592,15627915,238963,13086201165,236167,2796,842,906,0x68b3465833fb72A70ecDF485E0e4C7bD8665Fc45,0x7036f927898ea18A54831F1D79B77Ce6Ea2041d0
12593,15627915,122577,13086201165,121013,1564,394,72,0x1Fa8559e873f698292766790AeCf8080A66433F6,0xA404a82536882C6d40a47f6e38205Ad660fd70D3
12594,15627915,181458,13086201165,179906,1552,394,847,0x1Fa8559e873f698292766790AeCf8080A66433F6,0xb689A89954C04C4a238697b64379810a666287ea
12595,15627915,122577,13086201165,121013,1564,394,75,0x1Fa8559e873f698292766790AeCf8080A66433F6,0xbfFE6b5De11Ce18221D5DC6745c2Eb5d898753c5
12596,15627915,21000,13086201165,21000,0,2,903,0xEcc97236B886ED2F4C947eF4e795FB80d3140Fe1,0x99291eaEC9f3208bC4e3621bb92Ca8F701Dc211e
12597,15627915,122564,13086201165,121012,1552,394,76,0x1Fa8559e873f698292766790AeCf8080A66433F6,0x1B9830af221ef80dEAAc64DB9070000D9f048D94
12598,15627915,122577,13086201165,121013,1564,394,76,0x1Fa8559e873f698292766790AeCf8080A66433F6,0xbC2ec030d257d8Ee10482474332addB98EB6a2a2
12599,15627915,181476,13086201165,179912,1564,394,828,0x1Fa8559e873f698292766790AeCf8080A66433F6,0x52b4AE6798DDd241f0e882960FAF3F966d488493
12600,15627915,122577,13086201165,121013,1564,394,79,0x1Fa8559e873f698292766790AeCf8080A66433F6,0xC19ed12a1D7CC5f1D0090bE4Fe596D8c5b93491A
12601,15627915,122577,13086201165,121013,1564,394,79,0x1Fa8559e873f698292766790AeCf8080A66433F6,0xfFFC8492F4E00d2Da5D4A20b1be2256E26323119
12602,15627915,39603,13086201165,39351,252,74,9,0xC02aaA39b223FE8D0A0e5C4F27eAD9083C756Cc2,0x7378711DE38d222F984B4a6C1CC550C1efBFa113
12603,15627915,181476,13086201165,179912,1564,394,95,0x1Fa8559e873f698292766790AeCf8080A66433F6,0x0b883afE0514c3309FAF749Ee431Ef4902b8490A
12604,15627915,21000,13086201165,21000,0,2,2759952,0xFE609D962dDb1736513Be3A30645C00b28e635FE,0x267be1C1D684F78cb4F6a176C4911b741E4Ffdc0
12605,15627915,235797,13086201165,235593,204,74,1460,0xaEab9eCBfae9A0ec5D6035c887D4D115aBcAe1D0,0x545AdcF5C9E88c19343E16e7ddbf4BF6c3e53bb8
12606,15627915,181458,13086201165,179906,1552,394,18,0x1Fa8559e873f698292766790AeCf8080A66433F6,0x7C400b04851C467a5dda76ce4abC54F309e14F29
12607,15627915,42000,13086201165,42000,0,2,329568,0x0b2Ab4b6dc89c0B408e567d5557Eb0Fc85346064,0x9430801EBAf509Ad49202aaBC5F5Bc6fd8A3dAf8
12608,15627915,21000,13086201165,21000,0,2,40,0x6260d79bD6856148C361e2eA72EddD3Ef1EC7e5F,0xC42542925B540371708e319df9f093D1Ef49eE2f
12609,15627915,48712,13086201165,47768,944,138,155,0xB1e93236ab6073fdAC58adA5564897177D4bcC43,0xf372F5B54d293990c639B531a16206246FC17680
12610,15627915,270730,13086201165,265318,5412,1484,156,0x881D40237659C251811CEC9c364ef91dC08D300C,0xf372F5B54d293990c639B531a16206246FC17680
12611,15627915,191041,13000000000,190165,876,266,1406,0xd588b586D61C826A0e87919b3D1a239206d58bf2,0xC22d03e13B888Dabb33A1575e4F6542f0e996622
12612,15627915,60105,12810484299,60105,0,2,48498,0x4dC9e781Fef18fa4Dc5217A5Ee1156f668B5aF55,0x4dC9e781Fef18fa4Dc5217A5Ee1156f668B5aF55
12613,15627915,300000,12686201165,297632,2368,586,279,0xd9e1cE17f2641f24aE83637ab66a2cca9C378B9F,0x49b2d9EF9658007d2d5A4Bf0d9E78F1ae0457AA7
12614,15627915,255511,12659388681,251883,3628,1162,246,0x68b3465833fb72A70ecDF485E0e4C7bD8665Fc45,0x17aFdC04CA1D732b3A376Fb9A8131F35D894f563
12615,15627915,1497500,12640741262,1470320,27180,6602,38597,0x902F09715B6303d4173037652FA7377e5b98089E,0xe93685f3bBA03016F02bD1828BaDD6195988D950
12616,15627915,58273,12587201165,57665,608,138,867,0xdAC17F958D2ee523a2206206994597C13D831ec7,0xA5D62640081d2a1bc5deD398F2AA5aC6e463746b
12617,15627915,46157,12586201165,45669,488,138,79,0x69d4584080EdC5d058D5C51Ac61ec0c14E417E70,0x791B61E3198bcFBf83530073F89B896DA85C56CA
12618,15627915,313585,12586201165,308609,4976,1674,39473,0x7Ed7382D0EcfeE9Bf1085671CCe4b0A5774a6E89,0x79b7a69d90c82E014Bf0315e164208119B510FA0
12619,15627915,21000,12586201165,21000,0,2,914,0x7E250AdFcE17ffA8e1C0974C919C8E09e39030E1,0x0455012bD2D352a72b8C35cd2fccF6934A5Fe280
12620,15627915,430114,12586201165,424934,5180,840,49933,0xED77777586D73C58EB4D6BEBDF9c85C2d5F56C2d,0x4425C20D8e84c48AEbEB116cF7b9838D4833f78D
12621,15627915,67544,12586201165,66068,1476,458,21,0x74fD1E808dD4919c90bc79F62d786C3576461ED6,0x030ce9d143332f6D9c287414f08e22c145c43c58
12622,15627915,175110,12586201165,173546,1564,394,60,0x1Fa8559e873f698292766790AeCf8080A66433F6,0xcc73ee348F7e5C9721E30577b71b29a692ed6689
12623,15627915,181458,12586201165,179906,1552,394,270,0x1Fa8559e873f698292766790AeCf8080A66433F6,0xb0002A56ce9Ca0881887DDA33c5EB3e18Ed4bb84
12624,15627915,55950,12586201165,55006,944,138,61,0xA2b4C0Af19cC16a6CfAcCe81F192B024d625817D,0xe858c86AF7111A8d72DDE4484993fD878F4E538F
12625,15627915,142896,12586201165,136380,6516,1802,1434,0x00000000006c3852cbEf3e08E8dF289169EdE581,0x2cdc001EA87149210328d292cC84c250b4995DC2
12626,15627915,21000,12586201165,21000,0,2,17,0x31c0B8553C5f95BddE35123Af010B22Ff08e7c4e,0x464811Fb0A14EbB946792D8bD8224D07B00Ea457
12627,15627915,507666,12586201165,503162,4504,970,8126,0x00000000C2Cf7648c169b25ef1C217864bFa38cC,0x51A83f2aD30Ce3e0a5f39108f54cDB46401267e0
12628,15627915,46319,12586201165,45687,632,138,17,0x045da4bFe02B320f4403674B3b7d121737727A36,0xaaFA6b898A43b61F576bc71513A0ac23Ca0220b7
12629,15627915,21000,12586201165,21000,0,2,113,0x274362fA1A737D20e84E4f82D5b193A95A7cc455,0x700cd69fA3B03646ECfA7C5AD8a380f2E91fc80d
12630,15627915,21000,12586201165,21000,0,2,2,0xc445B4268D41293F986De7d276186e2d3AFBA543,0x7aA4943A28a729415a3B4f9e30029E00638D0F93
12631,15627915,21000,12586201165,21000,0,2,91,0xA8D9aDAa60E4A24e0eb3453E885681837C190caF,0x910cDBf1ce1866Af0e480eB22B36F140EdD8DB26
12632,15627915,60779,12586201165,53271,7508,2514,350,0x00000000006c3852cbEf3e08E8dF289169EdE581,0x140d9Fb266aA0C399e2E4b89545b2d80720d7e79
12633,15627915,21000,12586201165,21000,0,2,552,0x00cbB5Bf296213909a7b2A4Ce28f3e802bC62a70,0xC01A16b70F77f078B7B8c7e5Bd4EB8eec60f0382
12634,15627915,176930,12586201165,170354,6576,1802,444,0x00000000006c3852cbEf3e08E8dF289169EdE581,0x0B9db020472EFc722Da08a7dC50f3Abe3BE8bC29
12635,15627915,66432,12586201165,66000,432,74,434,0x867cD80e464E8E2074a8c46aE3C983096395172F,0x48782befEe56a2538749668B922202726a6CcD93
12636,15627915,150756,12586201165,150692,64,10,8,0x65c2e54a4c75ff6da7b6B32369c1677250075fb2,0xa320931b7c91b708D43e2F109776C6b596bd3F84
12637,15627915,21000,12586201165,21000,0,2,4,0xdf8963eA56aA915E1497c3d22c8760B12BC6F3f4,0x88fc3d68D7723770A189a8330B784616bB353C48
12638,15627915,28974,12586201165,28414,560,138,494,0x6B175474E89094C44Da98b954EedeAC495271d0F,0x2EceCf5a33d038694133BbF3A22AEAFBc96d4B04
12639,15627915,21000,12586201165,21000,0,2,898,0x86C07dC5f35357b835061623990800814D358183,0xaDdD2174538291c932F94D3183c4885FdF11341b
12640,15627915,55921,12586201165,54977,944,138,7,0x467719aD09025FcC6cF6F8311755809d45a5E5f3,0x6CeA873B5b556A6f572A14F8ed339306A02d9B54
12641,15627915,185823,12586201165,183671,2152,586,166,0xFbdDaDD80fe7bda00B901FbAf73803F2238Ae655,0xB78F8440a21a3128439BE04ac257703EE549a41E
12642,15627915,46682,12586201165,46194,488,138,39,0x67df41EDf21e1c581A77E939f60db7bAa5E96993,0x1542e2A5CA9F89587281A10d4f47B93cA807Bb70
12643,15627915,21000,12586201165,21000,0,2,1343,0x80C2fA12BD8009E0CC5F7b0F0A8F3d40236D1313,0xf54611A627aFA7c00a58569932554372dD3F4b3B
12644,15627915,56659,12586201165,55715,944,138,213,0xAD13C2a8d418d01F3236F4d8b9d724575a4e9d24,0x9AC3b437ce4D8F10210955D7A7829f3312612D90
12645,15627915,46136,12586201165,45648,488,138,1906,0xf13F29330DcA76Be26A6c7E268da836Aef978E11,0x2c893b54E24188764ab71Bbb72BaCA8990Dea2e4
12646,15627915,181476,12586201165,179912,1564,394,607,0x1Fa8559e873f698292766790AeCf8080A66433F6,0xff019340537C2DB8F0717F9E710977d18A46d61f
12647,15627915,21000,12586201165,21000,0,2,4,0x129EF75EA740e6A2650a83Ff494B6D8db5bBC3B6,0x4619365d3F5cEA6a279426a9ea9dd3A8F6989E5B
12648,15627915,46547,12586201165,46059,488,138,26,0xaE351b8Ae55B69A5007618E598dDe89d0a092c37,0x9F0D3484Ea73Ccb0238df5b03d385b0e149C718D
12649,15627915,21000,12586201165,21000,0,2,130,0x6494472f99531960fD02B45edf9F74c7aC0def65,0xB95731D8960164cdF68484439c65A634e471AA60
12650,15627915,21000,12586201165,21000,0,2,969,0x74Fec90277FEF63D5Aca5a0d2f6A684cF4911B7a,0xfb94718490d08F5146313d03Aee65D6564995B3C
12651,15627915,63599,12586201165,53983,9616,2890,1864,0x00000000006c3852cbEf3e08E8dF289169EdE581,0x3436100674492BCe353C6709ec11DEd32b1A797a
12652,15627915,163784,12586201165,157208,6576,1802,57,0x00000000006c3852cbEf3e08E8dF289169EdE581,0xE5B9841918bF2F29308E154A46D4c2d71B62E1A4
12653,15627915,215667,12586201165,209355,6312,1802,1925,0x00000000006c3852cbEf3e08E8dF289169EdE581,0x28ec4b9785C3D7E4dB5017D3CD09224136F7Ff34
12654,15627915,132172,12586201165,125968,6204,1610,25,0x00000000006c3852cbEf3e08E8dF289169EdE581,0x4DBB6b7cF4BD8E9C72763cCd7cBc1c77600d308d
12655,15627915,139200,12586201165,138544,656,138,19,0xD502F487e1841Fdc805130e13eae80c61186Bc98,0xDB2C0733e0A8d202BD1246e02047FC59665Dd8D2
12656,15627915,21000,12586201165,21000,0,2,25,0xD5dc108C6F31BaA43E6F906c70D3E837b876abE0,0xBe732b27274f0Da3222F95Fcc05C17aE5875F3b8
12657,15627915,163784,12586201165,157208,6576,1802,238,0x00000000006c3852cbEf3e08E8dF289169EdE581,0xd07834e20843843fBd3381CbBb970a0Ea5F64C64
12658,15627915,48897,12586201165,48301,596,138,145,0xdAC17F958D2ee523a2206206994597C13D831ec7,0x93750D820cA511BCf9d98bE98FB011bE5703CcAe
12659,15627915,21000,12586201165,21000,0,2,551,0xDe2FBcDfd564D2D2Be6066eE88ABCdd889c79F90,0x2b8dd6db293dd5e88eE856f5DF5682416e760D04
12660,15627915,21000,12586201165,21000,0,2,4,0x0E638C186C9cF41cfaBbc7E8024E0D1987b2011f,0x86Cd0944013e2B852DA7AFa6C8b7ad76d0B35a67
12661,15627915,46086,12586201165,45598,488,138,70,0x6E6650fD4949fddF0BACC45c06ae3437f61acb1b,0x0249DEeC079ECC900aB1E25E098AE49bF06bCAAb
12662,15627915,90711,12586201165,90507,204,74,1,0xaEab9eCBfae9A0ec5D6035c887D4D115aBcAe1D0,0x8BA3719B8eF5Dfc3CEF00Df337CDf16e26456028
12663,15627915,55897,12586201165,54953,944,138,324,0xFDBf91A7F2d757A9815326af5E1e60319571984c,0xff7fEd770EE4E628a6106A2399044E3C4fC7521C
12664,15627915,21000,12586201165,21000,0,2,374,0x9D4B3553f7F615ff0315711e31A41500EBDfFA13,0xc4fBCB5C649A94Ee5d72875aE3d71B92f8c049e7
12665,15627915,73170,12586201165,72574,596,138,254,0xA0b86991c6218b36c1d19D4a2e9Eb0cE3606eB48,0xD9b248c2420d02E4597F5d1E1530F7f6D3Bb6e0F
12666,15627915,21000,12586201165,21000,0,2,8,0x73b3EF034AcD92535aEB869BA25145878Bc0b8f1,0x8f6b5607124C53F2a16BC48A74772F09875D9F42
12667,15627915,240662,12586201165,234374,6288,1802,334,0x00000000006c3852cbEf3e08E8dF289169EdE581,0xD76010A698973345c7500FD38576C0B67E17a659
12668,15627915,46135,12586201165,45647,488,138,905,0x1Fa8559e873f698292766790AeCf8080A66433F6,0x4248E7C9B1f45FC8C479eA9bE8db719c95B0dCA8
12669,15627915,21000,12586201165,21000,0,2,106,0xfaAe71F5B5cedF4C878Fe1d019ed35225e66C1ee,0xf6e9b43969f52021bC920c635df3933bC01aB52c
12670,15627915,46103,12586201165,45615,488,138,13,0x346378C67d0F71343F80299ed8C0407aC2Df05eB,0xa50FF6aD20aDC10998e33F52b63d71f26C34874A
12671,15627915,100279,12586201165,99327,952,202,432,0x87b5D8fE6cF8b37678B6CeF7cca23a4852883C48,0x216A023E0c19382D895a66A76dd92E898c9BE3a7
12672,15627915,320189,12417204795,315709,4480,1420,857,0x881D40237659C251811CEC9c364ef91dC08D300C,0xAa4B6B4c7417248dF49dc484d5Eb9a4377A4C7e1
12673,15627915,175092,12086201165,173540,1552,394,52,0x1Fa8559e873f698292766790AeCf8080A66433F6,0xF4005e4C3C2F5eC923bc0356a038FBd8b59D5e8a
12674,15627915,181476,12086201165,179912,1564,394,255,0x1Fa8559e873f698292766790AeCf8080A66433F6,0x66576C594D6fEC3794EC3d53A8Dc5B83Ad48Da79
12675,15627915,160881,12086201165,158073,2808,842,936,0x68b3465833fb72A70ecDF485E0e4C7bD8665Fc45,0xdCb31a6d93b1a51101cCa6FCdc45594cd9688401
12676,15627915,181476,12086201165,179912,1564,394,840,0x1Fa8559e873f698292766790AeCf8080A66433F6,0x982461d904FC0eF2773B3cDa2d7d1A7376Ca458F
12677,15627915,181476,12086201165,179912,1564,394,70,0x1Fa8559e873f698292766790AeCf8080A66433F6,0x2c08759EBcA7740F9f9a9E33f64D9a3A3417426c
12678,15627915,181476,12086201165,179912,1564,394,283,0x1Fa8559e873f698292766790AeCf8080A66433F6,0x7c46882efFdac172A4Db0C3a019e5bC71bB62B4D
12679,15627915,181476,12086201165,179912,1564,394,544,0x1Fa8559e873f698292766790AeCf8080A66433F6,0x7afC3de088304bDB158dE344beE4566Ce7037c08
12680,15627915,21000,12086201165,21000,0,2,265,0x208DDb5e396990B0EA030d89BA8F91D3A319179D,0x1B352185145d1aEBCB151F7C28257682c3375336
12681,15627915,181476,12086201165,179912,1564,394,0,0x1Fa8559e873f698292766790AeCf8080A66433F6,0xbE75d710D3b171416726148117ba03e2d66A93b9
12682,15627915,181476,12086201165,179912,1564,394,2986,0x1Fa8559e873f698292766790AeCf8080A66433F6,0x98cE912ea90388950BaB6779DD104Db6F2d540eD
12683,15627915,181476,12086201165,179912,1564,394,411,0x1Fa8559e873f698292766790AeCf8080A66433F6,0xb55d17a1e777bB1C4EA2383569CC5760166246A3
12684,15627915,181476,12086201165,179912,1564,394,24,0x1Fa8559e873f698292766790AeCf8080A66433F6,0x1A31A79c2FdCd8234438e232d91f30ee81040a74
12685,15627915,181476,12086201165,179912,1564,394,545,0x1Fa8559e873f698292766790AeCf8080A66433F6,0x7afC3de088304bDB158dE344beE4566Ce7037c08
12686,15627915,181476,12086201165,179912,1564,394,640,0x1Fa8559e873f698292766790AeCf8080A66433F6,0xC8eD349529BAb23AC6c726693623ceFa2e31Ed98
12687,15627915,181476,12086201165,179912,1564,394,594,0x1Fa8559e873f698292766790AeCf8080A66433F6,0xEA39fE417A9a39aa4A25f3C92c57A68489D94A0B
12688,15627915,181458,12086201165,179906,1552,394,268,0x1Fa8559e873f698292766790AeCf8080A66433F6,0x0F57Af1A2300Fc358a25ed4847ab520fD7569Bb9
12689,15627915,181476,12086201165,179912,1564,394,112,0x1Fa8559e873f698292766790AeCf8080A66433F6,0xf844B9C29FEC74ED26C8aD77cEA077bad0AB151d
12690,15627915,181458,12086201165,179906,1552,394,1912,0x1Fa8559e873f698292766790AeCf8080A66433F6,0xb39a6B4cb933AAB3c30dA765aCF26c4C00a4bF11
12691,15627915,181476,12086201165,179912,1564,394,1153,0x1Fa8559e873f698292766790AeCf8080A66433F6,0xb7e6c740C03e9a50A26A08E367b6786A47F690bb
12692,15627915,181476,12086201165,179912,1564,394,273,0x1Fa8559e873f698292766790AeCf8080A66433F6,0xEC97CD3771b5f1fdbe4673c597b06f4c7ac389E3
12693,15627915,550000,12086201165,548152,1848,458,92,0x7a250d5630B4cF539739dF2C5dAcb4c659F2488D,0x00804aD8aa538E852f5Bb4A49f8957a783ac132f
12694,15627915,178398,12086201165,178194,204,74,2364,0x645E9324f4be25be581BB62163cfa86c40b01D07,0xc5009AFEd2D6DA219538aD165998F63B553185B1
12695,15627915,181476,12086201165,179912,1564,394,155,0x1Fa8559e873f698292766790AeCf8080A66433F6,0x8712F58C0D39C6Fbb61F842C84e8C2B425c8c8eb
12696,15627915,181476,12086201165,179912,1564,394,1419,0x1Fa8559e873f698292766790AeCf8080A66433F6,0xA95c4b11C3b4082B178080C5a661A020a053a891
12697,15627915,181476,12086201165,179912,1564,394,632,0x1Fa8559e873f698292766790AeCf8080A66433F6,0x4c10444245371aaba306B60E6B33397B952cCb93
12698,15627915,181476,12086201165,179912,1564,394,232,0x1Fa8559e873f698292766790AeCf8080A66433F6,0xB647A968616Cede5C5Fe462C46019A3369abf88f
12699,15627915,181476,12086201165,179912,1564,394,714,0x1Fa8559e873f698292766790AeCf8080A66433F6,0x5E47565F5fb626D3c8557F3e589e3490154B8b91
12700,15627915,181476,12086201165,179912,1564,394,546,0x1Fa8559e873f698292766790AeCf8080A66433F6,0x7afC3de088304bDB158dE344beE4566Ce7037c08
12701,15627915,181476,12086201165,179912,1564,394,254,0x1Fa8559e873f698292766790AeCf8080A66433F6,0xfD439029A39c6C3B848CfFDb4DF149B4ac5fCA11
12702,15627915,181476,12086201165,179912,1564,394,5,0x1Fa8559e873f698292766790AeCf8080A66433F6,0x537f917CaDA5449C9f04171bCFCC8fCe06A8F780
12703,15627915,181476,12086201165,179912,1564,394,996,0x1Fa8559e873f698292766790AeCf8080A66433F6,0xBe38Ab7Fd020A228841Cf9836a48f0Bf500BCa7d
12704,15627915,181476,12086201165,179912,1564,394,18,0x1Fa8559e873f698292766790AeCf8080A66433F6,0x44ddf7814EECCbD9472405ec15400186Bae3a5Ab
12705,15627915,121018,12086201165,120446,572,138,49,0x1748B24faf9780B74E5A9f3Feb41553E712E94aa,0x6819eA7792CC89394fEEE84FC70d54a67cD0B765
12706,15627915,181476,12086201165,179912,1564,394,115,0x1Fa8559e873f698292766790AeCf8080A66433F6,0x1c4016C89E6C3b7A63d4C915FB9B714C27692449
12707,15627915,189972,11959152379,189908,64,10,1,0x2cac916b2A963Bf162f076C0a8a4a8200BCFBfb4,0xb63cF3F5469be8A06f2dB72116f3Bb9708fF1DEE
12708,15627915,251522,11896303666,248726,2796,842,0,0x68b3465833fb72A70ecDF485E0e4C7bD8665Fc45,0x5c2202CF00E2c6376c5b3faa5d94A6fD87987488
12709,15627915,341342,11888230139,340218,1124,144,292,0xdb7A53E6AE058E1Dcf4502341E2ADFA522E2B29F,0xa23cABeCa2145Ce4e6fdD81a45be8fB53A4F9535
12710,15627915,21000,11364072049,21000,0,2,9,0xd5FBDa4C79F38920159fE5f22DF9655FDe292d47,0xf001865fB324b8201aA53c81933a4a34f9Efcd00
12711,15627915,207793,11322122990,206853,940,202,7790,0x9d418C2Cae665D877F909a725402EbD3A0742844,0x8aE57A027c63fcA8070D1Bf38622321dE8004c67
12712,15627915,366796,11322122990,170044,196752,24728,183259,0x5E4e65926BA27467555EB562121fac00D24E9dD2,0x6887246668a3b87F54DeB3b94Ba47a6f63F32985
12713,15627915,26000,11086201165,26000,0,2,12039,0xe688b84b23f322a994A53dbF8E15FA82CDB71127,0xDAFEA492D9c6733ae3d56b7Ed1ADB60692c98Bc5
12714,15627917,800000,60085489361,800000,0,2,131,0xe001b672D7e2E779fDc34D0E69bB223994621403,0xe001b672D7e2E779fDc34D0E69bB223994621403
12715,15627917,210000,34000000000,210000,0,2,843597,0xeb65D3caD572720054B6FA9366c98bF444041B1E,0xA7EFAe728D2936e78BDA97dc267687568dD593f3
12716,15627917,181476,33000000000,179912,1564,394,2698,0x1Fa8559e873f698292766790AeCf8080A66433F6,0xE2f9fC75984516748405cC2c184Fc7cF1Be11026
12717,15627917,181476,20085489361,179912,1564,394,932,0x1Fa8559e873f698292766790AeCf8080A66433F6,0xe6F1d43080749b7805e905aefEf0575990F2F0B5
12718,15627917,750000,20085489361,748212,1788,458,652,0x7a250d5630B4cF539739dF2C5dAcb4c659F2488D,0xE3Bf3e1e0516d21d62800f05aB4fF95c730AbfA7
12719,15627917,100000,16983184485,99392,608,138,181442,0x473037de59cf9484632f4A27B509CFE8d4a31404,0x6238872A0Bd9F0E19073695532a7Ed77ce93C69E
12720,15627917,181476,16085489361,179912,1564,394,16,0x1Fa8559e873f698292766790AeCf8080A66433F6,0xE62bb72A6C828a8e56788c803B7A141cdd211C0a
12721,15627917,175110,16085489361,173546,1564,394,299,0x1Fa8559e873f698292766790AeCf8080A66433F6,0x4167c401A81e3286019C31699e3fD993F9Df89Ba
12722,15627917,181476,15000000000,179912,1564,394,319,0x1Fa8559e873f698292766790AeCf8080A66433F6,0xf72B223D99C89042475E6e7Bb356880C8931B398
12723,15627917,251309,15000000000,244833,6476,1746,2352,0x00000000006c3852cbEf3e08E8dF289169EdE581,0x2Be60b0fb138479F7333086Cc2460620436A110E
12724,15627917,21000,14751800439,21000,0,2,0,0xC098B2a3Aa256D2140208C3de6543aAEf5cd3A94,0x430e48e58B91E35135a6066D6D6591f1dE9Eec61
12725,15627917,210000,14492317427,209320,680,138,105,0x2b8beC81F648f327B7d8278EE74932845cDa3d19,0x18de54c850C959eDa854017De199e27c437635DF
12726,15627917,210000,14492317427,209320,680,138,880,0x2b8beC81F648f327B7d8278EE74932845cDa3d19,0xdea76156e7ADC43a942931a90d55a573583a760d
12727,15627917,1000000,14441489361,998048,1952,522,2102,0x7a250d5630B4cF539739dF2C5dAcb4c659F2488D,0x81E805660B2b43d582372BECc06Ae504f788E8Ce
12728,15627917,45000,14284696782,45000,0,2,105728,0x0000000000007F150Bd6f54c40A34d7C3d5e9f56,0x60530f5Ca4CB9907e0FBE67cA3AFCbFE56D19A5c
12729,15627917,100000,14200000000,99024,976,202,705898,0xdAC17F958D2ee523a2206206994597C13D831ec7,0x6dfc34609a05bC22319fA4Cce1d1E2929548c0D7
12730,15627917,277688,14152653715,276952,736,202,17979,0xFE290336a7FB1d5FDcCDe1C4FFeb714Ab6892Bc2,0x22596EeC7A0399D1fA9Cab32f519AB305162e7Fc
12731,15627917,181476,14085489361,179912,1564,394,297,0x1Fa8559e873f698292766790AeCf8080A66433F6,0x7479BFc856DBCfA030DeD747436c6ab81c072586
12732,15627917,100000,14045246470,99392,608,138,368503,0xdAC17F958D2ee523a2206206994597C13D831ec7,0xeC30d02f10353f8EFC9601371f56e808751f396F
12733,15627917,100000,14045246470,99392,608,138,368504,0xdAC17F958D2ee523a2206206994597C13D831ec7,0xeC30d02f10353f8EFC9601371f56e808751f396F
12734,15627917,90000,14045246470,90000,0,2,784424,0x42b853fB9C26D633A51fF47141efD641f3595577,0xcaD621da75a66c7A8f4FF86D30A2bF981Bfc8FdD
12735,15627917,90000,14045246470,90000,0,2,784425,0x18A57dA87A37eAAd6E380afCE94803a87E9b2446,0xcaD621da75a66c7A8f4FF86D30A2bF981Bfc8FdD
12736,15627917,100000,14000000000,100000,0,2,61696,0x2628cc9c880Bb91Fe4686FCaA6CD83B83Aa59d8F,0x9AA65464b4cFbe3Dc2BDB3dF412AeE2B3De86687
12737,15627917,65990,13985857501,65346,644,138,4709953,0xd9Fcd98c322942075A5C3860693e9f4f03AAE07b,0x2FAF487A4414Fe77e2327F0bf4AE2a264a776AD2
12738,15627917,84522,13987501505,83486,1036,202,4709954,0x016ee7373248a80BDe1fD6bAA001311d233b3CFa,0x2FAF487A4414Fe77e2327F0bf4AE2a264a776AD2
12739,15627917,76207,13985857501,75231,976,202,355163,0xdAC17F958D2ee523a2206206994597C13D831ec7,0x7abE0cE388281d2aCF297Cb089caef3819b13448
12740,15627917,21000,13160000000,21000,0,2,56,0xABf3Be82Df9342873E64B90C1D63841E502dd476,0x1F8F3B933fF8c37bf2230E92395281DA7E086106
12741,15627917,260324,13085489361,258512,1812,458,126,0x7a250d5630B4cF539739dF2C5dAcb4c659F2488D,0x49B30b829B2DF81C87E918dE9c1d40216f160c40
12742,15627917,284379,13085489361,282555,1824,458,951,0x7a250d5630B4cF539739dF2C5dAcb4c659F2488D,0x5E32dc9E56CFa0Ec2AAd724Bb564d8D9F9364382
12743,15627917,175110,13085489361,173546,1564,394,1095,0x1Fa8559e873f698292766790AeCf8080A66433F6,0x6635efbB877BDb525FA860C89015E0ced93262a4
12744,15627917,181458,13085489361,179906,1552,394,153,0x1Fa8559e873f698292766790AeCf8080A66433F6,0xB364c91C018cDaF601CcBDaC0933B10582BF18C4
12745,15627917,21000,13000000000,21000,0,2,32,0x09932321CB34f19f77747fa154db03F97056874B,0xD65c0C3424d5418304761A1DF3072fbE5150fC2c
12746,15627917,21000,12580000000,21000,0,2,4,0x5063a2b00481dB2ee6209effF61C6b638713BbBd,0x2E6FD5F9a8fa2368bE31005D242b25a8749E8C98
12747,15627917,21000,12086489361,21000,0,2,251067,0x95B3621bdA8272Ea2c78c32528E45f5EBa65c42e,0x8216874887415e2650D12D53Ff53516F04a74FD7
12748,15627917,21000,12086489361,21000,0,2,251068,0x24817724B8365212cCB03dFCF9d800d22AB9cCD0,0x8216874887415e2650D12D53Ff53516F04a74FD7
12749,15627917,207128,12085489361,206508,620,138,4708721,0x514910771AF9Ca656af840dff83E8264EcF986CA,0x28C6c06298d514Db089934071355E5743bf21d60
12750,15627917,207128,12085489361,207128,0,2,3492297,0xD75bf2B44A815Ff55B2E5daFcCf8FE54168701D8,0x56Eddb7aa87536c09CCc2793473599fD21A8b17F
12751,15627917,207128,12085489361,207128,0,2,3199192,0xC3Fa085bE8725fdA4c80d4c6f450E5E90668c328,0x9696f59E4d72E237BE84fFD425DCaD154Bf96976
12752,15627917,207128,12085489361,207128,0,2,1679542,0x6ff851b4359d96D752E49A79e9Cc8236C008Ac82,0x4976A4A02f38326660D17bf34b431dC6e2eb2327
12753,15627917,181476,12085489361,179912,1564,394,441,0x1Fa8559e873f698292766790AeCf8080A66433F6,0xce364F5E9d2b59e4C99621723388a81e9ec65630
12754,15627917,207128,12085489361,206520,608,138,4468977,0xdAC17F958D2ee523a2206206994597C13D831ec7,0x21a31Ee1afC51d94C2eFcCAa2092aD1028285549
12755,15627917,207128,12085489361,207128,0,2,4468978,0x25EABCb066D71b55EC5E0FeE771BC108B878C443,0x21a31Ee1afC51d94C2eFcCAa2092aD1028285549
12756,15627917,176942,12085489361,170354,6588,1802,516,0x00000000006c3852cbEf3e08E8dF289169EdE581,0x7A191b38D87DD2beCaa24d90Cd7731BA879E722a
12757,15627917,207128,12085489361,206520,608,138,4468979,0xA0b86991c6218b36c1d19D4a2e9Eb0cE3606eB48,0x21a31Ee1afC51d94C2eFcCAa2092aD1028285549
12758,15627917,207128,12085489361,206460,668,138,4468980,0x0D8775F648430679A709E98d2b0Cb6250d2887EF,0x21a31Ee1afC51d94C2eFcCAa2092aD1028285549
12759,15627917,181476,12085489361,179912,1564,394,1935,0x1Fa8559e873f698292766790AeCf8080A66433F6,0x48198DD06B89D8E8D4cc29A7D2AB4c60ABd3ad14
12760,15627917,21000,12085489361,21000,0,2,0,0xEA6aA41dE532389916752bCB374186C13E4Fd03F,0xEA6aA41dE532389916752bCB374186C13E4Fd03F
12761,15627917,135994,12085489361,135790,204,74,402,0x5DAC20CEabd1cfC989Ab4C48AF95e563631556c9,0xac58CE842935CC0D7dF67c553310697f76e75d4D
12762,15627917,42000,12085489361,42000,0,2,329569,0x1805731CedEE4874563ab676A14e31B38b88cc35,0x9430801EBAf509Ad49202aaBC5F5Bc6fd8A3dAf8
12763,15627917,135994,12085489361,135790,204,74,357,0x5DAC20CEabd1cfC989Ab4C48AF95e563631556c9,0x12924567B1a33bF8Feb4A39fe78181EfDd342A89
12764,15627917,135994,12085489361,135790,204,74,880,0x5DAC20CEabd1cfC989Ab4C48AF95e563631556c9,0x3e66C2151FF6B31D1912B6181393ad746aD83A67
12765,15627917,135994,12085489361,135790,204,74,508,0x5DAC20CEabd1cfC989Ab4C48AF95e563631556c9,0xDe1CeC1161B99248Ee3BD76e8868c59d2326717D
12766,15627917,135994,12085489361,135790,204,74,275,0x5DAC20CEabd1cfC989Ab4C48AF95e563631556c9,0xf90975f555c94A59396E586c631Fac8D1145F676
12767,15627917,135994,12085489361,135790,204,74,346,0x5DAC20CEabd1cfC989Ab4C48AF95e563631556c9,0x02403C6497c8ac6820254B357EF084b964fDdF3F
12768,15627917,135994,12085489361,135790,204,74,263,0x5DAC20CEabd1cfC989Ab4C48AF95e563631556c9,0xA16E6e84d9f5Deef40406736E8e2a8d6cB517d21
12769,15627917,135994,12085489361,135790,204,74,233,0x5DAC20CEabd1cfC989Ab4C48AF95e563631556c9,0x0597065B7F92d029B847325278D4cbCE16190fd1
12770,15627917,135994,12085489361,135790,204,74,293,0x5DAC20CEabd1cfC989Ab4C48AF95e563631556c9,0xAE3D530dc744d890eD3243C7dfB4ce49f8973B84
12771,15627917,135994,12085489361,135790,204,74,95,0x5DAC20CEabd1cfC989Ab4C48AF95e563631556c9,0x48A833b66feF4660617e6A1A5Ed0cF4C879a8bdA
12772,15627917,135994,12085489361,135790,204,74,80,0x5DAC20CEabd1cfC989Ab4C48AF95e563631556c9,0xF4afb6A0Fdeaa2bae9c226dc8139F8f64040C3A1
12773,15627917,135994,12085489361,135790,204,74,41,0x5DAC20CEabd1cfC989Ab4C48AF95e563631556c9,0x6F146312d76d6F1f435BC44063fBA68A563f6Ae7
12774,15627917,135994,12085489361,135790,204,74,297,0x5DAC20CEabd1cfC989Ab4C48AF95e563631556c9,0xd898e5eE3783f70197F6CB15c606C4c4d734acfF
12775,15627917,135994,12085489361,135790,204,74,209,0x5DAC20CEabd1cfC989Ab4C48AF95e563631556c9,0xEd3323E4AaB0D92A4550eCdFE6223F3ad88dA0ac
12776,15627917,135994,12085489361,135790,204,74,341,0x5DAC20CEabd1cfC989Ab4C48AF95e563631556c9,0xe80E7865966e74E5cC73967EE80a1a29F74CcCA8
12777,15627917,135994,12085489361,135790,204,74,557,0x5DAC20CEabd1cfC989Ab4C48AF95e563631556c9,0x766447cf3e7eafb2503aFD0DECD76eb95911C963
12778,15627917,175110,12085489361,173546,1564,394,664,0x1Fa8559e873f698292766790AeCf8080A66433F6,0xFB7Dbd99108045A075ee1CE107FF0AADde706aa2
12779,15627917,181458,12085489361,179906,1552,394,666,0x1Fa8559e873f698292766790AeCf8080A66433F6,0xA5029B84B4E7Da75D15ACD4D2df6F4c7fC46016a
12780,15627917,265635,12085489361,262863,2772,842,90,0x68b3465833fb72A70ecDF485E0e4C7bD8665Fc45,0x4Ff9C62eefAf1E4c0d5d362aEF3646912BF3B2c4
12781,15627917,135994,12085489361,135790,204,74,315,0x5DAC20CEabd1cfC989Ab4C48AF95e563631556c9,0x9308a7fd454FB86D4a737aB53E07DA2516621764
12782,15627917,135994,12085489361,135790,204,74,82,0x5DAC20CEabd1cfC989Ab4C48AF95e563631556c9,0x1B2f84fC5B95fb439Cf68A4BB284d4B9124137da
12783,15627917,135994,12085489361,135790,204,74,254,0x5DAC20CEabd1cfC989Ab4C48AF95e563631556c9,0x3Cbb2D03F8281EbBd4c62B7dD2284dbFBBE256fF
12784,15627917,135994,12085489361,135790,204,74,243,0x5DAC20CEabd1cfC989Ab4C48AF95e563631556c9,0xDaDcBBe3Df21395a0A7774Ec80c9d8F428B8Af26
12785,15627917,135994,12085489361,135790,204,74,76,0x5DAC20CEabd1cfC989Ab4C48AF95e563631556c9,0xB3552DD8152A09192D2995bb588554207bECC94e
12786,15627917,135994,12085489361,135790,204,74,360,0x5DAC20CEabd1cfC989Ab4C48AF95e563631556c9,0xD523ba249eE37A9F25aeb28669FFeec4Ec99a67A
12787,15627917,135994,12085489361,135790,204,74,75,0x5DAC20CEabd1cfC989Ab4C48AF95e563631556c9,0x733CA0a5b15a8ca29dC74eca4fC42cee773Fc22e
12788,15627917,135994,12085489361,135790,204,74,97,0x5DAC20CEabd1cfC989Ab4C48AF95e563631556c9,0x7670d9D73FE172D856bB1E9012251c828D09BcCC
12789,15627917,135994,12085489361,135790,204,74,330,0x5DAC20CEabd1cfC989Ab4C48AF95e563631556c9,0xDC783651052663c7f78fe2e8AF7EFcD986182bA2
12790,15627917,135994,12085489361,135790,204,74,392,0x5DAC20CEabd1cfC989Ab4C48AF95e563631556c9,0xA78FFd39FDaC562232204Dd340d16590b2AD7Edc
12791,15627917,135994,12085489361,135790,204,74,370,0x5DAC20CEabd1cfC989Ab4C48AF95e563631556c9,0x45677bfBF8aBb370F4c793ddBa02b975f96e0EF3
12792,15627917,135994,12085489361,135790,204,74,159,0x5DAC20CEabd1cfC989Ab4C48AF95e563631556c9,0x2876a59C8D523704882B2660aea4A4725AdCD57B
12793,15627917,135994,12085489361,135790,204,74,258,0x5DAC20CEabd1cfC989Ab4C48AF95e563631556c9,0xbFbB51A6CCD6c05FB00b0164609dab03Ca50ea72
12794,15627917,181476,12085489361,179912,1564,394,58,0x1Fa8559e873f698292766790AeCf8080A66433F6,0xA619F080255d6f02b0622b7fc1509C93B4A314bB
12795,15627917,56659,12085489361,55715,944,138,1233,0xAD13C2a8d418d01F3236F4d8b9d724575a4e9d24,0x2B473732FdD9e90D2BAb7433dA2eE55Cdf6b0248
12796,15627917,135994,12085489361,135790,204,74,227,0x5DAC20CEabd1cfC989Ab4C48AF95e563631556c9,0xC2205f1f35492c1673dF84c80A0f72F7083B415a
12797,15627917,135994,12085489361,135790,204,74,162,0x5DAC20CEabd1cfC989Ab4C48AF95e563631556c9,0x74A54e786f7cF72d727f0297099625F9e7Ad5F58
12798,15627917,400525,12085489361,398189,2336,522,11,0x283Af0B28c62C092C9727F1Ee09c02CA627EB7F5,0x725707A1B85A929E6F21Be73301cA0C974CC0aB4
12799,15627917,195110,12085489361,193546,1564,394,19,0x1Fa8559e873f698292766790AeCf8080A66433F6,0x196300253371Be2cD7AbBF5Ae2Da0691758C685b
12800,15627917,21000,12085489361,21000,0,2,667,0x4d988e59f285cD984dEdDC09EcfeFF1da3EaB539,0x45F1e7EeE9dc2dba7d85F2EC146632DC8Db8Ce85
12801,15627917,21000,12085489361,21000,0,2,16,0x2b4D95B73d5809B55728ab762B1005af926f8f7e,0x1f41509DC6F3777EF62b20645a0dc58D77c3dB51
12802,15627917,226780,12085489361,223176,3604,1162,869,0x68b3465833fb72A70ecDF485E0e4C7bD8665Fc45,0xc9BF80eA3918c2fcbf8Fa9e2325241E69A413874
12803,15627917,63209,12000000000,62601,608,138,6002,0xdAC17F958D2ee523a2206206994597C13D831ec7,0xa8e6ec181Bc616c6C22c42Bc5F5d52Ca63955ea6
12804,15627917,67254,12000000000,67050,204,74,2,0x9b9D659D4f2cF68b6616Cc0a65683f1951Eb725C,0xa95af2846B7970f649935591647d1BB5F7bF4852
12805,15627917,67254,12000000000,67050,204,74,96,0x9b9D659D4f2cF68b6616Cc0a65683f1951Eb725C,0x37407CdCF792aAc00397e39cedC0262368F4A2b5
12806,15627917,84354,12000000000,84150,204,74,28,0x9b9D659D4f2cF68b6616Cc0a65683f1951Eb725C,0x2198172d7e32e61ceF2b056D67d8C5240073ce43
12807,15627917,84354,12000000000,84150,204,74,41,0x9b9D659D4f2cF68b6616Cc0a65683f1951Eb725C,0xCE665a427B032f69Ea845B34988471A32496ffa1
12808,15627917,67254,12000000000,67050,204,74,89,0x9b9D659D4f2cF68b6616Cc0a65683f1951Eb725C,0x71bC6438d2Ccf31c6b06D0D973aBbDE75C1D65CF
12809,15627917,67254,12000000000,67050,204,74,26,0x9b9D659D4f2cF68b6616Cc0a65683f1951Eb725C,0xA49578FD4EA031C1c99C1013F6632F516Ae560C0
12810,15627917,84354,12000000000,84150,204,74,30,0x9b9D659D4f2cF68b6616Cc0a65683f1951Eb725C,0xa982C239bcb0ae716Bd2E09f81d4387Bf9761862
12811,15627917,67254,12000000000,67050,204,74,95,0x9b9D659D4f2cF68b6616Cc0a65683f1951Eb725C,0x838d8B141d3E14E4746D91f7bfB610Ab22B50317
12812,15627917,67254,12000000000,67050,204,74,106,0x9b9D659D4f2cF68b6616Cc0a65683f1951Eb725C,0x308bACc0c4Babd7DFF0427941fb9433824eE21ED
12813,15627917,84354,12000000000,84150,204,74,42,0x9b9D659D4f2cF68b6616Cc0a65683f1951Eb725C,0x360f76B95B1BF3914FAd762F2B9e7beD17D90613
12814,15627917,84354,12000000000,84150,204,74,40,0x9b9D659D4f2cF68b6616Cc0a65683f1951Eb725C,0x49039111608884e4E852d29B2D9c51a4ED72251e
12815,15627917,67254,12000000000,67050,204,74,81,0x9b9D659D4f2cF68b6616Cc0a65683f1951Eb725C,0x4802a5a84d23Bd886B978eec822Da2bc5971B49c
12816,15627917,67254,12000000000,67050,204,74,93,0x9b9D659D4f2cF68b6616Cc0a65683f1951Eb725C,0x6785F6F9f736B168492c0eC7e8Df9Be5A0f5322b
12817,15627917,67254,12000000000,67050,204,74,95,0x9b9D659D4f2cF68b6616Cc0a65683f1951Eb725C,0x0C32B2fbE36F6CaCaE010EFf9e8AEC712f7CDa6d
12818,15627917,67254,12000000000,67050,204,74,80,0x9b9D659D4f2cF68b6616Cc0a65683f1951Eb725C,0x5061Ff0938926C854AF12D1657B6Ac822546Dfc4
12819,15627917,67254,12000000000,67050,204,74,100,0x9b9D659D4f2cF68b6616Cc0a65683f1951Eb725C,0xB4f1826F944E6B891371eCa2319a1bdE842624BE
12820,15627917,67254,12000000000,67050,204,74,93,0x9b9D659D4f2cF68b6616Cc0a65683f1951Eb725C,0xCba4Ff22F56C909d3FD606bb57b6C75aA48F1B30
12821,15627917,84354,12000000000,84150,204,74,37,0x9b9D659D4f2cF68b6616Cc0a65683f1951Eb725C,0xc31D6b51a9f9B4B064D16432894bb8f228f17f89
12822,15627917,67254,12000000000,67050,204,74,102,0x9b9D659D4f2cF68b6616Cc0a65683f1951Eb725C,0x5b4068C24E00d522042924cBeC5952Fe146DF556
12823,15627917,84354,12000000000,84150,204,74,38,0x9b9D659D4f2cF68b6616Cc0a65683f1951Eb725C,0x57d6399672E5696c098fba7734634d4d065b69d4
12824,15627917,67254,12000000000,67050,204,74,90,0x9b9D659D4f2cF68b6616Cc0a65683f1951Eb725C,0x342111b74610994a6eD9a0e19fEf9B0041AE07Af
12825,15627917,67254,12000000000,67050,204,74,48,0x9b9D659D4f2cF68b6616Cc0a65683f1951Eb725C,0xFDb77d738Abd8DC53611226EFC09C11f0eBadB2b
12826,15627917,67254,12000000000,67050,204,74,97,0x9b9D659D4f2cF68b6616Cc0a65683f1951Eb725C,0xcA96CC95e5F714f9dDCe9531d2b5a1873a9C5B3B
12827,15627917,67254,12000000000,67050,204,74,98,0x9b9D659D4f2cF68b6616Cc0a65683f1951Eb725C,0x02F7d1e2Acb99330eD542d18fcbA665940681279
12828,15627917,67254,12000000000,67050,204,74,93,0x9b9D659D4f2cF68b6616Cc0a65683f1951Eb725C,0x0EfD9DF3389156B7Ed545ab2A569193e22c3d55f
12829,15627917,67254,12000000000,67050,204,74,98,0x9b9D659D4f2cF68b6616Cc0a65683f1951Eb725C,0xaBEBF6c4BeD54C352a4ce4fC9162B3374ca6880b
12830,15627917,84354,12000000000,84150,204,74,33,0x9b9D659D4f2cF68b6616Cc0a65683f1951Eb725C,0x7593f9e65e0371b4FfB34352012b06f82f47e7d3
12831,15627917,67254,12000000000,67050,204,74,30,0x9b9D659D4f2cF68b6616Cc0a65683f1951Eb725C,0xD53201419A0cFfA2d2ca48E8b285e309b90dDF6e
12832,15627917,67254,12000000000,67050,204,74,92,0x9b9D659D4f2cF68b6616Cc0a65683f1951Eb725C,0xAE37C4C57854f7aC6D054D64fb2226bD7fFfaa2C
12833,15627917,67254,12000000000,67050,204,74,73,0x9b9D659D4f2cF68b6616Cc0a65683f1951Eb725C,0x308a322e4F7dB2710313D788cfA5DA224Bf3fE71
12834,15627917,181476,11755489361,179912,1564,394,613,0x1Fa8559e873f698292766790AeCf8080A66433F6,0x77cCf05f28d6AB4F393606649E72EAC53A09D83C
12835,15627917,551388,11618981223,524412,26976,8594,6361,0x1111111254fb6c44bAC0beD2854e76F90643097d,0xCf58eaC3C7D16796Aea617a7E2461c99CaCDFf1D
12836,15627917,338745,11586489361,330005,8740,2314,302801,0x9D58779365B067D5D3fCc6e92d237aCd06F1e6a1,0xF27696C8BCa7D54D696189085Ae1283f59342fA6
12837,15627917,84000,11586489361,83368,632,138,17,0xA0b86991c6218b36c1d19D4a2e9Eb0cE3606eB48,0xfB9e4a36fE323ac3241a876C709b04E5678411CD
12838,15627917,21000,11586489361,21000,0,2,9142,0x6FF5ef76466c6ec11c1E5f582F49DB9dd48917d2,0xD86e3A116Bc98A354253dea47ffd36E86b1A1BC2
12839,15627917,21000,11586489361,21000,0,2,57309,0x165bB6Eb113bA57738da78cebf5ac713D51528A6,0xCfC0F98f30742B6d880f90155d4EbB885e55aB33
12840,15627917,116548,11585489361,116344,204,74,28,0xC549d87E9CEA28961927436a2B7D6944f7CA86eb,0x619f32C16797B4FC7ec6609A1de42BA7E77cd8E2
12841,15627917,184110,11585489361,177534,6576,1802,6,0x00000000006c3852cbEf3e08E8dF289169EdE581,0xd7dB838A13c52481EA6233A48DF090A06a51d6a8
12842,15627917,46185,11585489361,45697,488,138,119,0x9b3B6974531d8AA15A87908FFd821A64863Ede5B,0x252375fcCF631CCF9012a7c60acd6D6D37c4a02C
12843,15627917,60779,11585489361,53271,7508,2514,6,0x00000000006c3852cbEf3e08E8dF289169EdE581,0xFda13fFab1D19b97094580AFC05a8A7c1427e0cA
12844,15627917,145019,11585489361,138383,6636,1802,1179,0x00000000006c3852cbEf3e08E8dF289169EdE581,0x8175e7fB3672B9c02060F569cd0F59BCBc47c643
12845,15627917,75221,11585489361,74293,928,202,22,0x8AA0d86B9A7Dd09fFf4bF7C4f02ae47005C2F930,0xBae73D40b01D4Cb690381926E53Ca01EcD7f2071
12846,15627917,181476,11585489361,179912,1564,394,164,0x1Fa8559e873f698292766790AeCf8080A66433F6,0x5f3c2F785C6e180Acc1ff0389C92eAAb24c981b0
12847,15627917,21000,11585489361,21000,0,2,994,0x6709085463EbFb3Cc0B416596569e1f5eFB4DF87,0xcE75CE9885124c5fae732C5f51F41BBD876ED84d
12848,15627917,51964,11585489361,51012,952,202,140,0x346378C67d0F71343F80299ed8C0407aC2Df05eB,0x4872a6E29eC61B8f3Dc09B41a1f90C352Dc19BFf
12849,15627917,60763,11585489361,53271,7492,2506,5,0x00000000006c3852cbEf3e08E8dF289169EdE581,0x07b3103f8ECEEE53f233e58d6B4481EDab2784a1
12850,15627917,60760,11585489361,59816,944,138,26,0xA0b86991c6218b36c1d19D4a2e9Eb0cE3606eB48,0x8785Bd90b0d0ee06C8D33dF8Ccbf57BF5dBd7C0C
12851,15627917,251245,11585489361,244833,6412,1738,325,0x00000000006c3852cbEf3e08E8dF289169EdE581,0xc20b23462377bea7A7C1253057F8Ce1a74406Fcf
12852,15627917,21000,11585489361,21000,0,2,0,0x80e437971E638BaF56De90B08A5a41b2F2016D7d,0xb12Cdc0531E510A607537854401276c8560fAa7e
12853,15627917,243128,11585489361,218908,24220,8530,1628,0x00000000006c3852cbEf3e08E8dF289169EdE581,0x735Fb1B51D03B1230321693Aaf89e7D08476482e
12854,15627917,69145,11585489361,68549,596,138,4,0xdAC17F958D2ee523a2206206994597C13D831ec7,0x99336A9162dc473996E5E6B0cAe1A78773E171dF
12855,15627917,110590,11585489361,110386,204,74,0,0xd5dF338F6C32476ef2A3FB341416ddA981c0F310,0x4ebbb2fb847E30FF528C303840f7884D60403019
12856,15627917,237546,11585489361,192130,45416,13194,778,0x74312363e45DCaBA76c59ec49a7Aa8A65a67EeD3,0xCBb2534C6898655d50FDaC79D6E4B23b18a25B97
12857,15627917,55897,11585489361,54953,944,138,1,0x978cB8306E6ed25867d0E2A88E127aC5a681Ad1B,0x38834189F1F92BF15ad38DAe4cE58DBE52D28681
12858,15627917,21000,11585489361,21000,0,2,157,0xcC80747B1E603808f7f517C823AC37f96cfeabBb,0x01f4651c682Be1b7a554bac13E6917D44a04860C
12859,15627917,21000,11585489361,21000,0,2,443,0x26687033F470CF31D40D3BD42fDe9AC4BD6a53cc,0xacc71131DFADD1c658F11AAbEd9508559Ba55630
12860,15627917,97222,11585489361,82690,14532,4874,604,0x00000000006c3852cbEf3e08E8dF289169EdE581,0x7Ff9A10Ee542689f17da368a67F9092f5a7263b0
12861,15627917,812217,11585489361,781741,30476,9930,3944,0xaE9C73fd0Fd237c1c6f66FE009d24ce969e98704,0x0886A3B935DE1A05dd5067821d5a753656a607A2
12862,15627917,21000,11585489361,21000,0,2,4,0xc009705515E9F3915F4E51B461aBF7BDaDaDa883,0x5bcb2050eA9A300DbBd56093eaF696D3Bc617089
12863,15627917,83808,11585489361,83236,572,138,864,0x5CC5B05a8A13E3fBDB0BB9FcCd98D38e50F90c38,0x655C7eAdf9360603CB5077D8Dc57Fa07bCF61D55
12864,15627917,2812863,11585489361,2621171,191692,25720,510,,0x1f2414D0af8741Bc822dBc2f88069c2b2907a840
12865,15627917,21000,11585489361,21000,0,2,286,0xEf46CeADb2Ace25E5f6a677318778ac6BfeAf6E9,0x5abeEF2611AEB90e11761a88F0C828764e949C7e
12866,15627917,21000,11585489361,21000,0,2,547,0x3dbf7064e9403cf3Ed8e98A8F5338B43cd1Bc2bF,0x1FFcaf50205683234141D28aBFE5a5b3f75f2c5e
12867,15627917,181476,11585489361,179912,1564,394,860,0x1Fa8559e873f698292766790AeCf8080A66433F6,0x40e4CfBFCC0a518ff0dd77F4D326611BE341E123
12868,15627917,186597,11585489361,179997,6600,1802,77,0x00000000006c3852cbEf3e08E8dF289169EdE581,0xCDff08AC9084710035E87842FE0FF504483C84f2
12869,15627917,51406,11585489361,50918,488,138,80,0xAE060DC36b019c1F4789DA60360F84dB91603F6C,0x791B61E3198bcFBf83530073F89B896DA85C56CA
12870,15627917,104467,11585489361,101191,3276,1034,906,0x0000000000c2d145a2526bD8C716263bFeBe1A72,0x4248E7C9B1f45FC8C479eA9bE8db719c95B0dCA8
12871,15627917,21000,11585489361,21000,0,2,11,0xCBFE53Ea2a5CFb5e93aCEB6Fa81262Ac74016A8D,0x735B811D46aF95A4EE63512E9303c615df209e16
12872,15627917,46135,11585489361,45647,488,138,19,0x1Fa8559e873f698292766790AeCf8080A66433F6,0xee21b01B7e22CB9AaEBDd0167A4c7C7c1BE63c0f
12873,15627917,46685,11585489361,46197,488,138,24,0x0c537f8F6780628aFdf866E41A81d2ED97CFC8a2,0x2bfE28Ca41fb75e1B3ae5b5284AaF3fc13110935
12874,15627917,179312,11585489361,175708,3604,1162,63,0x68b3465833fb72A70ecDF485E0e4C7bD8665Fc45,0x64c952FBec6a6b16Ffd95eD728c21900337Aa8Cf
12875,15627917,163837,11585489361,163773,64,10,88,0x7d7B7A8f9DAEC5CC01C098d88c70e64C3913f0Ba,0xFd30CA22DFCC233874a14596614c53AAFCf2aD6E
12876,15627917,245900,11585489361,242284,3616,1162,4032,0x68b3465833fb72A70ecDF485E0e4C7bD8665Fc45,0x1541681a72632143E412e918dA772DEaDF6DbC76
12877,15627917,238934,11585489361,236162,2772,842,509,0x68b3465833fb72A70ecDF485E0e4C7bD8665Fc45,0x918403Accc9F319c724E9e57d016dbA8CA6c7aae
12878,15627917,21000,11585489361,21000,0,2,1458,0x4b30Ae101B305c6a7DfE26bD73F16CE832b04AB5,0xEAfAA1405A1BaC58D2C3dCefe6A07467Bcd7fEbE
12879,15627917,67254,11585489361,67050,204,74,42,0x9b9D659D4f2cF68b6616Cc0a65683f1951Eb725C,0xa04159bd2521f6d7Cd48083daD6c6c4D7dabCb7a
12880,15627917,21000,11585489361,21000,0,2,986,0x9Ad83e1fBBF7d4d86f5B395Be4002e8679314859,0xa04c72592849B57c6830B36C43f77faC9A7886B2
12881,15627917,100279,11585489361,99327,952,202,433,0x87b5D8fE6cF8b37678B6CeF7cca23a4852883C48,0x216A023E0c19382D895a66A76dd92E898c9BE3a7
12882,15627917,389460,11585489361,385844,3616,1162,122,0x68b3465833fb72A70ecDF485E0e4C7bD8665Fc45,0x1DCcF2f39cf7Afc76e74068C8d954e7F79e2b101
12883,15627917,61495,11585489361,53271,8224,2506,35,0x00000000006c3852cbEf3e08E8dF289169EdE581,0x4e80169Aed328c8375993c8F334b8F1C1Ae9f75B
12884,15627917,219642,11585489361,218870,772,202,772,0xcDA72070E455bb31C7690a170224Ce43623d0B6f,0x344A4c67Ee8AE84b89BCdE443F982C07AE5B1358
12885,15627917,190950,11585489361,187346,3604,1162,201,0x68b3465833fb72A70ecDF485E0e4C7bD8665Fc45,0x53Cdc87043681c669608ae9444fBB32c11E32e69
12886,15627917,21000,11585489361,21000,0,2,28,0x8fbD7F3d625Aa41c9730Db4915f0d71d66949965,0xd9b2392b8A72ED60421AE29aA254937c88eeBFc6
12887,15627917,198579,11585489361,192003,6576,1802,265,0x00000000006c3852cbEf3e08E8dF289169EdE581,0xc3c87912c081d990898113302F12afAc36DDAEf9
12888,15627917,232501,11265098486,227517,4984,1426,226,0x1111111254fb6c44bAC0beD2854e76F90643097d,0x8cdbaE227f436290035e292580E3e1081E0F669A
12889,15627917,163784,11085489361,157208,6576,1802,868,0x00000000006c3852cbEf3e08E8dF289169EdE581,0x8cc0a0C64e75e8082EBCe935EA8F51C9547DCe30
12890,15627917,87234,11085489361,87170,64,10,103,0xb55e1442EDA37d31249f97b3fCA6DEF588346FeF,0x22572EFe346CF77a8D95126B763E2B6fD7Cd3De0
12891,15627917,181476,11085489361,179912,1564,394,353,0x1Fa8559e873f698292766790AeCf8080A66433F6,0xfE0286d8EFc905Da0477D4BB9ce75A8D18C1Fa4E
12892,15627917,181476,11085489361,179912,1564,394,342,0x1Fa8559e873f698292766790AeCf8080A66433F6,0xE6ceF3226E19A5bBf2b4310A242AB1b9692E4A15
12893,15627917,21000,11085489361,21000,0,2,24,0x745FcA508F6b738a528b23d623c01Fa95F32dB66,0x8cb7382c9672f5D77d62726317C301eF2B267ece
12894,15627917,247215,11085489361,243999,3216,1034,474,0x68b3465833fb72A70ecDF485E0e4C7bD8665Fc45,0x2c7Ba425f07c11fc685fC4F4B82632f9782F4930
12895,15627917,181458,11085489361,179906,1552,394,486,0x1Fa8559e873f698292766790AeCf8080A66433F6,0x0f196E2Cd3bB7E61D900eE63f398CC229423117c
12896,15627917,181476,11085489361,179912,1564,394,410,0x1Fa8559e873f698292766790AeCf8080A66433F6,0xF24fB86d08fc4D2F2c3D5fe1cCd969b97Dd0fECB
12897,15627917,181476,11085489361,179912,1564,394,6,0x1Fa8559e873f698292766790AeCf8080A66433F6,0x41a3A352c03C36B42E4b542035969970903d8E74
12898,15627917,181476,11085489361,179912,1564,394,115,0x1Fa8559e873f698292766790AeCf8080A66433F6,0x029cB6fa08e50dA7D4736E87262De715B203FB05
12899,15627917,181476,11085489361,179912,1564,394,284,0x1Fa8559e873f698292766790AeCf8080A66433F6,0x6d14FEe3d3EAA9dF21F9B7011226AAA5A33F702a
12900,15627917,181476,11085489361,179912,1564,394,543,0x1Fa8559e873f698292766790AeCf8080A66433F6,0xEf82c093a0e6b94a94704fccD0b6df966A7833eB
12901,15627917,181476,11085489361,179912,1564,394,997,0x1Fa8559e873f698292766790AeCf8080A66433F6,0x6d3C1B048F45E008f3C205C292cdB21318865DD3
12902,15627917,181476,11085489361,179912,1564,394,167,0x1Fa8559e873f698292766790AeCf8080A66433F6,0x3CdABa566F3a5106035237aa8F69D46cF97bE3d3
12903,15627917,181476,11085489361,179912,1564,394,2048,0x1Fa8559e873f698292766790AeCf8080A66433F6,0xc29cFBF5BCdbA65996a25301DF67f9F5728931ee
12904,15627917,181476,11085489361,179912,1564,394,5817,0x1Fa8559e873f698292766790AeCf8080A66433F6,0x80A25bB487e89e79599c9ACAe6dbc6b8a5F1BCDc
12905,15627917,181476,11085489361,179912,1564,394,61,0x1Fa8559e873f698292766790AeCf8080A66433F6,0x1EC4c4C2A615302F1E9cC4b2b6F11F936c211404
12906,15627917,175110,11085489361,173546,1564,394,1092,0x1Fa8559e873f698292766790AeCf8080A66433F6,0xA7702a59E479BF6EF7b26d1b31d1835B1B0aB996
12907,15627917,181476,11085489361,179912,1564,394,72,0x1Fa8559e873f698292766790AeCf8080A66433F6,0xe87080F295c7A1e3E7308a7eced9AAcEE796A78B
12908,15627917,181476,11085489361,179912,1564,394,161,0x1Fa8559e873f698292766790AeCf8080A66433F6,0x220d6Ae81DcCD4D2bF52d30ECfbF06a6d0C72233
12909,15627917,67887,11085489361,66943,944,138,374,0xF63B34710400CAd3e044cFfDcAb00a0f32E33eCf,0x907206D1Fb31AeB9E36Fdc98CE09F5B088bE56bF
12910,15627917,181458,11085489361,179906,1552,394,1913,0x1Fa8559e873f698292766790AeCf8080A66433F6,0xb39a6B4cb933AAB3c30dA765aCF26c4C00a4bF11
12911,15627917,121018,11085489361,120446,572,138,50,0x1748B24faf9780B74E5A9f3Feb41553E712E94aa,0x6819eA7792CC89394fEEE84FC70d54a67cD0B765
12912,15627917,181476,11085489361,179912,1564,394,134,0x1Fa8559e873f698292766790AeCf8080A66433F6,0x3E2dB04A77359b39daeC28Ce9155DeA9d8Db16B5
12913,15627917,175110,11085489361,173546,1564,394,2,0x1Fa8559e873f698292766790AeCf8080A66433F6,0xe90FCD8046E03EB27B8E5B2CcA72B94a01767ce1
12914,15627917,181476,11085489361,179912,1564,394,1379,0x1Fa8559e873f698292766790AeCf8080A66433F6,0xA882fB71aA1967A6a8aa11375F8abd5FeE5BDD6a
12915,15627917,181476,11085489361,179912,1564,394,812,0x1Fa8559e873f698292766790AeCf8080A66433F6,0x96AbdBa824368eE3C8DeAdEaD045031Ab711e624
12916,15627917,453010,11085489361,430622,22388,7818,2594,0x00000000006c3852cbEf3e08E8dF289169EdE581,0x87375c43c6e95D2B1974662dC97e3ca25c3cd9a7
12917,15627917,271694,11000000000,269502,2192,522,2,0x7a250d5630B4cF539739dF2C5dAcb4c659F2488D,0xcf04A63F3e7F54c910a31bde33c98ccd4c6F6f4e
12918,15627917,160000,11000000000,159796,204,74,162,0xb967D2335A3879b7CAE42E085f88274EBff90Fc4,0xA35853E380A57A778f5D2FBA9B2EE4fD21298179
12919,15627917,200000,11000000000,199380,620,138,19,0x24cCeDEBF841544C9e6a62Af4E8c2fA6e5a46FdE,0x2D2CF70180a0f02D6Fb2921C46CD977033755D7C
12920,15627917,21000,11000000000,21000,0,2,171,0x387EB5232d64578b5689e21B90B0ABB51a3C24D1,0xcf8FDbc996331E684E3024f8528257D5402453b8
12921,15627917,80000,10957957911,79056,944,138,0,0xA0b86991c6218b36c1d19D4a2e9Eb0cE3606eB48,0x550862F6a513cEAdA5cc516e69219411Ac2dF119
12922,15627917,80000,10957957911,79056,944,138,0,0x6B175474E89094C44Da98b954EedeAC495271d0F,0x82C3FcE7B8beB04bc8Acb0C4a98AA80331FAC8Ae
12923,15627917,55951,10895591862,55007,944,138,1527,0xe4b4C008Ff36E3C50c4299c223504a480DE9C833,0xBb860FEe33B6B3a2b15E469ADB8Fd5Be240A6012
12924,15627917,252693,10895591862,252085,608,138,0,0x226bb599a12C826476e3A771454697EA52E9E220,0xAb0065817923a0a19e70De8D85a1D3df2354F3EF
12925,15627917,2359293,10634128753,2190529,168764,21600,0,,0x9Aee91055D78D5bA1E79631E342071ca7ee485d6
12926,15627917,300000,10533951052,299404,596,138,150330,0xdAC17F958D2ee523a2206206994597C13D831ec7,0x1C727a55eA3c11B0ab7D3a361Fe0F3C47cE6de5d
12927,15627917,216198,10533951052,214326,1872,458,1429,0xEfF92A263d31888d860bD50809A8D171709b7b1c,0x909CEFd055B2F2C8160a41a3031B24083AFd2cfD
12928,15627917,177811,10533951052,177187,624,266,231,0x806Bf9A1C54D76b86eD1C871e38C6d373CE6C809,0xC4B0dc090E87345151D1E486B5b8eb49aE4fFF2F
12929,15627917,339144,10533951052,335888,3256,778,546,0x6fBF1b6A681307f86c2d212f0f6Ad72621309eF1,0xE2B18fF370BF86CB4A7fF7ce2B93DcE225A5a951
12930,15627917,190693,10321411186,189753,940,202,7791,0x9d418C2Cae665D877F909a725402EbD3A0742844,0x8aE57A027c63fcA8070D1Bf38622321dE8004c67
12931,15627917,150000,10321411186,149392,608,138,4437,0xdAC17F958D2ee523a2206206994597C13D831ec7,0x2759bC7b8f9F2b47eEeFFB2f5751E0CFF3fF1aD8
12932,15627917,200000,10321411186,199392,608,138,1952,0xdAC17F958D2ee523a2206206994597C13D831ec7,0x6ffF07ccDdd39CD0CbeadeFAf470593e44070E59
12933,15627917,28556,10298029227,28492,64,10,9,0xda1f37F7d37bcE8ffc3Ef9188d853573236978E9,0x062d96Dfc60e90c2C40BBA382e3EbA9D3fB91901
12934,15627918,172818,10953586007,172082,736,130,10938,0xE8c060F8052E07423f71D445277c61AC5138A2e5,0x7944E84D18803f926743Fa56fb7A9bB9Ba5f5F24
12935,15627918,334944,15953586007,333036,1908,458,221,0x7a250d5630B4cF539739dF2C5dAcb4c659F2488D,0x11cE31192602A36f4203b264da3132D2a5A9BF17
12936,15627918,157059,430068929504,156003,1056,170,10939,0xE8c060F8052E07423f71D445277c61AC5138A2e5,0x7944E84D18803f926743Fa56fb7A9bB9Ba5f5F24
12937,15627918,203578,14675081177,202562,1016,138,2101,0x40Cd64cf6F2Ed6E86790FC39EDC3A91B91cb6d12,0x0ddFF0c42AAA6870CFd79D0050a0387134Aa5163
12938,15627918,250124,10953586007,247940,2184,650,106641,0xA69babEF1cA67A37Ffaf7a485DfFF3382056e78C,0x9AAb3F81604c683a1a0D14019FBfe15bef7aA1ee
12939,15627918,74963,12163588207,73115,1848,458,10042,0xFA103c21ea2DF71DFb92B0652F8B1D795e51cdEf,0x2E9c305B77EF39145aCdc4C30935a20C7b91aB66
12940,15627918,46458,12163588207,45514,944,138,2,0xE66b3AA360bB78468c00Bebe163630269DB3324F,0xe3A27465e6c966B8D91Bb3815A764Fa414231E24
12941,15627918,344527,12053587007,339603,4924,1420,3,0x881D40237659C251811CEC9c364ef91dC08D300C,0xe3A27465e6c966B8D91Bb3815A764Fa414231E24
12942,15627918,2000000,60953586007,1998176,1824,458,166,0x7a250d5630B4cF539739dF2C5dAcb4c659F2488D,0x3C2a7589f22f4cC06938d33aC80784c6aD784A2F
12943,15627918,250000,53000000000,250000,0,2,18573,0x2d574B46446F895c1AeAA746C1fFeC451Dafaf03,0x41b309236C87b1bc6FA8Eb865833E44158Fa991a
12944,15627918,21000,53000000000,21000,0,2,0,0xFe44DAeb65166846fccb3f4aA7186e36247b1C1E,0xe97d5419C74DB944B9307393dbC535372ae99026
12945,15627918,21000,45000000000,21000,0,2,25,0x069Acf904f610Cbf8ef1540349092852e46b4E95,0x4535be0b873D47Afa636B3Eb7804d1Ba40e74C5e
12946,15627918,21000,34500000000,21000,0,2,1005599,0xb2E09a7E5191e00A3deFcbEa7C932cBecB354F2f,0xc5a93444Cc4dA6EfB9e6FC6e5D3CB55A53b52396
12947,15627918,420000,33000000000,419344,656,138,2198556,0x4d224452801ACEd8B2F0aebE155379bb5D594381,0x6cC5F688a315f3dC28A7781717a9A798a59fDA7b
12948,15627918,90000,28321411186,90000,0,2,29108,0xEe9092312b9daB7A2a43632B2423ebb1D743924c,0xfa9f7a1cBfBCB688729c522b4F0905CcF4d26D25
12949,15627918,262841,25870000000,260805,2036,522,11,0x7a250d5630B4cF539739dF2C5dAcb4c659F2488D,0x948b6760d77Cd2D86e3C269de0897312a87A2C3F
12950,15627918,80000,21322122990,79392,608,138,17,0xdAC17F958D2ee523a2206206994597C13D831ec7,0x369f3C8c294cf53836BD9c545987003653435BC6
12951,15627918,85542,20000000000,84874,668,138,1362,0x321C2fE4446C7c963dc41Dd58879AF648838f98D,0xb615928b8545ED42F5699CA049fee81FE991CC2A
12952,15627918,50000,19026273555,50000,0,2,2188255,0x0d788F1EC3F1d94b3415570A9ed9Af94838ef125,0x75e89d5979E4f6Fba9F97c104c2F0AFB3F1dcB88
12953,15627918,5049560,17000000000,5042424,7136,1098,305,0x0a39DA505DfB5E0BBc6bd84428281A8ba1bC7753,0x495E889d1A6cEB447a57dcc1C68410299392380c
12954,15627918,96703,16953586007,95155,1548,458,19,0x0BABA1Ad5bE3a5C0a66E7ac838a129Bf948f1eA4,0x37FD6133282E53c09bdcBc5A4CC4251cD5962b86
12955,15627918,21000,16792611306,21000,0,2,1569077,0xb8bE8f2d7Bb8a309A3C85ca2474CA2a07018A52a,0xAe45a8240147E6179ec7c9f92c5A18F9a97B3fCA
12956,15627918,21000,16792611306,21000,0,2,1569078,0xBAd0880CaA4421E104BC09F2057405d8b792DA44,0xAe45a8240147E6179ec7c9f92c5A18F9a97B3fCA
12957,15627918,21000,16792611306,21000,0,2,1569079,0xd1C3a47798f84aAA3DFB4c021EFf7df83f6D1F2d,0xAe45a8240147E6179ec7c9f92c5A18F9a97B3fCA
12958,15627918,21000,16792611306,21000,0,2,1569080,0x8F2B3A434B746c55c5dba065d58C69c4dE35b161,0xAe45a8240147E6179ec7c9f92c5A18F9a97B3fCA
12959,15627918,21000,16792611306,21000,0,2,1569081,0x4A4d0975fC1064C0eB8C67E4819863A0386724A4,0xAe45a8240147E6179ec7c9f92c5A18F9a97B3fCA
12960,15627918,21000,16792611306,21000,0,2,1569082,0x29082A9D84D5c422f7d22f14219dca9708bA057E,0xAe45a8240147E6179ec7c9f92c5A18F9a97B3fCA
12961,15627918,21000,16792611306,21000,0,2,1569083,0x6918796Da11589dA97e68adF441c6EDe40F494ea,0xAe45a8240147E6179ec7c9f92c5A18F9a97B3fCA
12962,15627918,181476,16000000000,179912,1564,394,357,0x1Fa8559e873f698292766790AeCf8080A66433F6,0xE9c9477AAdA08bc570C34DBEd4EA93503D8B5302
12963,15627918,401930,16000000000,398338,3592,1162,2953,0x68b3465833fb72A70ecDF485E0e4C7bD8665Fc45,0x15Ea1b7C5402126435B2b02fc1AB6c556998B004
12964,15627918,21000,15953586007,21000,0,2,2699,0x79E3c80939134bE2437b24655127028D209A9E9B,0xE2f9fC75984516748405cC2c184Fc7cF1Be11026
12965,15627918,350000,15800926578,350000,0,2,6925085,0xDcc4fE65BE721472B91806C5DfAde28e114c0729,0x46340b20830761efd32832A74d7169B29FEB9758
12966,15627918,350000,15800926578,350000,0,2,6925086,0x40c6e42D992C64761846B52A643dEb16832B5Edf,0x46340b20830761efd32832A74d7169B29FEB9758
12967,15627918,350000,15800926578,349380,620,138,6925087,0xA0b73E1Ff0B80914AB6fe0444E65848C4C34450b,0x46340b20830761efd32832A74d7169B29FEB9758
12968,15627918,50000,15290853994,50000,0,2,1210294,0xe3a0e7d0d320ecb66b936A7D3B00F6A9Ee18DAbd,0x912fD21d7a69678227fE6d08C64222Db41477bA0
12969,15627918,181476,15000000000,179912,1564,394,484,0x1Fa8559e873f698292766790AeCf8080A66433F6,0x112F5c6B85D5dF1594DE75E5Cc655dD011e61d78
12970,15627918,181476,14953586007,179912,1564,394,361,0x1Fa8559e873f698292766790AeCf8080A66433F6,0x200E480FE45C711DBe2fc663E1aD20fdB52e5C5d
12971,15627918,500000,14953586007,498632,1368,266,141512,0xb8901acB165ed027E32754E0FFe830802919727f,0x710bDa329b2a6224E4B44833DE30F38E7f81d564
12972,15627918,181476,14953586007,179912,1564,394,51,0x1Fa8559e873f698292766790AeCf8080A66433F6,0x7e64E4548eE744954b417c147505D26cb2e65619
12973,15627918,181476,14953586007,179912,1564,394,107,0x1Fa8559e873f698292766790AeCf8080A66433F6,0x6bb2F935e0D990773f95cd9DbeF4b639F2A29c50
12974,15627918,77419,14863586007,76763,656,138,4709955,0x4Fabb145d64652a948d72533023f6E7A623C7C53,0x2FAF487A4414Fe77e2327F0bf4AE2a264a776AD2
12975,15627918,83162,14863586007,82554,608,138,4709956,0xaaAEBE6Fe48E54f431b0C390CfaF0b017d09D42d,0x2FAF487A4414Fe77e2327F0bf4AE2a264a776AD2
12976,15627918,63000,14855598151,63000,0,2,2710068,0x30EF80845EeDcbcEeDA4ff64854069F40697CF08,0xC098B2a3Aa256D2140208C3de6543aAEf5cd3A94
12977,15627918,63000,14855598151,63000,0,2,2710069,0x816000Cd76d2b1b0e1Eb3fdc52e7edc1629c5e99,0xC098B2a3Aa256D2140208C3de6543aAEf5cd3A94
12978,15627918,63000,14863586007,63000,0,2,2710070,0x736021eabE2Fc397971Fa015dD90674194c81801,0xC098B2a3Aa256D2140208C3de6543aAEf5cd3A94
12979,15627918,115231,14831528266,114527,704,138,6,0xA3E059c0b01F07F211c85bF7b4f1d907AfB011df,0xe9292bFD1AaB4e689E3C87723912A9F1d85c849a
12980,15627918,104819,14236886458,104035,784,202,186,0x8f9c03411Ed4DCf742aAeC58330D7028f28b90DC,0x6a6134eb5eD4ae4BbbdffB0709062F31eE1d5Fce
12981,15627918,181476,14000000000,179912,1564,394,7439,0x1Fa8559e873f698292766790AeCf8080A66433F6,0xE91C4eC4a439Ec9d6b11ef8d1dF11B35142df7C9
12982,15627918,122429,13953586007,121677,752,138,192818,0xDBd324B73f6f85bf9013B75C442021303b635Ff9,0x19f494583c7C933be7B0eE58104DDaFac1E8aDfA
12983,15627918,181476,13953586007,179912,1564,394,331,0x1Fa8559e873f698292766790AeCf8080A66433F6,0x4a942EAe8bDEf1398278C152242baa5671838204
12984,15627918,69884,13953586007,68940,944,138,127,0x6274f70C1C366Fff461245d5a900D962B2F32cf7,0x49B30b829B2DF81C87E918dE9c1d40216f160c40
12985,15627918,69872,13953586007,68928,944,138,952,0xFDBf91A7F2d757A9815326af5E1e60319571984c,0x5E32dc9E56CFa0Ec2AAd724Bb564d8D9F9364382
12986,15627918,181476,13953586007,179912,1564,394,1014,0x1Fa8559e873f698292766790AeCf8080A66433F6,0x343562858619136D77718c19AF87289758f43AF4
12987,15627918,341064,13867384842,310272,30792,5450,4,0xA0c68C638235ee32657e8f720a23ceC1bFc77C77,0x1B5F0fe9F237D9571AA50997e967fF386F052927
12988,15627918,275883,13544303208,273503,2380,586,47,0x53e0e51b5Ed9202110D7Ecd637A4581db8b9879F,0x02c841947FFcBB2F124Bc4a2D9eF298eC792CebC
12989,15627918,92856,13453586007,92284,572,138,3,0x7E59A6D7F024863451612b48b070F5fE1B1Ed7c0,0x6B6dc6886A4Bb4fa3091089f0E2d0E29a8c8e150
12990,15627918,109660,13453586007,109456,204,74,2405,0x9b9D659D4f2cF68b6616Cc0a65683f1951Eb725C,0x74456CF397975601D7924Ee113BdA64F9024EFaB
12991,15627918,104926,13453586007,104722,204,74,159,0x3F20958d3F58aa4f3c14c9350976721A0ACAC440,0x6AAEFd3B20aC8beA99a884Ca031694aBF0084597
12992,15627918,156856,13000000000,156652,204,74,7,0x928bBD403acAfF9D73bBc1C6856215B01e9cac6F,0x04Ef3980187CFa014b282be0A3cbaC861B2Aea22
12993,15627918,167598,12953586007,164826,2772,842,923,0x68b3465833fb72A70ecDF485E0e4C7bD8665Fc45,0x5C7ca6A93a46aE786D99D91ED423A91d6fa13879
12994,15627918,500000,12953586007,498272,1728,458,542324,0xa24787320ede4CC19D800bf87B41Ab9539c4dA9D,0xAe2D4617c862309A3d75A0fFB358c7a5009c673F
12995,15627918,500000,12953586007,498260,1740,458,1262744,0xa24787320ede4CC19D800bf87B41Ab9539c4dA9D,0x89e51fA8CA5D66cd220bAed62ED01e8951aa7c40
12996,15627918,130000,12953586007,129512,488,138,2154,0x1Fa8559e873f698292766790AeCf8080A66433F6,0x22e091333Eed4FD5Ec370992592B2A70E6042Ada
12997,15627918,181476,12953586007,179912,1564,394,205,0x1Fa8559e873f698292766790AeCf8080A66433F6,0xAE6f9bbE4215865337f70F4c9677a4436aDd895b
12998,15627918,36015,12953586007,35751,264,74,1711,0xC02aaA39b223FE8D0A0e5C4F27eAD9083C756Cc2,0x9f82f46FCaeBE047BF0108e74eb8f7f2E1c0bC68
12999,15627918,50000,12953586007,49056,944,138,0,0xdAC17F958D2ee523a2206206994597C13D831ec7,0xda04C3386Ab0666e3eD1538A8c0f619487f5F36C
13000,15627918,46517,12953586007,45573,944,138,1009,0x4b520c812E8430659FC9f12f6d0c39026C83588D,0x40C52A227713F95Df575E0baF4A186025F1909E4
13001,15627918,249480,12953586007,244152,5328,1484,1010,0x881D40237659C251811CEC9c364ef91dC08D300C,0x40C52A227713F95Df575E0baF4A186025F1909E4
13002,15627918,21000,12953586007,21000,0,2,7,0xF710d23fA1C4055D2e8b33c50D7C41d48775339C,0x72a4FBf5cF07dF624e979904Fc9214e2adEa3a27
13003,15627918,181476,12953586007,179912,1564,394,0,0x1Fa8559e873f698292766790AeCf8080A66433F6,0x74ab7F2f8BfbEA54D12Dc5bf18e2bc4F3aa3a4be
13004,15627918,181458,12953586007,179906,1552,394,118,0x1Fa8559e873f698292766790AeCf8080A66433F6,0x756270D45193d0196472DC5913ADd1C0eD28cb83
13005,15627918,21000,12953586007,21000,0,2,4,0x6428eBE5929D96fEba8D2Fb5B8956624e23820f2,0x4C6Ee0F12aD88303dF32E727B4451550FD3C26c9
13006,15627918,90000,12953586007,89404,596,138,93932,0xdAC17F958D2ee523a2206206994597C13D831ec7,0xf89d7b9c864f589bbF53a82105107622B35EaA40
13007,15627918,122577,12953586007,121013,1564,394,90,0x1Fa8559e873f698292766790AeCf8080A66433F6,0xFd0F0db4AE5ECA9E54c412dD606371B7E8aF3bF9
13008,15627918,122577,12953586007,121013,1564,394,93,0x1Fa8559e873f698292766790AeCf8080A66433F6,0xfB4d2024F32f4b7d1D8B292442F8e4CF7517e5D0
13009,15627918,122577,12953586007,121013,1564,394,90,0x1Fa8559e873f698292766790AeCf8080A66433F6,0x4c4713406849fffbCF2E2f7fb2E8166F83F682d2
13010,15627918,122577,12953586007,121013,1564,394,94,0x1Fa8559e873f698292766790AeCf8080A66433F6,0x12CB8a5d01763D81866BD399eDe11FF3342626C8
13011,15627918,49542,12953586007,49478,64,10,564,0xC02aaA39b223FE8D0A0e5C4F27eAD9083C756Cc2,0xDF7E27dB0888238226E6e7cf8224749FFE5F9768
13012,15627918,122577,12953586007,121013,1564,394,98,0x1Fa8559e873f698292766790AeCf8080A66433F6,0x932D7C7EE0d1e30f103894fb71Da0EAb964C09d5
13013,15627918,122577,12953586007,121013,1564,394,107,0x1Fa8559e873f698292766790AeCf8080A66433F6,0x8F4eD305d1F7611a04072960ca903237e023ACd0
13014,15627918,122577,12953586007,121013,1564,394,110,0x1Fa8559e873f698292766790AeCf8080A66433F6,0x5Ff30475e05882a45eFd1C2297Af62eAfD0420A2
13015,15627918,181458,12953586007,179906,1552,394,160,0x1Fa8559e873f698292766790AeCf8080A66433F6,0xd8009A620696E9C065E13359Fb170B0fe0BDeE29
13016,15627918,122577,12953586007,121013,1564,394,112,0x1Fa8559e873f698292766790AeCf8080A66433F6,0xcb7C3528c939e69D7CaF8fdfc28859a337232d46
13017,15627918,54022,12953586007,53758,264,74,32,0xC02aaA39b223FE8D0A0e5C4F27eAD9083C756Cc2,0xC3Ff40AC92645D01aFb4485d38800A09E572b740
13018,15627918,55932,12953586007,54988,944,138,483,0xEe0A7622CeD485E02d9f9ed66acEd59122c05E45,0x8764885033215F2fdfE7A2CF3a6430E14FA5BdB2
13019,15627918,56659,12953586007,55715,944,138,105,0xAD13C2a8d418d01F3236F4d8b9d724575a4e9d24,0x98aaf9BfbE917abdb2481543F0f46343F3f54C2E
13020,15627918,90000,12953586007,89392,608,138,93933,0xdAC17F958D2ee523a2206206994597C13D831ec7,0xf89d7b9c864f589bbF53a82105107622B35EaA40
13021,15627918,122577,12953586007,121013,1564,394,115,0x1Fa8559e873f698292766790AeCf8080A66433F6,0x1556Ca3fdF5BC5E1e72018AAe75a47264103809e
13022,15627918,48780,12953586007,48184,596,138,4,0xA0b86991c6218b36c1d19D4a2e9Eb0cE3606eB48,0x6eE33e145C0f8cC86D9630A915efd30Ec33312B9
13023,15627918,46109,12953586007,45501,608,138,35,0xdAC17F958D2ee523a2206206994597C13D831ec7,0x7f323f2bA367FeA1C0C61Afeb677132CE014E662
13024,15627918,34819,12953586007,34127,692,138,10528,0x95aD61b0a150d79219dCF64E1E6Cc01f0B64C4cE,0xA850B2ADe716017814d5cD8B9345EB4b33FeCE31
13025,15627918,46121,12953586007,45501,620,138,1,0xdAC17F958D2ee523a2206206994597C13D831ec7,0x65eBE6e591f5ACe20D59686FFaF40D937FA9240F
13026,15627918,34832,12953586007,34212,620,138,0,0x15D4c048F83bd7e37d49eA4C83a07267Ec4203dA,0x9f8FA959fCa0b76D0B70CAC667c29f88e90381c8
13027,15627918,34881,12953586007,34213,668,138,0,0x4a220E6096B25EADb88358cb44068A3248254675,0x5eaF17f3Da46eD21047e52f54736BB4bAC125749
13028,15627918,21000,12953586007,21000,0,2,1211352,0x779F5286d1C421e8BD5A111cbB9A3bB1C41e2EB5,0x95A9bd206aE52C4BA8EecFc93d18EACDd41C88CC
13029,15627918,2000000,12953586007,1988012,11988,2762,171064,0xA9D1e08C7793af67e9d92fe308d5697FB81d3E43,0x7830c87C02e56AFf27FA8Ab1241711331FA86F43
13030,15627918,34529,12953586007,33873,656,138,50,0xBB0E17EF65F82Ab018d8EDd776e8DD940327B28b,0x3aAb510A686966E9E57A0734E0F63Ae588a284a2
13031,15627918,46109,12953586007,45501,608,138,25,0xdAC17F958D2ee523a2206206994597C13D831ec7,0x095E9325c7Aa403c1aBf8d81D1aE15b842E79c7A
13032,15627918,21000,12953586007,21000,0,2,52388,0xA2eC1d763Ee64400a172414D12F792824d7fDc43,0x7c195D981AbFdC3DDecd2ca0Fed0958430488e34
13033,15627918,2000000,12953586007,1994836,5164,1162,171065,0xA9D1e08C7793af67e9d92fe308d5697FB81d3E43,0x7830c87C02e56AFf27FA8Ab1241711331FA86F43
13034,15627918,21000,12953586007,21000,0,2,1211353,0x513aC8D8baa0998E7B2b029fD07532A5ed30d00C,0x95A9bd206aE52C4BA8EecFc93d18EACDd41C88CC
13035,15627918,243756,12953586007,241896,1860,458,215,0x7a250d5630B4cF539739dF2C5dAcb4c659F2488D,0x1701be5b892164c6d8443b76B59d9aFb3ED522f6
13036,15627918,122446,12953586007,120882,1564,394,585,0x1Fa8559e873f698292766790AeCf8080A66433F6,0xbe358587cCFae29891022C66A13F8a9868cd4CC7
13037,15627918,21000,12953586007,21000,0,2,7100809,0x2Eb9CA8c65D45729488C77a2295EB811ee1cFAB0,0xddfAbCdc4D8FfC6d5beaf154f18B778f892A0740
13038,15627918,21000,12953586007,21000,0,2,1211354,0x7f21b439392CbF4146983fFA9D78Cf8aC4113180,0x95A9bd206aE52C4BA8EecFc93d18EACDd41C88CC
13039,15627918,207128,12953586007,207128,0,2,3492298,0x3a217cE0eDb40218537C500B05090b2f81622818,0x56Eddb7aa87536c09CCc2793473599fD21A8b17F
13040,15627918,42000,12953586007,42000,0,2,329570,0x3b598B18eE522Be7425c0c92dD135C7d7D737d15,0x9430801EBAf509Ad49202aaBC5F5Bc6fd8A3dAf8
13041,15627918,287505,12953586007,283281,4224,1418,8,0xc30141B657f4216252dc59Af2e7CdB9D8792e1B0,0xd075155b1dA63ff3809FbE4BAa3f705C95c3991e
13042,15627918,45018,12953586007,44754,264,74,484,0xC02aaA39b223FE8D0A0e5C4F27eAD9083C756Cc2,0x50c7AA78B01Eb084a0bC3ad94A2C8DAFC65D91bC
13043,15627918,55953,12953586007,55009,944,138,250,0xD371cE2BeB6b24195E790C561e4d86DD745E3c49,0xc400EE704477fDb6f54b5CD95E5c878678D64282
13044,15627918,528691,12953586007,525075,3616,1162,2462,0x68b3465833fb72A70ecDF485E0e4C7bD8665Fc45,0x0069f94C6Ef196cf54b2f0746dE92D40a83D41A5
13045,15627918,181476,12953586007,179912,1564,394,275,0x1Fa8559e873f698292766790AeCf8080A66433F6,0x073b7993d04835Ca17cDe15ab6323876e6aFBb93
13046,15627918,39630,12953586007,39354,276,74,320,0xC02aaA39b223FE8D0A0e5C4F27eAD9083C756Cc2,0x40385AdA31A8D236e6026B0dD6A66768B9654840
13047,15627918,21000,12910000000,21000,0,2,705899,0x0F9539B9Cb59e7DA18521e63840AD30cd4aDFe47,0x6dfc34609a05bC22319fA4Cce1d1E2929548c0D7
13048,15627918,139243,12563586007,136943,2300,594,1199,0xDef1C0ded9bec7F1a1670819833240f027b25EfF,0x1700749308F542BEd70728C47f62a7ad71B79869
13049,15627918,34224,12500000000,33580,644,138,4,0x3845badAde8e6dFF049820680d1F14bD3903a5d0,0x608D46CE5f5B04c88D8801E8c3ccc6d40a108a4E
13050,15627918,39916,12500000000,39260,656,138,1,0x321C2fE4446C7c963dc41Dd58879AF648838f98D,0xAa37f3FDBdd320dd065FEE9ac7cdB99C07367CEa
13051,15627918,120000,12454586007,119392,608,138,57310,0xdAC17F958D2ee523a2206206994597C13D831ec7,0xCfC0F98f30742B6d880f90155d4EbB885e55aB33
13052,15627918,44096,12454335289,43452,644,138,99,0xDaa58A1851672a6490E2bb9Fdc8868918cDd86e6,0xe7A43a8b6817304e64023a4d0df074242D704c58
13053,15627918,21000,12453586007,21000,0,2,533,0x6aC20BF955649752F7a7797A4BC98FBAA1e9af8D,0xd50d8df8f5aD747899B8b23fa0dC1c166c82dE12
13054,15627918,58676,12453586007,57732,944,138,593,0xdAC17F958D2ee523a2206206994597C13D831ec7,0xCa1eE57390f16B67855D200Cebf59804277a9DDd
13055,15627918,94813,12453586007,94205,608,138,206,0xdAC17F958D2ee523a2206206994597C13D831ec7,0xD1C5a4445dB5273af5b44C30C99b86e120abB243
13056,15627918,343209,12453586007,336281,6928,970,1004,0x67f57d9C4dc6fbEE423B15B6bBe488c3896AfBc3,0xEd03c484f4e22095CA89BF41c2eb2c4B23a443bD
13057,15627918,55950,12453586007,55006,944,138,370,0x6097004C68F7B350d72226003226Ac089597D579,0x94e3047aE5bbce0039B19b264120Ee9A350c7875
13058,15627918,46729,12453586007,46241,488,138,269,0x4503e3C58377a9d2A9ec3c9eD42a8a6a241Cb4e2,0x73c0E52d54b4fF57deDCFdc8003e3C2f734486df
13059,15627918,21000,12453586007,21000,0,2,3,0x129EF75EA740e6A2650a83Ff494B6D8db5bBC3B6,0x563156041712E9486240Ca9618b3EbB0408886Ae
13060,15627918,61749,12453586007,60497,1252,202,1,0x5FDCCA53617f4d2b9134B29090C87D01058e27e9,0xa516B3825ab8626711Cb1d6F631a0Ed67189EECA
13061,15627918,21000,12453586007,21000,0,2,421,0xC3de2D9a9162F527B3618b5895De2f6AA7436c17,0x370318A773705B314D68f4d82cf4cc12D07B5E9e
13062,15627918,21000,12453586007,21000,0,2,285,0x713107703Ffba2C29ACCCfdB26548Fec7EDCE1A6,0xf74e644D030D378Ce753FC45A5d4b0aF06E5d0E5
13063,15627918,21000,12453586007,21000,0,2,107,0x2A9Ca05cf2dBB1Ea2b71876258322A21783E78a7,0xf6e9b43969f52021bC920c635df3933bC01aB52c
13064,15627918,616335,12453586007,570279,46056,16082,580,0x00000000006c3852cbEf3e08E8dF289169EdE581,0x0db7b27b7A3Ea8035D3F66F3ba7532221eF06abE
13065,15627918,77393,12453586007,76749,644,138,18,0xae7ab96520DE3A18E5e111B5EaAb095312D7fE84,0x31437e500Ead4285A717f5F23017a05450FCb1c1
13066,15627918,257863,12453586007,257179,684,266,146,0xbEbc44782C7dB0a1A60Cb6fe97d0b483032FF1C7,0x93750D820cA511BCf9d98bE98FB011bE5703CcAe
13067,15627918,21000,12453586007,21000,0,2,16,0xA1A252e4e9B8dfaE6b58C6C88a04791dc6B9E558,0xCcB85037D536731CEf4DE24E16EE9A87E0718d21
13068,15627918,46135,12453586007,45647,488,138,428,0x1Fa8559e873f698292766790AeCf8080A66433F6,0x9bCF50d39D15b15623E3A57628E3CEAD75890207
13069,15627918,181458,12453586007,179906,1552,394,138,0x1Fa8559e873f698292766790AeCf8080A66433F6,0x66B4cFd9BC14a9164B6DeD9200864Cf0a88ac719
13070,15627918,60739,12453586007,53271,7468,2506,23,0x00000000006c3852cbEf3e08E8dF289169EdE581,0x4243b6CEb2E6e7d4cBe4BcF93eB9bD3e8F943423
13071,15627918,99226,12453586007,98630,596,138,133,0xA0b86991c6218b36c1d19D4a2e9Eb0cE3606eB48,0x514A2a2953CfEF46d67dA516d3660406fDE5c445
13072,15627918,46103,12453586007,45615,488,138,91,0x346378C67d0F71343F80299ed8C0407aC2Df05eB,0xE8996228b2A7A7937AF6eCB2bee5b99bAba6aF3c
13073,15627918,132253,12453586007,125921,6332,1674,245,0x00000000006c3852cbEf3e08E8dF289169EdE581,0x941B4c03446EaC02902C30554EC683BaB3d40ff9
13074,15627918,55950,12453586007,55006,944,138,463,0x6097004C68F7B350d72226003226Ac089597D579,0x87eaA58fEF2C5180e48152E1E469E90bFb3e7b9C
13075,15627918,402996,12453586007,378884,24112,8530,7,0x00000000006c3852cbEf3e08E8dF289169EdE581,0x10a144587E3B45B15bE09c475D8E0e609d31d3D2
13076,15627918,175021,12453586007,171321,3700,1162,315,0x68b3465833fb72A70ecDF485E0e4C7bD8665Fc45,0x3d0A26d8f6c5Ca6bd1e1081D0E686203f5D6B03B
13077,15627918,185679,12453586007,182039,3640,1162,13,0x68b3465833fb72A70ecDF485E0e4C7bD8665Fc45,0xf5233063cE767a450c8140558F090a13A139Efcc
13078,15627918,46135,12453586007,45647,488,138,1025,0x1Fa8559e873f698292766790AeCf8080A66433F6,0xFF37CB274E6C7eEBc8d95ae266A782E87AbF5cb4
13079,15627918,46103,12453586007,45615,488,138,60,0x346378C67d0F71343F80299ed8C0407aC2Df05eB,0x36EF597c32A1c77904c7F373e1Ed6AB959331449
13080,15627918,60727,12453586007,53271,7456,2506,79,0x00000000006c3852cbEf3e08E8dF289169EdE581,0x4333132E5e13BBBf8e1CF17fb93fCd1c61AB6e17
13081,15627918,144983,12453586007,138383,6600,1802,291,0x00000000006c3852cbEf3e08E8dF289169EdE581,0x0E327c85FBCf3e200a1b11Ba2D87e21834185cB2
13082,15627918,282970,12453586007,282706,264,74,18,0x6a9f9d6F5D672a9784c5E560a9648de6cbe2c548,0xaaFA6b898A43b61F576bc71513A0ac23Ca0220b7
13083,15627918,21000,12453586007,21000,0,2,1346,0x6B4dE1bDc47cBD389312E5eeFC46F17aC20e1f34,0x45E204d04fDA4AD85840454Abcf1d1Be4361Bf43
13084,15627918,180503,12453586007,173915,6588,1802,971,0x00000000006c3852cbEf3e08E8dF289169EdE581,0x6483AFa117fD0c334f2A6D8D64149cf84FDd1dB2
13085,15627918,273160,12453586007,270412,2748,842,2060,0x68b3465833fb72A70ecDF485E0e4C7bD8665Fc45,0x3461F903D434CCf3684D6f82d9F8833799Da177c
13086,15627918,21000,12453586007,21000,0,2,97,0xFa265F1B164Ce2311D180a052EF77840462D090D,0x8B2DaEB8D65be8d7Bf0d852c17BdfaF50897d039
13087,15627918,50706,12453586007,50110,596,138,10,0xdAC17F958D2ee523a2206206994597C13D831ec7,0xd192E0e9dD9710D63DE2D591CC08aC648Ca173fe
13088,15627918,21000,12453586007,21000,0,2,14,0xC898bdC6AdF265B327082AF1e097F77F0286F41e,0xc6009b64b0d52113C012F2616Ce81BBe4d33b3FF
13089,15627918,29104,12453586007,28628,476,138,323,0x19b86299c21505cdf59cE63740B240A9C822b5E4,0xa4606Bb11264E40A912dD4cde577986013562d23
13090,15627918,28974,12453586007,28414,560,138,495,0x6B175474E89094C44Da98b954EedeAC495271d0F,0x2EceCf5a33d038694133BbF3A22AEAFBc96d4B04
13091,15627918,280004,12453586007,276724,3280,970,8,0x68b3465833fb72A70ecDF485E0e4C7bD8665Fc45,0x6CeA873B5b556A6f572A14F8ed339306A02d9B54
13092,15627918,122512,12453586007,121264,1248,458,22,0x4e32004D8b81847A670b4a1778ACe4dCF2bBA01E,0x030ce9d143332f6D9c287414f08e22c145c43c58
13093,15627918,144565,12453586007,137953,6612,1802,115,0x00000000006c3852cbEf3e08E8dF289169EdE581,0x3bEb5Fb5771EE6a53284E54a744c9e28bf4b2C4B
13094,15627918,21000,12453586007,21000,0,2,38,0x804aD65e9197FE534D3Bf5E7CFE40aB42444A554,0x4D2826C0d88D7d130A1C80Ac038B703fE6Ec73D4
13095,15627918,181476,12453586007,179912,1564,394,249,0x1Fa8559e873f698292766790AeCf8080A66433F6,0x1de90BD69cBBab9FC4845B2ea2d6B68Ab8b624Ba
13096,15627918,21000,12453586007,21000,0,2,108,0x40b8fD1b61b6644717D2400096077b3a4f677619,0xf6e9b43969f52021bC920c635df3933bC01aB52c
13097,15627918,181476,12453586007,179912,1564,394,737,0x1Fa8559e873f698292766790AeCf8080A66433F6,0x3bc232768C62eA03ED2cbDc9315223d1dF820f64
13098,15627918,86349,12453586007,86145,204,74,85,0x55f1C36Bb7aE0d7D6caE97902E30A2306686Ec73,0x9265aeB370B730e69C2706cf0b11CC3756A1D90B
13099,15627918,61879,12453586007,53271,8608,2506,920,0x00000000006c3852cbEf3e08E8dF289169EdE581,0x824C3b8713D4080B2F42c992eC3250CdF2616d34
13100,15627918,99226,12453586007,98630,596,138,6,0xA0b86991c6218b36c1d19D4a2e9Eb0cE3606eB48,0x539d8E3250a6955336c413d440FE3BBb7B9B13ee
13101,15627918,181440,12453586007,179900,1540,394,170,0x1Fa8559e873f698292766790AeCf8080A66433F6,0x86C07dC5f35357b835061623990800814D358183
13102,15627918,46685,12453586007,46197,488,138,399,0xEF9c21e3Ba31a74910fc7e7cB3fc814AD842AD6e,0x7b15428169f5C5579Ea2159c4079Ab189c16bCeF
13103,15627918,436676,12453586007,411648,25028,3678,511,,0x1f2414D0af8741Bc822dBc2f88069c2b2907a840
13104,15627918,83184,12453586007,82232,952,202,1782,0xD73ACd7F5099fdd910215Dbff029185F21ffBCf0,0xB972C02761e51C9C502636c5DBF56635b41c1C26
13105,15627918,122446,12453586007,120882,1564,394,378,0x1Fa8559e873f698292766790AeCf8080A66433F6,0x092AC7F06be7e2a4Dd1Bc49D0F6F44a08CAC12f1
13106,15627918,49175,12453586007,48687,488,138,445,0x7f738Ad7072187909384B2ffBaEEdC3C1DA1b686,0x0B9db020472EFc722Da08a7dC50f3Abe3BE8bC29
13107,15627918,21000,12453586007,21000,0,2,42,0x54f061893247E57527bb92517f58e25c2B652AFD,0x860cFec6FF3b3fF45078cc6F48668028C61403A7
13108,15627918,832528,12453586007,814812,17716,2314,443,0x000000000000509081d6FCD3ee63e791aD1db763,0xdEa4766BB96f93f637808492285BE15BEAF3c2b3
13109,15627918,74603,12453586007,73663,940,202,235,0x7f738Ad7072187909384B2ffBaEEdC3C1DA1b686,0x2fAE61c7b7e0c073a69Fe687CE977Ac33565F9AD
13110,15627918,46793,12453586007,46305,488,138,91,0xeC516eFECd8276Efc608EcD958a4eAB8618c61e8,0x7a48bF4Ac1AB4D793eA297335CC561D80443EaE3
13111,15627918,51406,12453586007,50918,488,138,123,0x724739CEB3945b8CA946cC692F6eE58096f1634b,0xadBa39a4D993F5d8846505B63F701c944E5DF1c2
13112,15627918,227700,12453586007,224964,2736,842,798,0x68b3465833fb72A70ecDF485E0e4C7bD8665Fc45,0x6953Ba87386bD829F800C533D73264BFA5d43D6D
13113,15627918,21000,12453586007,21000,0,2,12,0x129EF75EA740e6A2650a83Ff494B6D8db5bBC3B6,0xe21de9ee3570EAFf172cDBa2Ca44d18C383E74d7
13114,15627918,21000,12453586007,21000,0,2,36,0x4818F19A7B6912aeF8F431eEf0601C72408Fa979,0xfB7C4FE356c119E460Efb5B509C6902320a595Fc
13115,15627918,46682,12453586007,46194,488,138,64,0x67df41EDf21e1c581A77E939f60db7bAa5E96993,0xBeEa584B3F032D0cA801202832E731d6F53C1A79
13116,15627918,21000,12321411186,21000,0,2,1,0xb833A1A13c33212566E633eD62D5A67A43D39b04,0x855988454830056Ac57Dd2cDB507E4063c4E1018
13117,15627918,181476,12053586007,179912,1564,394,174,0x1Fa8559e873f698292766790AeCf8080A66433F6,0x40b7E83c0e342d09525b108576c894D4aD0FA2E3
13118,15627918,67254,12000000000,67050,204,74,10,0x9b9D659D4f2cF68b6616Cc0a65683f1951Eb725C,0x14CF7B3bce8C88BF88A7960bc591D7482F5cC97f
13119,15627918,85794,12000000000,84842,952,202,66,0x1Fa8559e873f698292766790AeCf8080A66433F6,0xcd8D0c3668b46cBd61F5Dcedaab0e52E01561A3c
13120,15627918,85794,12000000000,84842,952,202,67,0x1Fa8559e873f698292766790AeCf8080A66433F6,0xbb6916F4Ad547F369C74C058c1A2dC693a79cb02
13121,15627918,85794,12000000000,84842,952,202,66,0x1Fa8559e873f698292766790AeCf8080A66433F6,0xdE0c98c5c12386A2057D8450120D4F84593197e6
13122,15627918,85794,12000000000,84842,952,202,62,0x1Fa8559e873f698292766790AeCf8080A66433F6,0x736501215F7bae4d48fdB5d3127A5f8370dd58EB
13123,15627918,85794,12000000000,84842,952,202,65,0x1Fa8559e873f698292766790AeCf8080A66433F6,0x6511dda031496AAc17eC8fd1bCD468eEbF18D627
13124,15627918,85794,12000000000,84842,952,202,65,0x1Fa8559e873f698292766790AeCf8080A66433F6,0x2B9A0D776252ACF9b08137be93A358138B736Ce9
13125,15627918,21000,12000000000,21000,0,2,8,0x4B602384A89CEB6e4d3241f2120069DaDDC6ff65,0x0DF86E9410377eFc27E7266Ce3Fe4FfE9CD52b7C
13126,15627918,151058,12000000000,144406,6652,1810,11,0x00000000006c3852cbEf3e08E8dF289169EdE581,0x916581B2CfacA9BB63E946db89beA1367C0ad5E1
13127,15627918,181476,12000000000,179912,1564,394,283,0x1Fa8559e873f698292766790AeCf8080A66433F6,0x2Ca98993858D7243f5996cBEB1BE097bF743B802
13128,15627918,181458,11953586007,179906,1552,394,165,0x1Fa8559e873f698292766790AeCf8080A66433F6,0x11C0DEF51903e9BF03568A223C49c246f8B50a21
13129,15627918,54685,11953586007,53721,964,394,2365,0x645E9324f4be25be581BB62163cfa86c40b01D07,0xc5009AFEd2D6DA219538aD165998F63B553185B1
13130,15627918,181476,11953586007,179912,1564,394,151,0x1Fa8559e873f698292766790AeCf8080A66433F6,0xFd012c7E3278F5F214c7E5d94c51910510f81EB7
13131,15627918,181476,11953586007,179912,1564,394,65,0x1Fa8559e873f698292766790AeCf8080A66433F6,0x45bf6DeC6D40D5Ba1Ea0bb32F295757f11148E0C
13132,15627918,305917,11953586007,298929,6988,970,81,0x9b3B6974531d8AA15A87908FFd821A64863Ede5B,0x9c528c5A8066379528057b125Fb6Cad6A27c026c
13133,15627918,175092,11953586007,173540,1552,394,410,0x1Fa8559e873f698292766790AeCf8080A66433F6,0x4FDae27E003Db44fc4A69ad85546367FB9e9273f
13134,15627918,181476,11953586007,179912,1564,394,203,0x1Fa8559e873f698292766790AeCf8080A66433F6,0x1dbEEdfc5E4005279fEd4ab145F29d2e928938D8
13135,15627918,181476,11953586007,179912,1564,394,837,0x1Fa8559e873f698292766790AeCf8080A66433F6,0x46EDcFa49bbf3E3173c02A077937C9df4D48172E
13136,15627918,21000,11953586007,21000,0,2,164,0xd1Bb9C022B2bae8523BdD17221458370599cA613,0xb46474ED447403367b6fB561B353C1C5995f059F
13137,15627918,99244,11953586007,98636,608,138,0,0xA0b86991c6218b36c1d19D4a2e9Eb0cE3606eB48,0x852e8F2d469A464d67Afa38080d93076BA0c0Ed5
13138,15627918,181476,11953586007,179912,1564,394,348,0x1Fa8559e873f698292766790AeCf8080A66433F6,0x444a19317a3F5119B0b65937fA32A442B01DB904
13139,15627918,181476,11953586007,179912,1564,394,430,0x1Fa8559e873f698292766790AeCf8080A66433F6,0xd810174DC20aD742A661c49AD601A6DC67efD1F7
13140,15627918,181476,11953586007,179912,1564,394,13,0x1Fa8559e873f698292766790AeCf8080A66433F6,0x0e61E21c1E33Daf6d70f56bd1e8E93c1B4e083C2
13141,15627918,181476,11953586007,179912,1564,394,39,0x1Fa8559e873f698292766790AeCf8080A66433F6,0xa6e9AFcb696fd1Ad4878384a2059dc290DEa2C98
13142,15627918,181476,11953586007,179912,1564,394,147,0x1Fa8559e873f698292766790AeCf8080A66433F6,0x283EB07B1B01Ebe78CeB3C491DcBCD44824A8509
13143,15627918,181476,11953586007,179912,1564,394,82,0x1Fa8559e873f698292766790AeCf8080A66433F6,0xbc376CF98287EE3Bdb0Dc652a2eb977bc9d02A67
13144,15627918,181476,11953586007,179912,1564,394,198,0x1Fa8559e873f698292766790AeCf8080A66433F6,0x265698E1B656e8BDF8e7d6d1125c5162726c7f37
13145,15627918,200000,11953586007,198436,1564,394,2169,0x1Fa8559e873f698292766790AeCf8080A66433F6,0x049808d5EAA90a2665b9703d2246DDed34F1EB73
13146,15627918,181476,11953586007,179912,1564,394,225,0x1Fa8559e873f698292766790AeCf8080A66433F6,0xE7DcD1Ae643eECd97CBdeff297Aa4eB52441a23E
13147,15627918,175110,11953586007,173546,1564,394,38,0x1Fa8559e873f698292766790AeCf8080A66433F6,0x6afca06a8b3f40AD65D5fd016A4b8dCdC914F587
13148,15627918,121018,11953586007,120446,572,138,51,0x1748B24faf9780B74E5A9f3Feb41553E712E94aa,0x6819eA7792CC89394fEEE84FC70d54a67cD0B765
13149,15627918,175110,11953586007,173546,1564,394,609,0x1Fa8559e873f698292766790AeCf8080A66433F6,0x8580DE1fd8C5423b2Ec64860a791211c3ADf6205
13150,15627918,181476,11953586007,179912,1564,394,205,0x1Fa8559e873f698292766790AeCf8080A66433F6,0xB54e13B261c3DD6fdd240223d9F2F0FE328D1B26
13151,15627918,181476,11953586007,179912,1564,394,470,0x1Fa8559e873f698292766790AeCf8080A66433F6,0x267B6f06420505392c45fA3322e68595ABdEC383
13152,15627918,181476,11953586007,179912,1564,394,959,0x1Fa8559e873f698292766790AeCf8080A66433F6,0xDc173A534db25B93B8fb662811EE0b30C63807e5
13153,15627918,46187,11953586007,45615,572,138,174,0x34Bc797F40Df0445c8429d485232874B15561728,0x02221A91a389d4DfeFFE9756ad02f1dA4872269F
13154,15627918,175092,11953586007,173540,1552,394,42,0x1Fa8559e873f698292766790AeCf8080A66433F6,0xA2FCA16c6F86F923d060b7FAA3aDfAB0009F6f62
13155,15627918,181476,11953586007,179912,1564,394,38,0x1Fa8559e873f698292766790AeCf8080A66433F6,0xA45684D3dA5787db547e2ec0D0467238dFF8052A
13156,15627918,181458,11953586007,179906,1552,394,94,0x1Fa8559e873f698292766790AeCf8080A66433F6,0x993b15E96e09349622Feb6b1f9bC81e763B9ECa3
13157,15627918,181476,11953586007,179912,1564,394,15,0x1Fa8559e873f698292766790AeCf8080A66433F6,0xf4b2D9b91Bd2B4770b189F54caCc21d1920d0f93
13158,15627918,21000,11953586007,21000,0,2,99,0xcF82c499A6Fe4299c1E2098E9d8589fC263f19fD,0xc8Ed6D535D08fc4435Fea832C78B866e7ed1F40a
13159,15627918,175110,11953586007,173546,1564,394,188,0x1Fa8559e873f698292766790AeCf8080A66433F6,0xd3c2087B63559fc8C4B98c99778a086171A9db2B
13160,15627918,181476,11953586007,179912,1564,394,473,0x1Fa8559e873f698292766790AeCf8080A66433F6,0x51750327bf65F7782baa865A09c79a0A82CeD5D5
13161,15627918,112884,11953586007,112820,64,10,161,0xb55e1442EDA37d31249f97b3fCA6DEF588346FeF,0xE3197391348C02044fbcD853FB6F800f09C4D037
13162,15627918,181476,11953586007,179912,1564,394,2,0x1Fa8559e873f698292766790AeCf8080A66433F6,0x51d5C4fF3D901c55F254fA0F3c29Be1afFba469d
13163,15627918,181458,11953586007,179906,1552,394,45,0x1Fa8559e873f698292766790AeCf8080A66433F6,0xA0bcdc7cBe7A977b12817D3a2070266AAf5D0093
13164,15627918,181476,11953586007,179912,1564,394,83,0x1Fa8559e873f698292766790AeCf8080A66433F6,0x274362fA1A737D20e84E4f82D5b193A95A7cc455
13165,15627918,181476,11953586007,179912,1564,394,2331,0x1Fa8559e873f698292766790AeCf8080A66433F6,0x10e719c7F2024021Add3323E3F3dF56D8376709C
13166,15627918,175110,11953586007,173546,1564,394,233,0x1Fa8559e873f698292766790AeCf8080A66433F6,0x0c9550Aa7c4982B9E901f5F4816E955806D67805
13167,15627918,181476,11953586007,179912,1564,394,69,0x1Fa8559e873f698292766790AeCf8080A66433F6,0x05Baa8F3DF422a141f5E0647e1D76aF7111E7607
13168,15627918,181476,11953586007,179912,1564,394,395,0x1Fa8559e873f698292766790AeCf8080A66433F6,0x11eA480d7c8d4f6c94b3B184d4BfF78e5fB5f4BA
13169,15627918,168045,11953586007,165213,2832,842,386,0x68b3465833fb72A70ecDF485E0e4C7bD8665Fc45,0x1453169a1B1Fb2160B4c64E573c2296CB131143A
13170,15627918,181476,11953586007,179912,1564,394,1282,0x1Fa8559e873f698292766790AeCf8080A66433F6,0xA61F438c227C0af7CA5C53ba8057325fdE72a811
13171,15627918,175110,11953586007,173546,1564,394,4874,0x1Fa8559e873f698292766790AeCf8080A66433F6,0x94eF50aFAc9c04572813F36Fb8D676EB400de278
13172,15627918,175110,11953586007,173546,1564,394,15,0x1Fa8559e873f698292766790AeCf8080A66433F6,0x130f3584A3be17D41e15b439cbEF6fcDc39cAc27
13173,15627918,181476,11953586007,179912,1564,394,60,0x1Fa8559e873f698292766790AeCf8080A66433F6,0x3A72982f0CEf60C558ad5Aa627Ba82038A40db0B
13174,15627918,181476,11953586007,179912,1564,394,1334,0x1Fa8559e873f698292766790AeCf8080A66433F6,0x2e82494083D823173249D67e3b7BdAd17425e028
13175,15627918,42000,11953586007,42000,0,2,646177,0x282Eef8c7Fb24BE01507A2eEE6006ccF893C5c32,0x29D5527CaA78f1946a409FA6aCaf14A0a4A0274b
13176,15627918,181476,11953586007,179912,1564,394,653,0x1Fa8559e873f698292766790AeCf8080A66433F6,0x992E913fC63c9C4F8195e29E3cfbC3857617f107
13177,15627918,181476,11953586007,179912,1564,394,109,0x1Fa8559e873f698292766790AeCf8080A66433F6,0x03990c4c96d04a39c61265EAB182229a5A3aA4A9
13178,15627918,181476,11953586007,179912,1564,394,363,0x1Fa8559e873f698292766790AeCf8080A66433F6,0x73A5433fD8d8380F49c46B2c11eC83e439D8cE97
13179,15627918,181476,11953586007,179912,1564,394,554,0x1Fa8559e873f698292766790AeCf8080A66433F6,0x9e85280CB47aE823Ff1d817E8bc969fc08ABA6fB
13180,15627918,181458,11953586007,179906,1552,394,2715,0x1Fa8559e873f698292766790AeCf8080A66433F6,0x9D4B3553f7F615ff0315711e31A41500EBDfFA13
13181,15627918,181476,11953586007,179912,1564,394,54,0x1Fa8559e873f698292766790AeCf8080A66433F6,0x0aac9911D47d7E79B1AE78de5FE056d0AdfdFdc1
13182,15627918,181458,11953586007,179906,1552,394,289,0x1Fa8559e873f698292766790AeCf8080A66433F6,0x1E68b5a283Db69a500E473028cCf77f27264bD9E
13183,15627918,205897,11953586007,202353,3544,1162,73,0x68b3465833fb72A70ecDF485E0e4C7bD8665Fc45,0xaDcc0dB15b779E2FbF012F13e392986c630272ed
13184,15627918,21000,11763688508,21000,0,2,175,0xeefAbcb1e2a276a6bB3Ea4489b2982cC7a6F9A94,0x134E2cA341d0128FDbad3C35a6e2F512eE2cb3F5
13185,15627918,21000,11763688508,21000,0,2,137,0x1b1173968d76aa664eF03872f3f95fF4659BA66a,0x2c5e0478bcd516cfA726d46815f90daF0607B507
13186,15627918,99262,11763688508,98642,620,138,14,0xA0b86991c6218b36c1d19D4a2e9Eb0cE3606eB48,0x7e3BAcE267cB6fec834Df232dA0f5097c085a993
13187,15627918,105000,11762195380,105000,0,2,138589,0x9cdf37470AC6d984EC8fB055d7905C9Bbe110151,0x974CaA59e49682CdA0AD2bbe82983419A2ECC400
13188,15627918,120000,11762195380,119392,608,138,1,0xdAC17F958D2ee523a2206206994597C13D831ec7,0xd350FD242AF1c5469e196A9776373176c9838dBB
13189,15627918,181476,11762195380,179912,1564,394,51,0x1Fa8559e873f698292766790AeCf8080A66433F6,0xEA36f975A4e3b4E76A7B48fB8669d0De1497b078
13190,15627918,329277,11762195380,327065,2212,586,66,0x89078be8004Fb238630C2E156DF7d3bA56e590EF,0x99CCE83Ab2e046E0e08d8aE0797f1c6f46956ec9
13191,15627918,254415,11762195380,252543,1872,458,2,0xEfF92A263d31888d860bD50809A8D171709b7b1c,0x40E255648795679a323D1A5b221327590Ad96988
13192,15627918,191077,11762195380,190177,900,266,202,0xd588b586D61C826A0e87919b3D1a239206d58bf2,0x2E243DF4892e05E5C8AAcfB550DC172DDdF8b1A3
13193,15627918,236566,11265098486,233326,3240,1034,14,0x68b3465833fb72A70ecDF485E0e4C7bD8665Fc45,0x30762F13B220765C6dCb0Cd6e87013dF3F8de924
13194,15627918,262758,11189507832,261030,1728,458,6,0x7a250d5630B4cF539739dF2C5dAcb4c659F2488D,0x816Ab258b14839ef14201ef023d2eBD095Ce41F9
13195,15627918,128202,11000000000,127770,432,74,401,0xA0c68C638235ee32657e8f720a23ceC1bFc77C77,0x4dCbB1fE5983ad5b44DC661273a4f11CA812f8B8
13196,15627918,30000,10953586007,30000,0,2,3677,0x535B918F3724001FD6Fb52fCC6cBC220592990A3,0xF2f5C73fa04406b1995e397B55c24aB1f3eA726C
13197,15627919,310482,252000000000,308586,1896,458,156,0x7a250d5630B4cF539739dF2C5dAcb4c659F2488D,0xf073598cA0CAFb8E0ad39f283339514eCC0B7a21
13198,15627919,2000000,61794775224,1999056,944,138,167,0xAD13C2a8d418d01F3236F4d8b9d724575a4e9d24,0x3C2a7589f22f4cC06938d33aC80784c6aD784A2F
13199,15627919,600000,50000000000,598116,1884,458,2004,0x7a250d5630B4cF539739dF2C5dAcb4c659F2488D,0xe7c5DE03987777a18FF279A5e8d8A91Dd91db688
13200,15627919,21000,34500000000,21000,0,2,1005600,0x776BB566dC299C9e722773d2A04B401e831a6DC8,0xc5a93444Cc4dA6EfB9e6FC6e5D3CB55A53b52396
13201,15627919,21000,34500000000,21000,0,2,1005601,0xC50d44c97e2E03a2b7B310f40715ada59B6F3C60,0xc5a93444Cc4dA6EfB9e6FC6e5D3CB55A53b52396
13202,15627919,56130,20000000000,54770,1360,394,49,0xc36cF0cFcb5d905B8B513860dB0CFE63F6Cf9F5c,0x426DaeF611bB209Acc8ceFFeAa6aC151e7122A7C
13203,15627919,21000,17987040144,21000,0,2,0,0x44AfFdf87ABfb1DBa08e444141bD21B4380FA35F,0x14780506a321927f75a5EE71BAaf39D152219C41
13204,15627919,90000,17000000000,89392,608,138,0,0xdAC17F958D2ee523a2206206994597C13D831ec7,0x7Df83B2Ce8F85BFb1b72aC94C2e5DF03C64e2A8A
13205,15627919,99244,14794775224,98636,608,138,239,0xA0b86991c6218b36c1d19D4a2e9Eb0cE3606eB48,0xBEAE3275F81688Bd6e51982F2fDb16bC0e333333
13206,15627919,181458,14794775224,179906,1552,394,124,0x1Fa8559e873f698292766790AeCf8080A66433F6,0x50caDA4a77E0bD6EeE1501f458fC379bd5e65Bc1
13207,15627919,21000,14641630767,21000,0,2,2,0x1D874e5216F0A41e5E35E30258Aa9264db5aE4c7,0xd6348aDdC883a256F54d0Bf215df0f07eb397eD2
13208,15627919,150756,14294775224,150692,64,10,76,0x65c2e54a4c75ff6da7b6B32369c1677250075fb2,0x7a5D1A19151390Fc136CB8d387b9bC7974665D56
13209,15627919,109660,14294775224,109456,204,74,524,0x9b9D659D4f2cF68b6616Cc0a65683f1951Eb725C,0x2F1604fFfda7CDf5a7C3A9ef3158336B6D2E7693
13210,15627919,92091,14294775224,91607,484,202,4069,0xBE0e87fA5BCB163b614bA1853668FFcd39d18FcB,0x97B10F1d005C8edee0FB004af3Bb6E7B47c954fF
13211,15627919,222222,14000000000,220658,1564,394,173,0x1Fa8559e873f698292766790AeCf8080A66433F6,0xFcBb0E5935AED023435Fca45b61d1223eE785472
13212,15627919,21000,13795775224,21000,0,2,251473,0x86DF62E07dE79cD9d0d8D30C0Cf645F81a70e606,0x151B381058f91cF871E7eA1eE83c45326F61e96D
13213,15627919,207128,13794775224,206520,608,138,1312165,0xA0b86991c6218b36c1d19D4a2e9Eb0cE3606eB48,0xf60c2Ea62EDBfE808163751DD0d8693DCb30019c
13214,15627919,181476,13794775224,179912,1564,394,17,0x1Fa8559e873f698292766790AeCf8080A66433F6,0xc655E7223c44af83A4364Ae10E01c34c826eFd19
13215,15627919,234689,13794775224,232805,1884,458,176,0x03f7724180AA6b939894B5Ca4314783B0b36b329,0xEcdFFeEF02cde246bb59C4B760D0D0D50d15910f
13216,15627919,181476,13794775224,179912,1564,394,330,0x1Fa8559e873f698292766790AeCf8080A66433F6,0x9AEe5386D2092be8A1A5F7Fb31da3Bf02D63794f
13217,15627919,102928,13794775224,102296,632,138,5,0xB4375E8aaCf0147aDf6B2a296c61Ad6141010c37,0x8Fbbb24Bf54C0Bf2BdD86A79a910e5d33d01F5B5
13218,15627919,175110,13794775224,173546,1564,394,16,0x1Fa8559e873f698292766790AeCf8080A66433F6,0xD14c69D88AadE3C51A5eA7B06d5E160dad6DB08d
13219,15627919,90000,13794775224,90000,0,2,93934,0xc2Bd94a797D0408B11717E919ada9E8784001bC9,0xf89d7b9c864f589bbF53a82105107622B35EaA40
13220,15627919,21000,13794775224,21000,0,2,2759953,0x93CeeF42e14940Be2B181aE09a89414e9f8Ad771,0x267be1C1D684F78cb4F6a176C4911b741E4Ffdc0
13221,15627919,42000,13794775224,42000,0,2,329571,0x08a941634a60c90624ab71d29F9bB5B6ea717536,0x9430801EBAf509Ad49202aaBC5F5Bc6fd8A3dAf8
13222,15627919,46267,13794775224,45691,576,74,609,0x283Af0B28c62C092C9727F1Ee09c02CA627EB7F5,0x476c8712bf3A84f5a04db2D6a81d374f3F1AAD99
13223,15627919,160694,13794775224,157886,2808,842,5337,0x68b3465833fb72A70ecDF485E0e4C7bD8665Fc45,0x517f0FD1A317217C0515F34A9165EcDa5DC4deB1
13224,15627919,94463,13709285863,94031,432,74,33,0xA0c68C638235ee32657e8f720a23ceC1bFc77C77,0xdca7837722462E96010EAA41FB88b0AD832452C6
13225,15627919,21000,13444775224,21000,0,2,39,0x41eec5bf8382BAaa340067b869510B66D06A1C51,0x41eec5bf8382BAaa340067b869510B66D06A1C51
13226,15627919,50000,13417834541,50000,0,2,1210295,0x66B5010C8BA58FD0f089fa89325E29b530570702,0x912fD21d7a69678227fE6d08C64222Db41477bA0
13227,15627919,406207,13294775224,402555,3652,970,194,0x68b3465833fb72A70ecDF485E0e4C7bD8665Fc45,0xD12EC12A77D3f30844a58c2E992273B8152A2eD5
13228,15627919,21000,13294775224,21000,0,2,5,0x914ffE231951b5D9019525BDD0658D9edF53043A,0x88fc3d68D7723770A189a8330B784616bB353C48
13229,15627919,46157,13294775224,45669,488,138,1,0xEb4e856F69158052aC0AaF7Dc26f63DCb1ee067F,0x3732486e1abaAeEe97056F6bC39200F95c5b0d2e
13230,15627919,123866,13294775224,120578,3288,650,1128,0x23E79722Bb8B55a0d04f3AFbCFC34eb771526Adb,0x6861698B928562e396b9B6db2c0AbB17C4c729cd
13231,15627919,185679,13294775224,182039,3640,1162,14,0x68b3465833fb72A70ecDF485E0e4C7bD8665Fc45,0xf5233063cE767a450c8140558F090a13A139Efcc
13232,15627919,56334,13294775224,54974,1360,394,434,0xe4605d46Fd0B3f8329d936a8b258D69276cBa264,0x216A023E0c19382D895a66A76dd92E898c9BE3a7
13233,15627919,21000,13294775224,21000,0,2,471,0x4bb2Fda265F3c987a86aC5e8E86F782e94340CD8,0xc5Ef260415F8592835D6bde27e5172DACC135F54
13234,15627919,439146,13294775224,426450,12696,4106,81,0x0000000000c2d145a2526bD8C716263bFeBe1A72,0x791B61E3198bcFBf83530073F89B896DA85C56CA
13235,15627919,233743,13294775224,230515,3228,1034,158,0x68b3465833fb72A70ecDF485E0e4C7bD8665Fc45,0x1e09556B986e0771133466b224370903051F24d7
13236,15627919,103579,13294775224,103375,204,74,176,0x4ADD6AB943e7908Bb51e7878755D0CA322C898d6,0x05CF60Df7ad9BBc89cE591c4DBcA4BD58135f166
13237,15627919,61435,13294775224,53271,8164,2506,112,0x00000000006c3852cbEf3e08E8dF289169EdE581,0xFC086e37AE46e7Ac2D35F816E529E3f315Bf829d
13238,15627919,238948,13294775224,236164,2784,842,485,0x68b3465833fb72A70ecDF485E0e4C7bD8665Fc45,0xbb26DC6452577c09FAbd8882e04D628ae49089a1
13239,15627919,21000,13294775224,21000,0,2,109,0x901AF421e2688AbBB817c8A6d33c2252c29828dc,0xf6e9b43969f52021bC920c635df3933bC01aB52c
13240,15627919,250256,13294775224,246592,3664,1162,3377,0x68b3465833fb72A70ecDF485E0e4C7bD8665Fc45,0x2Dfd7946a6D8cA71ae48c307518ACC7aF5407dd5
13241,15627919,76134,13294775224,76070,64,10,4399,0xD057B63f5E69CF1B929b356b579Cba08D7688048,0x14Ce500a86F1e3aCE039571e657783E069643617
13242,15627919,122512,13294775224,121264,1248,458,406,0x4e32004D8b81847A670b4a1778ACe4dCF2bBA01E,0x399cC15527d172741476bDaCfBb4199898A50c7d
13243,15627919,51458,13294775224,50970,488,138,1,0x7F9306FC1978938d5C1C57Bf6044dc67E07eeB8a,0xd444eccbD61f2233981b3D2261E2FDB3Db1e0393
13244,15627919,197401,13294775224,190825,6576,1802,823,0x00000000006c3852cbEf3e08E8dF289169EdE581,0xeE033638d44be47dc01495493985a7FD65Ce28Ee
13245,15627919,21000,13294775224,21000,0,2,14,0xb28386c78e1070803F18f8EBE0D26C4fA37df9f8,0x90C058ccEF37b833A5B271A30192357Ded296DF4
13246,15627919,220147,13294775224,216923,3224,906,409,0x68b3465833fb72A70ecDF485E0e4C7bD8665Fc45,0x4fc3F8C8ADfD2f1277761807FB6938D44F88b096
13247,15627919,184042,13294775224,181370,2672,714,13948,0xc2F98E8A02dDDc29C4F7aB81DC141e913C837007,0xE7918DBc151Bf711d7E2DFe8d19F686B2938A7AF
13248,15627919,94463,13294775224,94031,432,74,62,0xA0c68C638235ee32657e8f720a23ceC1bFc77C77,0x1A910629f688471d7934295a93699b0eA545e644
13249,15627919,46195,13294775224,45623,572,138,33,0xFB6e20268256ed02Ad06fD983E80a48E87759F29,0xd5338E16A3b28d37330c79c573527E42a00a599A
13250,15627919,21000,13294775224,21000,0,2,26,0x6a9c85eD8b422209D6e3bE467eFb65158E23D79C,0xd89006a631e6bC9902770E31f8555e7Ed0321082
13251,15627919,21000,13294775224,21000,0,2,791,0x8f1CBa5C1F9580BdaF7baD07d1eB4679f02Aa1C0,0x901A07F3578d94564139408703585789A1BDf8C4
13252,15627919,181458,13294775224,179906,1552,394,31,0x1Fa8559e873f698292766790AeCf8080A66433F6,0x7F093BF0AF71FE7d675D819E1E029ee85f7d8b81
13253,15627919,46135,13294775224,45647,488,138,5645,0x1Fa8559e873f698292766790AeCf8080A66433F6,0xb5F31EB9e70f88c5997a243DfB59b7097bcd84bE
13254,15627919,135587,13294775224,128835,6752,1698,103,0x00000000006c3852cbEf3e08E8dF289169EdE581,0x4b30Ae101B305c6a7DfE26bD73F16CE832b04AB5
13255,15627919,358003,13294775224,354815,3188,1098,27,0x8731d54E9D02c286767d56ac03e8037C07e01e98,0x8785Bd90b0d0ee06C8D33dF8Ccbf57BF5dBd7C0C
13256,15627919,147965,13294775224,141301,6664,1810,727,0x00000000006c3852cbEf3e08E8dF289169EdE581,0xbf6c7208a0aD7612C53BFfB567E7365a3d02e86a
13257,15627919,238963,13294775224,236167,2796,842,32,0x68b3465833fb72A70ecDF485E0e4C7bD8665Fc45,0xd605639f9438F0A9D4FD2B86D32780E6FE160934
13258,15627919,55953,13294775224,55009,944,138,77,0xaE86f48c0B00F2a3eaeF4ba4c23d17368f0f63f4,0xC8F06c6a16d060B1Cb8d880655Cf7Ad5E1C6522D
13259,15627919,122512,13294775224,121264,1248,458,23,0x4e32004D8b81847A670b4a1778ACe4dCF2bBA01E,0x030ce9d143332f6D9c287414f08e22c145c43c58
13260,15627919,181458,13294775224,179906,1552,394,280,0x1Fa8559e873f698292766790AeCf8080A66433F6,0x2F1D71d05a2Fd7F8236C19009C82029779255A93
13261,15627919,46157,13294775224,45669,488,138,1,0xEb4e856F69158052aC0AaF7Dc26f63DCb1ee067F,0xD3e14b9787183546d9c5D64D5426ECe6F4130caD
13262,15627919,21000,13294775224,21000,0,2,6,0xB96e514d7aC237904F290368a6A4fFC51E0eb5fb,0xfe25F7A6c5405f31483CF830430Ae0e124C186F8
13263,15627919,267722,12794775225,265466,2256,650,119835,0xA69babEF1cA67A37Ffaf7a485DfFF3382056e78C,0xeCa2e2D894D19778939bD4DfC34D2a3C45E96456
13264,15627919,175110,12794775224,173546,1564,394,21,0x1Fa8559e873f698292766790AeCf8080A66433F6,0x1Ab5cc1196F5F027903b5611C92Ef61221043473
13265,15627919,181476,12794775224,179912,1564,394,145,0x1Fa8559e873f698292766790AeCf8080A66433F6,0x308D7EDA95D32cAc3954362F9f32740144dBFE86
13266,15627919,175110,12794775224,173546,1564,394,2212,0x1Fa8559e873f698292766790AeCf8080A66433F6,0xA0BDF16f3C91633838ad715a4bC7e8B406093340
13267,15627919,319302,12794775224,317406,1896,458,21,0x7a250d5630B4cF539739dF2C5dAcb4c659F2488D,0x0cB5B5C356FcE965b26683E0B3854a6f098108aC
13268,15627919,250000,12794775224,250000,0,2,45337170,0x79D2A299bd8681554b9F651f30728c2d2eEe8093,0xEA674fdDe714fd979de3EdF0F56AA9716B898ec8
13269,15627919,126531,12794775224,126327,204,74,203,0x9b9D659D4f2cF68b6616Cc0a65683f1951Eb725C,0x23b0757d00232e8423783509E8f162Dc034ed4b7
13270,15627919,181476,12794775224,179912,1564,394,569,0x1Fa8559e873f698292766790AeCf8080A66433F6,0x745FcA508F6b738a528b23d623c01Fa95F32dB66
13271,15627919,181476,12794775224,179912,1564,394,393,0x1Fa8559e873f698292766790AeCf8080A66433F6,0xF61B910b888326BBF31Efd46CD73d273e99794e7
13272,15627919,175110,12794775224,173546,1564,394,42,0x1Fa8559e873f698292766790AeCf8080A66433F6,0xDe2FBcDfd564D2D2Be6066eE88ABCdd889c79F90
13273,15627919,181476,12794775224,179912,1564,394,416,0x1Fa8559e873f698292766790AeCf8080A66433F6,0xBb63B9d24D06e6fd7f0cBB1e228C86971BF679B4
13274,15627919,121018,12794775224,120446,572,138,52,0x1748B24faf9780B74E5A9f3Feb41553E712E94aa,0x6819eA7792CC89394fEEE84FC70d54a67cD0B765
13275,15627919,175110,12794775224,173546,1564,394,319,0x1Fa8559e873f698292766790AeCf8080A66433F6,0x6701c8876D80eFEb19fF6583Bd121087953D50ba
13276,15627919,122446,12794775224,120882,1564,394,189,0x1Fa8559e873f698292766790AeCf8080A66433F6,0xd3c2087B63559fc8C4B98c99778a086171A9db2B
13277,15627919,181458,12794775224,179906,1552,394,1494,0x1Fa8559e873f698292766790AeCf8080A66433F6,0x9DB66D15E466B4eAB2E33b690569eAf50fd99f92
13278,15627919,181476,12794775224,179912,1564,394,603,0x1Fa8559e873f698292766790AeCf8080A66433F6,0x71EDD9C354489d7bDccED7F540b3da38C14C328b
13279,15627919,44824,12620000000,44156,668,138,43,0x6c6EE5e31d828De241282B9606C8e98Ea48526E2,0x7F2FFf0F29752Dc2d43A3fe65b323119d3555016
13280,15627919,250392,12563121867,247716,2676,842,380,0x68b3465833fb72A70ecDF485E0e4C7bD8665Fc45,0x85406E863296508c235E35a640F39433aEF4701a
13281,15627919,126531,12526273555,126327,204,74,708,0x9b9D659D4f2cF68b6616Cc0a65683f1951Eb725C,0x9b6cd0Ff5789748aA352a9257C13Be99126f3fB2
13282,15627919,60000,12385693423,59432,568,202,34116,0x41c69c8ffb4049fc393ed68Ec0Ce66c37f8CF7a0,0xe8463A6d371581d3E40315daD7dbAB85f1492da8
13283,15627919,60000,12385693423,59444,556,202,34117,0x41c69c8ffb4049fc393ed68Ec0Ce66c37f8CF7a0,0xe8463A6d371581d3E40315daD7dbAB85f1492da8
13284,15627919,60000,12385693423,59432,568,202,37657,0x902F09715B6303d4173037652FA7377e5b98089E,0x339d413CCEfD986b1B3647A9cfa9CBbE70A30749
13285,15627919,60000,12385693423,59444,556,202,37658,0x902F09715B6303d4173037652FA7377e5b98089E,0x339d413CCEfD986b1B3647A9cfa9CBbE70A30749
13286,15627919,345882,12030697049,163118,182764,23050,183260,0x5E4e65926BA27467555EB562121fac00D24E9dD2,0x6887246668a3b87F54DeB3b94Ba47a6f63F32985
13287,15627919,400000,12000000000,398064,1936,586,11457,0xebb46688c5a1d17A1606AF5d597D296662075D9E,0xf14FC3D40149EF0d4639Bd0141189C78CBD3B7b5
13288,15627919,62420,12000000000,61468,952,202,63,0x1Fa8559e873f698292766790AeCf8080A66433F6,0x736501215F7bae4d48fdB5d3127A5f8370dd58EB
13289,15627919,62420,12000000000,61468,952,202,66,0x1Fa8559e873f698292766790AeCf8080A66433F6,0x6511dda031496AAc17eC8fd1bCD468eEbF18D627
13290,15627919,62420,12000000000,61468,952,202,66,0x1Fa8559e873f698292766790AeCf8080A66433F6,0x2B9A0D776252ACF9b08137be93A358138B736Ce9
13291,15627919,62420,12000000000,61468,952,202,67,0x1Fa8559e873f698292766790AeCf8080A66433F6,0xdE0c98c5c12386A2057D8450120D4F84593197e6
13292,15627919,62420,12000000000,61468,952,202,68,0x1Fa8559e873f698292766790AeCf8080A66433F6,0xbb6916F4Ad547F369C74C058c1A2dC693a79cb02
13293,15627919,62420,12000000000,61468,952,202,67,0x1Fa8559e873f698292766790AeCf8080A66433F6,0xcd8D0c3668b46cBd61F5Dcedaab0e52E01561A3c
13294,15627920,149074,11220880778,148410,664,130,5362,0xE8c060F8052E07423f71D445277c61AC5138A2e5,0xc7Bf1bF8D639Db5aE9C52C905747795752DC967a
13295,15627920,240444,12720880778,237684,2760,842,598,0x68b3465833fb72A70ecDF485E0e4C7bD8665Fc45,0x306a2bA64dD4a810a0eC1CED08Cb2acC38bE8f4C
13296,15627920,137899,236888766347,136891,1008,170,5363,0xE8c060F8052E07423f71D445277c61AC5138A2e5,0xc7Bf1bF8D639Db5aE9C52C905747795752DC967a
13297,15627920,250034,11220880778,247850,2184,650,116846,0xA69babEF1cA67A37Ffaf7a485DfFF3382056e78C,0x6046945C5B5eF5933b8E73a98A6AD7bF3e031df7
13298,15627920,300852,11220880778,298716,2136,650,43189,0x5050e08626c499411B5D0E0b5AF0E83d3fD82EDF,0xBf2D5d8eBF05947245B3D7f38b2776A6a49710DD
13299,15627920,71000,17826880778,71000,0,2,5391,0x934ed35e39f5D9B1D42041B3f6B74C0ce452F4Ac,0x934ed35e39f5D9B1D42041B3f6B74C0ce452F4Ac
13300,15627920,650130,62220880778,648058,2072,522,66,0x7a250d5630B4cF539739dF2C5dAcb4c659F2488D,0x8ec3AB310701aD1053fcD45198a0813dc8AB54E6
13301,15627920,471084,61220880778,469036,2048,522,1056,0x7a250d5630B4cF539739dF2C5dAcb4c659F2488D,0xA1CC352bC94caDdFddaA4D095762F37B2b9bc57A
13302,15627920,420000,34500000000,419404,596,138,1226079,0xdAC17F958D2ee523a2206206994597C13D831ec7,0x5041ed759Dd4aFc3a72b8192C143F72f4724081A
13303,15627920,21000,34500000000,21000,0,2,1005602,0xA5E0D1Bd2F42c7C0d17B89789fb9da5CFF933ed0,0xc5a93444Cc4dA6EfB9e6FC6e5D3CB55A53b52396
13304,15627920,21000,30000000000,21000,0,2,206,0xCD6DE4e6Ae74267D3eb35cb8e9fbf62da41dB47D,0xb723D7f0942a2D8b1779CAfDBBAF1428ecae42dc
13305,15627920,181476,26220880778,179912,1564,394,1942,0x1Fa8559e873f698292766790AeCf8080A66433F6,0xB58007c1990a0ae29f0D34543714BAf168149F82
13306,15627920,82116,18427409398,81520,596,138,1239,0x083D41d6DD21EE938f0c055CA4fb12268DF0EfaC,0x0e747EB2ff0F26fB77c3a1eA67EE07FAc2DbB783
13307,15627920,5049432,17000000000,5042320,7112,1098,306,0x0a39DA505DfB5E0BBc6bd84428281A8ba1bC7753,0x495E889d1A6cEB447a57dcc1C68410299392380c
13308,15627920,181476,16220880778,179912,1564,394,165,0x1Fa8559e873f698292766790AeCf8080A66433F6,0x96236e18Be54818A1dE88DC4f63b9cDC752f10D4
13309,15627920,350000,15482116779,350000,0,2,6925088,0x1eCd3CaFE9D421B4e6D4892aAA3aD82AFb28E396,0x46340b20830761efd32832A74d7169B29FEB9758
13310,15627920,350000,15482116779,349404,596,138,6925089,0xdAC17F958D2ee523a2206206994597C13D831ec7,0x46340b20830761efd32832A74d7169B29FEB9758
13311,15627920,350000,15482116779,350000,0,2,6925090,0x48E3338048AAee5E872b0dEb2286Ac0E434Be05D,0x46340b20830761efd32832A74d7169B29FEB9758
13312,15627920,63000,15130880778,63000,0,2,2710071,0xc79C6515595A6C39dD777A2524499BA1af29851b,0xC098B2a3Aa256D2140208C3de6543aAEf5cd3A94
13313,15627920,63000,15122892922,63000,0,2,183636,0x297751960DAD09c6d38b73538C1cce45457d796d,0x25eAff5B179f209Cf186B1cdCbFa463A69Df4C45
13314,15627920,21000,15040000000,21000,0,2,0,0x6dfc34609a05bC22319fA4Cce1d1E2929548c0D7,0x828f556f391327CAA77d53ac3F8c8b1F1353d7D2
13315,15627920,46135,15000000000,45647,488,138,322,0x1Fa8559e873f698292766790AeCf8080A66433F6,0xaF25f948c1daa5Ed272345BbE355895F036eAa61
13316,15627920,181476,15000000000,179912,1564,394,320,0x1Fa8559e873f698292766790AeCf8080A66433F6,0x98aCdCaCd03C7e015Db748cf02d7cD8ee4336395
13317,15627920,90000,14694607223,90000,0,2,784426,0x0A9c4BDEe89a9318881441f6a99105fbdda0A025,0xcaD621da75a66c7A8f4FF86D30A2bF981Bfc8FdD
13318,15627920,50000,14546360181,50000,0,2,503555,0x9BC66deb421FAf05041eE69f8dB194F6a34bdC37,0x000F422887eA7d370FF31173FD3B46c8F66A5B1c
13319,15627920,21000,14220880778,21000,0,2,3417,0x056f99d38Dc0727b054955bFe86152b2Bc0C4dE4,0xfB183eb452CEe258c7e429610cb7d9e2a5fA68Ff
13320,15627920,46386,14220880778,45442,944,138,5,0x6fDB2d39f735964677D45CDAC8C31D0B514739FD,0x9A4140FFB57D5272ea009c37a18D2A88B54e6063
13321,15627920,181476,14189507832,179912,1564,394,28,0x1Fa8559e873f698292766790AeCf8080A66433F6,0x2739Ada195F5a76ae3222F884c99d1BCCBA41687
13322,15627920,104616,14144303208,103664,952,202,5,0x6de7aC835EC6841Af9b94fd1273dB83B8d69e3f7,0x0Cd860F2f008a43BFB7bcaD52aAe82E6FDC7987A
13323,15627920,181476,14000000000,179912,1564,394,109,0x1Fa8559e873f698292766790AeCf8080A66433F6,0xb8a52c76277c66122905D53fF4d2C8ADA76cc458
13324,15627920,222222,14000000000,220658,1564,394,209,0x1Fa8559e873f698292766790AeCf8080A66433F6,0xbC8c51eB156Cc9F95Bc7475dDfc6CDb74e269502
13325,15627920,181458,14000000000,179906,1552,394,265,0x1Fa8559e873f698292766790AeCf8080A66433F6,0x8C36547249DdB939989b922317d8c0F8d4549f2A
13326,15627920,69579,14000000000,69579,0,2,19,0x0b8EAB00034aE0EF11Ff72c6EA50762f72205435,0x2Bf25445FEC3B960b3E83b8F3984A134b3eA3E0F
13327,15627920,248801,13979835822,246421,2380,586,19,0x53e0e51b5Ed9202110D7Ecd637A4581db8b9879F,0x56C849e3cCbE195ed493077c888d52A5e41E49b6
13328,15627920,197454,13845880778,190878,6576,1802,1582,0x00000000006c3852cbEf3e08E8dF289169EdE581,0x203ff37CD6820FB445eA9ECab7cEEd595fF70D7c
13329,15627920,51313,13800000000,50369,944,138,649,0xd4cB651749953988647eEE9b51DDB8DB5aeb3410,0x6684Bec180207B8f3896C93e31663CD9C5b4f1e2
13330,15627920,305917,13720880778,298929,6988,970,117,0x9b3B6974531d8AA15A87908FFd821A64863Ede5B,0xAceB9F3D64e221be00C49036A6491EcB82D870Fa
13331,15627920,150756,13720880778,150692,64,10,2,0x65c2e54a4c75ff6da7b6B32369c1677250075fb2,0xbB6C6048492e3d181c6B52D6D06F5276a4f6F9f2
13332,15627920,305962,13720880778,298974,6988,970,168,0x9b3B6974531d8AA15A87908FFd821A64863Ede5B,0xfeAF8E25cC2c0Ae6b9B97d269528029294dFa41d
13333,15627920,250000,13474380694,250000,0,2,128426,0x9a5D1C60C913eC13De546A6AC6b7b288a25d29ea,0xa1Ab7a4aA264745912dB261536291336f7E543Ac
13334,15627920,46382,13270880778,45726,656,138,67,0xC631bE100F6Cf9A7012C23De5a6ccb990EAFC133,0x405aeF2B957A82F23FaC0cC4fc0BAe4d05545CF1
13335,15627920,120000,13223880778,119392,608,138,31732,0xdAC17F958D2ee523a2206206994597C13D831ec7,0x0b5c4a7FcDA49e0a8661419Bb55B86161a86db2a
13336,15627920,50000,13221880778,50000,0,2,16,0xE4b3dD9839ed1780351Dc5412925cf05F07A1939,0x7EF66ad6228d81DA13E28fde533666447f9AF056
13337,15627920,56659,13220880778,55715,944,138,159,0x9431DE2DFE10BDB30995bd3791dE03a6c9570054,0xccbfEE66dDb3E7e14394b128294e532BBa772C00
13338,15627920,254968,13220880778,252196,2772,842,1,0x68b3465833fb72A70ecDF485E0e4C7bD8665Fc45,0x066eDeeA7B363921232231eC0fD9Cb394C50023a
13339,15627920,314300,13220880778,304892,9408,2636,1230,0x881D40237659C251811CEC9c364ef91dC08D300C,0x4C0dbE2bFA35C379788D0d5b1d7F2e749945509f
13340,15627920,181476,13220880778,179912,1564,394,670,0x1Fa8559e873f698292766790AeCf8080A66433F6,0x4131918DbCeB7F8cB6C115188095aA6fCd9D2B7D
13341,15627920,175110,13220880778,173546,1564,394,3164,0x1Fa8559e873f698292766790AeCf8080A66433F6,0x809e82136239a5f26596bD6CE9192207BdffA04c
13342,15627920,319304,13220880778,316496,2808,842,14,0x68b3465833fb72A70ecDF485E0e4C7bD8665Fc45,0x9Dd95FbAFA6F7936e82fa5B724a804d1A194E94d
13343,15627920,181476,13220880778,179912,1564,394,56,0x1Fa8559e873f698292766790AeCf8080A66433F6,0x3B6bf291349e415569D699444608697B032219EF
13344,15627920,181458,13220880778,179906,1552,394,160,0x1Fa8559e873f698292766790AeCf8080A66433F6,0xeaAB5BAf6470570668e2c14e852eddBB6929fa15
13345,15627920,181458,13220880778,179906,1552,394,499,0x1Fa8559e873f698292766790AeCf8080A66433F6,0xFD13D67d67008f52bd7D113FE41D3d9Fb15CEa2a
13346,15627920,313907,13220880778,310931,2976,650,27,0x7a250d5630B4cF539739dF2C5dAcb4c659F2488D,0x2A207956B61AA0eF50a84E9058Eb9bf3793da136
13347,15627920,207128,13220880778,207128,0,2,4708722,0x352931262441B8E7F41339a323ae940Fd3E4e5E1,0x28C6c06298d514Db089934071355E5743bf21d60
13348,15627920,207128,13220880778,206520,608,138,4232357,0xdAC17F958D2ee523a2206206994597C13D831ec7,0xDFd5293D8e347dFe59E90eFd55b2956a1343963d
13349,15627920,207128,13220880778,206496,632,138,4468981,0x514910771AF9Ca656af840dff83E8264EcF986CA,0x21a31Ee1afC51d94C2eFcCAa2092aD1028285549
13350,15627920,207128,13220880778,207128,0,2,1679543,0x5A1Eb2425729b13D04643734A4246034Edf0dD2D,0x4976A4A02f38326660D17bf34b431dC6e2eb2327
13351,15627920,207128,13220880778,206532,596,138,3492299,0xdAC17F958D2ee523a2206206994597C13D831ec7,0x56Eddb7aa87536c09CCc2793473599fD21A8b17F
13352,15627920,207128,13220880778,207128,0,2,4232358,0x3F1ddC325e34CD2D84E967405B271959454Caa28,0xDFd5293D8e347dFe59E90eFd55b2956a1343963d
13353,15627920,151746,13220880778,150194,1552,394,3,0x1Fa8559e873f698292766790AeCf8080A66433F6,0x3d6c75a4d32CBEC57Eb56cF54226b5966D4074e7
13354,15627920,207128,13220880778,206532,596,138,4468982,0xdAC17F958D2ee523a2206206994597C13D831ec7,0x21a31Ee1afC51d94C2eFcCAa2092aD1028285549
13355,15627920,151746,13220880778,150194,1552,394,3,0x1Fa8559e873f698292766790AeCf8080A66433F6,0xe393dBDB41b96CDd45C4876d20A64842a701fc7a
13356,15627920,151762,13220880778,150198,1564,394,3,0x1Fa8559e873f698292766790AeCf8080A66433F6,0x65bfDAA4E793cB293013abC579f8cCBBcf5B126f
13357,15627920,21000,13220880778,21000,0,2,514,0x267F481B18Be284d1470563f863352148d3705f2,0xA7142Ef4f6F4a93796B2bDA2C3760Ae94FE6fF78
13358,15627920,151762,13220880778,150198,1564,394,2,0x1Fa8559e873f698292766790AeCf8080A66433F6,0x341e9DF7Ce030A17631d92f4f67A94Ab136A574a
13359,15627920,151762,13220880778,150198,1564,394,2,0x1Fa8559e873f698292766790AeCf8080A66433F6,0xf8375f2fE287693479deEbD32E9B98c75edB9d47
13360,15627920,42000,13220880778,42000,0,2,329572,0xDaB78AB136300B0c002b78911C50404B7953fc46,0x9430801EBAf509Ad49202aaBC5F5Bc6fd8A3dAf8
13361,15627920,200000,13220880778,199344,656,138,1372,0xBB0E17EF65F82Ab018d8EDd776e8DD940327B28b,0xc0D58FE8abf4BD2519c83fb101866e71517D59D2
13362,15627920,181476,13220880778,179912,1564,394,5,0x1Fa8559e873f698292766790AeCf8080A66433F6,0x5041ec9371E47d64C945eB93EA299069Dab50D81
13363,15627920,200000,13220880778,199344,656,138,1373,0xBB0E17EF65F82Ab018d8EDd776e8DD940327B28b,0xc0D58FE8abf4BD2519c83fb101866e71517D59D2
13364,15627920,740000,13220880778,729088,10912,2506,41661,0x5E3c7bdf06C35f88c6c0De739ed1c04767e330F9,0xBbf078A8849D74623e36E6DBBdC8e0a35E657C26
13365,15627920,401930,13220880778,398338,3592,1162,106,0x68b3465833fb72A70ecDF485E0e4C7bD8665Fc45,0x98aaf9BfbE917abdb2481543F0f46343F3f54C2E
13366,15627920,207128,13220880778,206472,656,138,4708723,0xdBdb4d16EdA451D0503b854CF79D55697F90c8DF,0x28C6c06298d514Db089934071355E5743bf21d60
13367,15627920,207128,13220880778,206460,668,138,4708724,0x0D8775F648430679A709E98d2b0Cb6250d2887EF,0x28C6c06298d514Db089934071355E5743bf21d60
13368,15627920,60000,13193157058,60000,0,2,25427,0x86aaAE8efeF7650dFEB18Fe26dEb992823a4004B,0x897b425dAB19Eb886Dc6Ae2010fE2A0de85308fa
13369,15627920,69906,13140880778,68962,944,138,72,0x6ADb2E268de2aA1aBF6578E4a8119b960E02928F,0x29BE0777A3Ab996D9086c33EbbC0153E2DcC5Dcb
13370,15627920,250294,12870880778,248330,1964,522,865,0xa6A496B715c8d8665650c79A4b5be4F450f0E323,0xd7918d20395F37bd36c57640aFe71E7Cf261D85F
13371,15627920,21000,12720880778,21000,0,2,1344,0x80C2fA12BD8009E0CC5F7b0F0A8F3d40236D1313,0xf54611A627aFA7c00a58569932554372dD3F4b3B
13372,15627920,220522,12720880778,213870,6652,1810,0,0x00000000006c3852cbEf3e08E8dF289169EdE581,0x3c1fd65750CbC6B02835Ecf540aFEad53b803b59
13373,15627920,55953,12720880778,55009,944,138,214,0x2b8beC81F648f327B7d8278EE74932845cDa3d19,0x25991B064289F1341b0eEDCF536f3688100c3790
13374,15627920,46267,12720880778,45691,576,74,980,0x283Af0B28c62C092C9727F1Ee09c02CA627EB7F5,0xA5b71Bac1a71C5c2A226B61E778C2a738Ff6b297
13375,15627920,71709,12720880778,69513,2196,458,92,0x74312363e45DCaBA76c59ec49a7Aa8A65a67EeD3,0xe331Fb1EdBe0EA0256d957C4955245404d5Ae124
13376,15627920,36015,12720880778,35751,264,74,2486,0xC02aaA39b223FE8D0A0e5C4F27eAD9083C756Cc2,0xba3c1983Fcb330D156Db75a14A14eb447CdDc7b2
13377,15627920,589713,12720880778,586061,3652,1162,226,0x68b3465833fb72A70ecDF485E0e4C7bD8665Fc45,0xcc533E119b8620F77F546D6C8f6D81BE8EaDF127
13378,15627920,56659,12720880778,55715,944,138,611,0xAD13C2a8d418d01F3236F4d8b9d724575a4e9d24,0x0254b349c49D1c3375453140Be3674C028C81251
13379,15627920,45897,12720880778,44953,944,138,597,0x57f1887a8BF19b14fC0dF6Fd9B2acc9Af147eA85,0x761989CF4dB9d6a878F924c91B53a68e647f28fC
13380,15627920,21000,12720880778,21000,0,2,932,0x49909013eb5F60c70Bda4D41aB9e85d5089F4b01,0xE64d73155F955e4E56061032f013B066C8C5B0eb
13381,15627920,181476,12720880778,179912,1564,394,106,0x1Fa8559e873f698292766790AeCf8080A66433F6,0xeeC1FC3C24B78107b8aA429CcA22133cc6979a60
13382,15627920,46083,12720880778,45595,488,138,323,0x79471Bb4CbB351a17Fa1EadB5B77AA76795c423a,0xB2cFE0c83cC4395889e779C44C1e33341Ea0155C
13383,15627920,46685,12720880778,46197,488,138,30,0x1699f71E5e77A2feaF62A386D773Ac7b5d62E72b,0xd86f5afd3F1A91f79aE811D078850d9ba04EF695
13384,15627920,46135,12720880778,45647,488,138,677,0x1Fa8559e873f698292766790AeCf8080A66433F6,0xcdBF676b4695444F3b53b76476b0C2866125F95c
13385,15627920,183231,12720880778,163683,19548,4682,420,0x00000000006c3852cbEf3e08E8dF289169EdE581,0xB8ef7f2082a0783aef1a8F85ecf89f06CD94F812
13386,15627920,157951,12720880778,151375,6576,1802,785,0x00000000006c3852cbEf3e08E8dF289169EdE581,0xfDdd273FbA4b480947eCE837f45f50ef3CBb8cBf
13387,15627920,51473,12720880778,50901,572,138,164,0x394E3d3044fC89fCDd966D3cb35Ac0B32B0Cda91,0xE24D6a761B11DF9e547D10512E7fEcc20Ac553Df
13388,15627920,46222,12720880778,45662,560,138,3,0xDCf68c8eBB18Df1419C7DFf17ed33505Faf8A20C,0x715A8689f2bF8A1cBE05D507Ba4CbC08CC756187
13389,15627920,21000,12720880778,21000,0,2,2700,0x03fD7A3C80efE94B59b5Ca61c40AD89b17d8647e,0xE2f9fC75984516748405cC2c184Fc7cF1Be11026
13390,15627920,45399,12720880778,44447,952,202,406,0xC86664e7d2608f881f796ee8E24FA9d4d7598406,0x7D3E5dD617EAF4A3d42EA550C41097086605c4aF
13391,15627920,21000,12720880778,21000,0,2,422,0x0a7737A209EefE1e0b484a6Ca210901BCf4004F8,0x370318A773705B314D68f4d82cf4cc12D07B5E9e
13392,15627920,209719,12720880778,207723,1996,466,56,0x1111111254fb6c44bAC0beD2854e76F90643097d,0x79cAF31d34521BD0a2a03a33a8119e09FcC80769
13393,15627920,209385,12720880778,206169,3216,1034,20,0x68b3465833fb72A70ecDF485E0e4C7bD8665Fc45,0xbb71cc02B7b5F2708Fd913889c90FBe3ECb14514
13394,15627920,21000,12720880778,21000,0,2,4,0xc4f6865d0ce53c780B1Ba4fb7C83DD106ec49cE3,0x6585Ef58B6e6C5217794Be782c521C489CD76f24
13395,15627920,750000,12720880778,747692,2308,586,251,0x9bC6369a2D947BdfAEdd74207d3589dbaFc48b52,0x17CDDeb2757Db0292ee94f74c50a67D89C548dd5
13396,15627920,203631,12720880778,197055,6576,1802,6,0x00000000006c3852cbEf3e08E8dF289169EdE581,0xE49403558aE1Cd6C82791A82dE88b4dccc7e3d5e
13397,15627920,750000,12720880778,747692,2308,586,2152,0x9bC6369a2D947BdfAEdd74207d3589dbaFc48b52,0x1c1D80d30F6f96cD288d9fD3E267f253220fD7C7
13398,15627920,750000,12720880778,747692,2308,586,281,0x9bC6369a2D947BdfAEdd74207d3589dbaFc48b52,0x4854C973f7DE13d8503a0133133F03Ee7FddA425
13399,15627920,21000,12720880778,21000,0,2,1607,0x1a9d02c3b92676DAd6a463b1e1446267CA59e462,0xaF589b5BbA5113e9733e44DAdFf8AdeC1438F8Fc
13400,15627920,46641,12720880778,46153,488,138,802,0x6B1B5FA2E50255A9a471b712C4245a422B9f5b70,0x0a5C6E05CEAA5E9C91C13bD9d8bf23ac8bd4B2D6
13401,15627920,3309676,12720880778,3308100,1576,394,2,0x7a250d5630B4cF539739dF2C5dAcb4c659F2488D,0x38834189F1F92BF15ad38DAe4cE58DBE52D28681
13402,15627920,750000,12720880778,747692,2308,586,3089,0x9bC6369a2D947BdfAEdd74207d3589dbaFc48b52,0x5BD8aCcB6d624bA8e0a9c017E02785144c0606Ac
13403,15627920,55950,12720880778,55006,944,138,510,0x6097004C68F7B350d72226003226Ac089597D579,0x918403Accc9F319c724E9e57d016dbA8CA6c7aae
13404,15627920,305908,12720880778,303572,2336,522,16,0x283Af0B28c62C092C9727F1Ee09c02CA627EB7F5,0x69a28644001eCA50420ef6B5Cb30D886936AeDAB
13405,15627920,21000,12720880778,21000,0,2,236,0x4814342Da5E3Ce70cbf01E990Af74741627fFfA2,0xca5b437dbc3c7f441f99C698d4B1FE1AA0599346
13406,15627920,209462,12720880778,207162,2300,522,243,0x283Af0B28c62C092C9727F1Ee09c02CA627EB7F5,0x8694918FFA878B8b53c54c11DF41f7BC574Fb2fd
13407,15627920,330890,12720880778,326882,4008,1226,312,0x68b3465833fb72A70ecDF485E0e4C7bD8665Fc45,0x71e2C21c470e84e096DFd5A4928dA84f78796818
13408,15627920,67254,12720880778,67050,204,74,43,0x9b9D659D4f2cF68b6616Cc0a65683f1951Eb725C,0xa04159bd2521f6d7Cd48083daD6c6c4D7dabCb7a
13409,15627920,110542,12720880778,109834,708,266,13,0x283Af0B28c62C092C9727F1Ee09c02CA627EB7F5,0x81932Fbbb63c11Cfa2Acc33b227BB184578F20EC
13410,15627920,21000,12720880778,21000,0,2,13,0x769d6f73d07c98B2E77b7fe89b357F4a8104E63a,0x6eF314FE7C08Cb78D58Df1995dE6CdF2060435F9
13411,15627920,46685,12720880778,46197,488,138,31,0x1699f71E5e77A2feaF62A386D773Ac7b5d62E72b,0xd86f5afd3F1A91f79aE811D078850d9ba04EF695
13412,15627920,371467,12720880778,338459,33008,10914,1329,0x00000000006c3852cbEf3e08E8dF289169EdE581,0x291362F270Db9bBFFF75ed70DfB07e54332810F0
13413,15627920,281826,12720880778,265822,16004,2250,205,0x3ee18B2214AFF97000D974cf647E7C347E8fa585,0xfE05fE13B4a2A2B03Bc62958CB95a4DC1137Af97
13414,15627920,51988,12720880778,51044,944,138,3,0x72B169AD8aF6c4FB53056b6a2A85602Ad6863864,0x40E255648795679a323D1A5b221327590Ad96988
13415,15627920,131198,12720880778,125114,6084,1682,26,0x00000000006c3852cbEf3e08E8dF289169EdE581,0x17D8Db5920a271125632dfF1Ca7e792365826789
13416,15627920,56322,12720880778,54974,1348,394,435,0xe4605d46Fd0B3f8329d936a8b258D69276cBa264,0x216A023E0c19382D895a66A76dd92E898c9BE3a7
13417,15627920,265413,12720880778,258825,6588,1802,928,0x00000000006c3852cbEf3e08E8dF289169EdE581,0x81F2c3C65C2D6707bf7B169EF0A8a6E6428faAE9
13418,15627920,182672,12720880778,179080,3592,1162,1420,0x68b3465833fb72A70ecDF485E0e4C7bD8665Fc45,0x98717560d065DbA4f8C259B9d079818489ad65C2
13419,15627920,46206,12720880778,45718,488,138,285,0x4E76Fc610dA679c9D07C7d640831AD6FF81E0252,0xaeB3EDE298560F26248368428AF2A290E77D9D31
13420,15627920,220569,12720880778,214637,5932,1738,3281,0x68b3465833fb72A70ecDF485E0e4C7bD8665Fc45,0x0B15b27E1739D96FB971DA481FFC2520157dCf66
13421,15627920,73188,12720880778,72580,608,138,92,0xA0b86991c6218b36c1d19D4a2e9Eb0cE3606eB48,0xf8027140e3A92817BA6749C080F8384381136bA0
13422,15627920,287097,12720880778,284785,2312,522,461,0x283Af0B28c62C092C9727F1Ee09c02CA627EB7F5,0x03d276d40979a7DBcdE3af4Df3543d253c11771B
13423,15627920,181533,12720880778,174869,6664,1810,1311,0x00000000006c3852cbEf3e08E8dF289169EdE581,0xe3a0e7d0d320ecb66b936A7D3B00F6A9Ee18DAbd
13424,15627920,389431,12720880778,385839,3592,1162,123,0x68b3465833fb72A70ecDF485E0e4C7bD8665Fc45,0x1DCcF2f39cf7Afc76e74068C8d954e7F79e2b101
13425,15627920,106670,12720880778,106466,204,74,0,0xd5dF338F6C32476ef2A3FB341416ddA981c0F310,0x37405653ed712Ed94bE6d95a4A5Dd78DdDf167df
13426,15627920,21000,12720880778,21000,0,2,215,0x316844B39c5Af69E6639Ad69844393B36174f1bb,0x938da74B558cb982b1B8fA834F009404ecc358bd
13427,15627920,21000,12720880778,21000,0,2,375,0x326709EcA2cD6e3D2D332EC6A30264C254fcEf83,0xc4fBCB5C649A94Ee5d72875aE3d71B92f8c049e7
13428,15627920,21000,12720880778,21000,0,2,848,0x3B976b02F913ef666bE129653686FC7a5DF46177,0xb689A89954C04C4a238697b64379810a666287ea
13429,15627920,36792,12720880778,36232,560,138,19,0xD95Be0e49472927AdAd417e5E62e2f087b8E210c,0x682Cad157D79d73Eb1D93d036B438d6F05084736
13430,15627920,144024,12720880778,140368,3656,714,1320,0x23E79722Bb8B55a0d04f3AFbCFC34eb771526Adb,0x4642D9D9A434134CB005222eA1422e1820508d7B
13431,15627920,59505,12720880778,59313,192,74,1834,0x03C1EafF32c4bd67ee750AB75Ce85BA7e5Aa65fB,0x62Fe7EFe0f3B58d93a3dE3063937409372A83686
13432,15627920,281845,12720880778,278505,3340,970,192,0x68b3465833fb72A70ecDF485E0e4C7bD8665Fc45,0x6BfE59e8fEaDDfBdBb97F7Da8c6B4550a8bD4ffd
13433,15627920,60393,12720880778,59961,432,74,1016,0xc7A03601Df9Fa1C032af8f806BAc2fB5034c5CfB,0xC75446A6AdaEF73269dBdEcE73536977B2b639e0
13434,15627920,46219,12720880778,45647,572,138,1720,0x1Fa8559e873f698292766790AeCf8080A66433F6,0x24F65FA44edd3165c221B370c055111c9AEdE2DE
13435,15627920,21000,12720880778,21000,0,2,3611,0xFb7A822A46d66c37b4632937c34A18DebaF96027,0x9308c261Dc19178a8b81C07b80CaaDe0fF057f6e
13436,15627920,46267,12720880778,45691,576,74,186,0x283Af0B28c62C092C9727F1Ee09c02CA627EB7F5,0x4Cf3f7C5B4fC7A14cfaFA3eD80D82F643c1DE8A4
13437,15627920,55897,12400489903,54953,944,138,15,0xFDBf91A7F2d757A9815326af5E1e60319571984c,0x30762F13B220765C6dCb0Cd6e87013dF3F8de924
13438,15627920,21000,12270880778,21000,0,2,1,0x2a0ab42e8389ce97fA5c81F9DdeC418f311b1e03,0xe6C8e27AdB28c19A27d30262CAEdDBf333e32c9e
13439,15627920,21000,12220880778,21000,0,2,1618,0x18b19a330C1B58c9965778e03A5C00FA0ea4F672,0x4e7F8A0da914Fa859E87d447b5366C5C1446a504
13440,15627920,181476,12220880778,179912,1564,394,555,0x1Fa8559e873f698292766790AeCf8080A66433F6,0xeA6CfAd957a0E008De4578D483b1bd5764f4c081
13441,15627920,401840,12220880778,398260,3580,1162,133,0x68b3465833fb72A70ecDF485E0e4C7bD8665Fc45,0x061d81bfbd139c9098036aeeB4D1475236BcAaF4
13442,15627920,181476,12220880778,179912,1564,394,16,0x1Fa8559e873f698292766790AeCf8080A66433F6,0xe94A9bb668bA80c771b982E02130365B319b5684
13443,15627920,181476,12220880778,179912,1564,394,139,0x1Fa8559e873f698292766790AeCf8080A66433F6,0x4cED29B1C7ec47d7a5A8A0711890d34B0F8fcfD1
13444,15627920,181476,12220880778,179912,1564,394,210,0x1Fa8559e873f698292766790AeCf8080A66433F6,0x6B4dE1bDc47cBD389312E5eeFC46F17aC20e1f34
13445,15627920,181476,12220880778,179912,1564,394,177,0x1Fa8559e873f698292766790AeCf8080A66433F6,0xeCDE97F066dCd1aAa86Fe8601B7F91eD0aB97481
13446,15627920,175110,12220880778,173546,1564,394,8,0x1Fa8559e873f698292766790AeCf8080A66433F6,0xF6F3683f3da8e791362FceF812c0846fB9C2e37f
13447,15627920,84000,12220880778,83392,608,138,24279,0xA0b86991c6218b36c1d19D4a2e9Eb0cE3606eB48,0xeA3d9B4743e20CE41777149A16e4eC97185d1487
13448,15627920,181476,12220880778,179912,1564,394,396,0x1Fa8559e873f698292766790AeCf8080A66433F6,0x11eA480d7c8d4f6c94b3B184d4BfF78e5fB5f4BA
13449,15627920,140406,12220880778,134386,6020,1674,392,0x00000000006c3852cbEf3e08E8dF289169EdE581,0x41D42207EDc025E219425Aa1b19013f7F8114fD7
13450,15627920,181476,12220880778,179912,1564,394,458,0x1Fa8559e873f698292766790AeCf8080A66433F6,0x84A4f9bd757d46D7E1Be58630BA7839d3FaB2EEf
13451,15627920,212020,12220880778,211780,240,74,1513,0x39AA39c021dfbaE8faC545936693aC917d5E7563,0x8726E46618D880da56E9004Ad2a845950190822f
13452,15627920,181458,12220880778,179906,1552,394,179,0x1Fa8559e873f698292766790AeCf8080A66433F6,0xaabCEe8F090038AE706f5e466EBEca9d5c3046eB
13453,15627920,112884,12220880778,112820,64,10,11,0xb55e1442EDA37d31249f97b3fCA6DEF588346FeF,0xaeB7314ea3D28C4153BA30878DEC47c0c1Ab86D8
13454,15627920,181476,12220880778,179912,1564,394,132,0x1Fa8559e873f698292766790AeCf8080A66433F6,0x64A2ae55019d13918C902b16Bea1214C860D899F
13455,15627920,181476,12220880778,179912,1564,394,70,0x1Fa8559e873f698292766790AeCf8080A66433F6,0xd03d5E53dd62D92fb20d7d989E1e0E1049a4eDD8
13456,15627920,181476,12220880778,179912,1564,394,10,0x1Fa8559e873f698292766790AeCf8080A66433F6,0x5C9e10516cC770AE1ea524C706368e96Af576A5b
13457,15627920,132325,12220880778,125921,6404,1674,12,0x00000000006c3852cbEf3e08E8dF289169EdE581,0xEC4a8bEfb811900607bF28E7958032E5fba71EA0
13458,15627920,181476,12220880778,179912,1564,394,211,0x1Fa8559e873f698292766790AeCf8080A66433F6,0x0C3d5D201872E6A96163a08b4Dc6ab4BA9b4aAb0
13459,15627920,21000,12220880778,21000,0,2,17441,0x61a6de2CD9a697780DAf355C117872845beba7C7,0x20bB82F2Db6FF52b42c60cE79cDE4C7094Ce133F
13460,15627920,181476,12220880778,179912,1564,394,63,0x1Fa8559e873f698292766790AeCf8080A66433F6,0x5CCb133Eb6cf87A2F2922AC53a9D85b0F5F284d6
13461,15627920,150756,12220880778,150692,64,10,3,0x65c2e54a4c75ff6da7b6B32369c1677250075fb2,0x3F4B497cDAA54e48514F54C9641F681dA8f44AeF
13462,15627920,328720,12220880778,326512,2208,650,106642,0xA69babEF1cA67A37Ffaf7a485DfFF3382056e78C,0x9AAb3F81604c683a1a0D14019FBfe15bef7aA1ee
13463,15627920,175110,12220880778,173546,1564,394,3668,0x1Fa8559e873f698292766790AeCf8080A66433F6,0x55f3bFB6a8AeE55EA567328e5560CC92eFDD9CCC
13464,15627920,181458,12220880778,179906,1552,394,1822,0x1Fa8559e873f698292766790AeCf8080A66433F6,0x63b5bfd8A6B18Ad2938139295F85a202c54eb47b
13465,15627920,181476,12220880778,179912,1564,394,131,0x1Fa8559e873f698292766790AeCf8080A66433F6,0xDfc044493EF3Ac75e270f6813bB6B10a3a8169A1
13466,15627920,181476,12220880778,179912,1564,394,534,0x1Fa8559e873f698292766790AeCf8080A66433F6,0x0aE8425F85757E767B322f128b10554578828849
13467,15627920,181476,12220880778,179912,1564,394,4,0x1Fa8559e873f698292766790AeCf8080A66433F6,0xDA7A7F4624FFBc47735190041371aE91Ba85c902
13468,15627920,181476,12220880778,179912,1564,394,31,0x1Fa8559e873f698292766790AeCf8080A66433F6,0x2bfc7f27dfc437fF6C84E0eD6C8859cdC8bcb651
13469,15627920,181458,12220880778,179906,1552,394,345,0x1Fa8559e873f698292766790AeCf8080A66433F6,0x693266D4a7a470295Cb8Be90D6503862dE509D4D
13470,15627920,175110,12220880778,173546,1564,394,23,0x1Fa8559e873f698292766790AeCf8080A66433F6,0xBd82CB46d4e9C554E6A2eb41237Eca1Faf1fd6eD
13471,15627920,181476,12220880778,179912,1564,394,248,0x1Fa8559e873f698292766790AeCf8080A66433F6,0x2f4Ac3A85d867655e7CFbd6cd9fB6106cE41a1bA
13472,15627920,181458,12220880778,179906,1552,394,13,0x1Fa8559e873f698292766790AeCf8080A66433F6,0x71B4787c3fe7aA36258C900D42C02D73E219C8Af
13473,15627920,288660,12220880778,286312,2348,522,1366,0x283Af0B28c62C092C9727F1Ee09c02CA627EB7F5,0x1f08CbFCa1f63a23bB6255a76e1DDeEb8D24d0Fa
13474,15627920,21000,12030983279,21000,0,2,874,0x34e619EF675d6161868CC16cf929F860F88242F7,0xc2db273c214cC03d6E7e5fafd4f3613eAD563435
13475,15627920,21000,11869339911,21000,0,2,5613,0xc8c62329aE33730B4c8A0208d95072b6A36A1cE3,0x2Cc3941D7E7a3Fa5d55D75b25748e497e4F83C46
13476,15627920,21000,11869339911,21000,0,2,2287,0x0E90687B87E1Bf60CF14d09a3176DA9B0d15E20D,0x4f24d8f60e0a6b8E2D51c23358a711b8212e71D0
13477,15627920,21000,11869339911,21000,0,2,3912,0xd2bF01ba9c9Fe1b3e70F23596680EA3cb1D0C997,0xF8956f7c427Ea6f2dc4B022e6b4a6B6EFEBcc4be
13478,15627920,21000,11762195380,21000,0,2,0,0x000F422887eA7d370FF31173FD3B46c8F66A5B1c,0x6f375F9Dd0f5D2A558451a89dfc744C69C4D8f42
13479,15627920,117206,11456802603,115038,2168,522,4035,0xE27d4Ed355e5273A3D4855c8e11BC4a8d3e39b87,0xa4ba90Fd7a3fa6830a8cDcc18e00309ba8c40c4B
13480,15627920,30000,11220880778,30000,0,2,641,0x388C818CA8B9251b393131C08a736A67ccB19297,0xf573d99385C05c23B24ed33De616ad16a43a0919
13481,15627921,309686,11659308735,307502,2184,650,111044,0xA69babEF1cA67A37Ffaf7a485DfFF3382056e78C,0x36a454aEF52938c8637CD4689B2980C1Cfd43389
13482,15627921,226782,11659308735,224634,2148,650,111465,0xA69babEF1cA67A37Ffaf7a485DfFF3382056e78C,0x065e3DbaFCb2C26A978720f9eB4Bce6aD9D644a1
13483,15627921,244024,11659308735,241888,2136,650,44524,0x5050e08626c499411B5D0E0b5AF0E83d3fD82EDF,0xe9F82f15910E161999777036e20CB4108F4Df800
13484,15627921,172700,11659308735,171976,724,130,12341,0xE8c060F8052E07423f71D445277c61AC5138A2e5,0xe2cA3167B89b8Cf680D63B06E8AeEfc5E4EBe907
13485,15627921,292856,69000000000,290960,1896,458,157,0x7a250d5630B4cF539739dF2C5dAcb4c659F2488D,0xf073598cA0CAFb8E0ad39f283339514eCC0B7a21
13486,15627921,156936,42916508920,155892,1044,170,12342,0xE8c060F8052E07423f71D445277c61AC5138A2e5,0xe2cA3167B89b8Cf680D63B06E8AeEfc5E4EBe907
13487,15627921,338978,19974171352,337938,1040,180,2274,0x9507c04B10486547584C37bCBd931B2a4FeE9A41,0x5D809525a9A1C4BEF5FeF0cEfa8269048e7d8DDE
13488,15627921,46563,12759309735,45619,944,138,704,0x43Ab765ee05075d78AD8aa79dcb1978CA3079258,0x37e189B454e70611042ac5c51179FE7d795d5238
13489,15627921,285295,12759309735,280179,5116,1420,705,0x881D40237659C251811CEC9c364ef91dC08D300C,0x37e189B454e70611042ac5c51179FE7d795d5238
13490,15627921,307602,54298281875,306322,1280,264,12173,0xBEEFBaBEeA323F07c59926295205d3b7a17E8638,0xab825b752143B0aFF895a353f598C1661a3A155B
13491,15627921,600000,50000000000,599056,944,138,2005,0x6097004C68F7B350d72226003226Ac089597D579,0xe7c5DE03987777a18FF279A5e8d8A91Dd91db688
13492,15627921,272797,42159308735,270453,2344,586,164,0x25553828F22bDD19a20e4F12F052903Cb474a335,0xdAF6ba5E1F897a807E158a84D4B968897050CED8
13493,15627921,21000,42030697049,21000,0,2,30145,0x3D51bAFdbA08536B7903f92b7a3C3bC43D7aD043,0x463E5b673d1029989c9B059d36393c539beF9094
13494,15627921,100000,32500000000,99308,692,138,0,0xa71d0588EAf47f12B13cF8eC750430d21DF04974,0xb2E09a7E5191e00A3deFcbEa7C932cBecB354F2f
13495,15627921,223072,20568711126,221756,1316,264,5080,0xBEEFBaBEeA323F07c59926295205d3b7a17E8638,0x789cDfE9F8AFE21717bc26Fd3f450f76fb37478a
13496,15627921,21000,18659308735,21000,0,2,1060,0x19F98944322036F391E5842c8b973473bC00a760,0x0C517c1DE86b49C2535236f181a220c0b55b7423
13497,15627921,21000,18659308735,21000,0,2,698,0x19F98944322036F391E5842c8b973473bC00a760,0x69b63ce04dBf9Bb21a3089b354a5d4f0c379536B
13498,15627921,100000,17185203904,99380,620,138,181443,0x473037de59cf9484632f4A27B509CFE8d4a31404,0x6238872A0Bd9F0E19073695532a7Ed77ce93C69E
13499,15627921,175110,15659308735,173546,1564,394,586,0x1Fa8559e873f698292766790AeCf8080A66433F6,0x690f7D46d22dc9fbD7253019c75b3E5f5bDa52e0
13500,15627921,181458,15659308735,179906,1552,394,40,0x1Fa8559e873f698292766790AeCf8080A66433F6,0x3eE8D0d8c49eff96e4c7e6D1A975c6309387B36f
13501,15627921,194692,15659308735,191932,2760,842,4279,0x68b3465833fb72A70ecDF485E0e4C7bD8665Fc45,0x0acf1B98Ae3a2084B729797116B0F5aD8d86a3EE
13502,15627921,69015,15569308735,67979,1036,202,4709957,0xc944E90C64B2c07662A292be6244BDf05Cda44a7,0x2FAF487A4414Fe77e2327F0bf4AE2a264a776AD2
13503,15627921,93836,15569308735,93240,596,138,4709958,0xdAC17F958D2ee523a2206206994597C13D831ec7,0x2FAF487A4414Fe77e2327F0bf4AE2a264a776AD2
13504,15627921,21000,15040000000,21000,0,2,0,0x6dfc34609a05bC22319fA4Cce1d1E2929548c0D7,0xa617e65683Dec55E718Fa3528b580844cf07b0F3
13505,15627921,21000,14963832769,21000,0,2,30,0xb7f5Ef20bD8a92ed2F8899762C62a9fB30b932F0,0xB164FbA6B8570cAb99e065aE8AcA949c3B346DA5
13506,15627921,273222,14659308735,270462,2760,842,531,0x68b3465833fb72A70ecDF485E0e4C7bD8665Fc45,0x96228749EaAb6Ea953787b9b5817762021581495
13507,15627921,55926,14659308735,54982,944,138,3090,0x978cB8306E6ed25867d0E2A88E127aC5a681Ad1B,0x5BD8aCcB6d624bA8e0a9c017E02785144c0606Ac
13508,15627921,243754,14659308735,237166,6588,1802,670,0x00000000006c3852cbEf3e08E8dF289169EdE581,0xCF76Abe378F0e9000B9de137c0BEdF87513d3541
13509,15627921,175110,14659308735,173546,1564,394,52,0x1Fa8559e873f698292766790AeCf8080A66433F6,0x12A64549ca10204E9693b7b2f143fC7693F26C02
13510,15627921,102249,14159308735,100957,1292,330,131,0xA0c68C638235ee32657e8f720a23ceC1bFc77C77,0x27684Cfc20021e3783DC1921a5eD31A454E17E02
13511,15627921,66334,14159308735,65382,952,202,7,0x1Fa8559e873f698292766790AeCf8080A66433F6,0xCA0b665BA1d169A850e93a58F96856D3e8474496
13512,15627921,49234,14159308735,48282,952,202,7,0x1Fa8559e873f698292766790AeCf8080A66433F6,0x963b2ae4Ed59955bd950e1B0378515Ed6B5D9f62
13513,15627921,66322,14159308735,65382,940,202,7,0x1Fa8559e873f698292766790AeCf8080A66433F6,0x5744B9849172709b8318074F00105Aa605aEA99A
13514,15627921,66285,14159308735,65333,952,202,7,0x1Fa8559e873f698292766790AeCf8080A66433F6,0xc90A4E96B034298ca77E77E87Bae416Ae24a88b9
13515,15627921,49234,14159308735,48282,952,202,7,0x1Fa8559e873f698292766790AeCf8080A66433F6,0xc90a85292DA5De6F7Aa18A81B1307101a40dDdA4
13516,15627921,21000,13662308735,21000,0,2,124699,0x99C68a628F4397c014cD2096cE564f711c404831,0x88DCdd4A0A58b7e2208805D547043c37dca2b6Dc
13517,15627921,131134,13659308735,125114,6020,1674,30,0x00000000006c3852cbEf3e08E8dF289169EdE581,0x2F5Ccdc5AEA3a53ED8587F4238e96B6420D2357A
13518,15627921,21000,13659308735,21000,0,2,83,0xe487c99619045DCf27a637E15CAbF456e2f3fef3,0x2EfE4C1536dbb50026638a5A329175f67bC15F9f
13519,15627921,21000,13659308735,21000,0,2,1712,0xc44C70fBFEf750862fbCf73F5197a28bCAA11253,0x9f82f46FCaeBE047BF0108e74eb8f7f2E1c0bC68
13520,15627921,151762,13659308735,150198,1564,394,2,0x1Fa8559e873f698292766790AeCf8080A66433F6,0xE259A53b82fF6D29D69eaeA78B746d34f076f9CC
13521,15627921,27938,13659308735,27874,64,10,1011,0xC02aaA39b223FE8D0A0e5C4F27eAD9083C756Cc2,0x40C52A227713F95Df575E0baF4A186025F1909E4
13522,15627921,151762,13659308735,150198,1564,394,2,0x1Fa8559e873f698292766790AeCf8080A66433F6,0x3aEE9bF5d3030C5b04255D823Cd75173a0290913
13523,15627921,151762,13659308735,150198,1564,394,2,0x1Fa8559e873f698292766790AeCf8080A66433F6,0x0D456EA3b8E4a1fc241754413e2Ca7918233B9FF
13524,15627921,181476,13659308735,179912,1564,394,409,0x1Fa8559e873f698292766790AeCf8080A66433F6,0xDa2A02C9F8B66f756f76d795D1ae0aD58788B009
13525,15627921,21000,13659308735,21000,0,2,5,0x18706BD79307495251184d97Eee110D003DdAC15,0x23f0FCfCAf53115b5b256b21265c2855b52F2ec4
13526,15627921,255859,13659308735,253075,2784,842,508,0x68b3465833fb72A70ecDF485E0e4C7bD8665Fc45,0x91CA602f60d8A7B2fC5610A5f0330078e10eda63
13527,15627921,181476,13659308735,179912,1564,394,836,0x1Fa8559e873f698292766790AeCf8080A66433F6,0x6f4c221f1c06ADb4bE502395a27D326178278f0E
13528,15627921,42000,13659308735,42000,0,2,329573,0xc7E240E5e2a1Fd14bD8c68cf5694D177acE280a9,0x9430801EBAf509Ad49202aaBC5F5Bc6fd8A3dAf8
13529,15627921,181476,13659308735,179912,1564,394,269,0x1Fa8559e873f698292766790AeCf8080A66433F6,0xd9038CfD0D2207E0771cC811e61C71715eD4b988
13530,15627921,200000,13659308735,199344,656,138,1374,0xBB0E17EF65F82Ab018d8EDd776e8DD940327B28b,0xc0D58FE8abf4BD2519c83fb101866e71517D59D2
13531,15627921,200000,13659308735,199344,656,138,1375,0xBB0E17EF65F82Ab018d8EDd776e8DD940327B28b,0xc0D58FE8abf4BD2519c83fb101866e71517D59D2
13532,15627921,207128,13659308735,207128,0,2,1312166,0x79E68088438B2A1fE2F545578A568fEEfe0731Bd,0xf60c2Ea62EDBfE808163751DD0d8693DCb30019c
13533,15627921,181458,13659308735,179906,1552,394,1704,0x1Fa8559e873f698292766790AeCf8080A66433F6,0x3Dadf855b9E30e63Bee10ec4D92cbFE789E5F8A8
13534,15627921,100000,13659308735,99036,964,202,88947,0xdAC17F958D2ee523a2206206994597C13D831ec7,0x3018018c44338B9728d02be12d632C6691E020d1
13535,15627921,39617,13659308735,39353,264,74,123,0xC02aaA39b223FE8D0A0e5C4F27eAD9083C756Cc2,0xfdDb0Bb81aee00D8E8D8d8dE1d9858C40405355f
13536,15627921,181476,13659308735,179912,1564,394,339,0x1Fa8559e873f698292766790AeCf8080A66433F6,0x67d80a7E5A24cCEDa37d3B525fEE067bd6b9EDDF
13537,15627921,535083,13439308735,526295,8788,2698,24,0x3b3ae790Df4F312e745D270119c6052904FB6790,0x9034B7e63b53Cd2ecF68D21b0c5Ecc097bE36b15
13538,15627921,72523,13160308735,71903,620,138,868,0xA0b86991c6218b36c1d19D4a2e9Eb0cE3606eB48,0xA5D62640081d2a1bc5deD398F2AA5aC6e463746b
13539,15627921,55897,13159308735,54953,944,138,215,0xFDBf91A7F2d757A9815326af5E1e60319571984c,0x4f102e320c8046242eEbaD43A6174678CCe1e8CC
13540,15627921,182930,13159308735,176126,6804,1802,3,0x00000000006c3852cbEf3e08E8dF289169EdE581,0xd8f5f16DB9e4CE0565B35cAe3b8015723d650956
13541,15627921,46127,13159308735,45639,488,138,578,0x9016067919813eDfDDAEdcDFCF62172411e3d6c8,0x3c13dC5662d437de2a4102dA3B00A8f57d5e1E20
13542,15627921,21000,13159308735,21000,0,2,15,0x5914B8f163375274266e49003D2985aECF237b6c,0x63615b60d97D64a7116B323117392ca3614249DE
13543,15627921,229264,13159308735,226540,2724,842,3083,0x68b3465833fb72A70ecDF485E0e4C7bD8665Fc45,0xE679647505254FA1129299cbfe4bC13a9520B45E
13544,15627921,132184,13159308735,125968,6216,1610,246,0x00000000006c3852cbEf3e08E8dF289169EdE581,0x941B4c03446EaC02902C30554EC683BaB3d40ff9
13545,15627921,196744,13159308735,195804,940,202,512,0x9DD4202AA5ee9625d1eaa671E2294014dd434E7E,0x1f2414D0af8741Bc822dBc2f88069c2b2907a840
13546,15627921,69163,13159308735,68555,608,138,793,0xdAC17F958D2ee523a2206206994597C13D831ec7,0x07EB3ca2225eCc0E42CfF3435Bc30b835030702b
13547,15627921,144983,13159308735,138383,6600,1802,1180,0x00000000006c3852cbEf3e08E8dF289169EdE581,0x8175e7fB3672B9c02060F569cd0F59BCBc47c643
13548,15627921,185169,13159308735,181565,3604,1162,252,0x68b3465833fb72A70ecDF485E0e4C7bD8665Fc45,0xC8b196167D19d4236112704dcf3FBb102dC8A425
13549,15627921,21000,13159308735,21000,0,2,51,0xDc1D18df7182b285a69502aB7C08d9a2AA2BDfae,0x620a94C66fc27881ed03bcb6D7e4De95f6fC9B17
13550,15627921,21000,13159308735,21000,0,2,8,0xe1e96037E29cD1dc4a2f289ECAF14Fd0f246C8bd,0x9079cCFb205fc1885a428421D49f901CB5f45Db4
13551,15627921,46267,13159308735,45691,576,74,104,0x283Af0B28c62C092C9727F1Ee09c02CA627EB7F5,0x0Bc1f13758ca0f1a166bd1d5B8CAf06d20378d25
13552,15627921,46256,13159308735,45768,488,138,17,0x50C43A5ad5f8DaA92beC15df5CFd9fbE7FbAC296,0xa376f588b524AFC30C7e3C0ecc26f207413023F2
13553,15627921,99244,13159308735,98636,608,138,208,0xA0b86991c6218b36c1d19D4a2e9Eb0cE3606eB48,0xe9031bFF3F17e1028507f05FecDc5639448BE9c0
13554,15627921,36015,13159308735,35751,264,74,301,0xC02aaA39b223FE8D0A0e5C4F27eAD9083C756Cc2,0xe5ae2923a8E55421AcfD1e19679B2104540D2Eb7
13555,15627921,46631,13159308735,46059,572,138,868,0xaE351b8Ae55B69A5007618E598dDe89d0a092c37,0xB8097Eb6344225D3D160202058640fd0E6f018D5
13556,15627921,68550,13159308735,68346,204,74,34,0xd5dF338F6C32476ef2A3FB341416ddA981c0F310,0x4b71BE4c8B4682C4d673bc3db401a608f181b58F
13557,15627921,45038,13159308735,44974,64,10,120,0xC02aaA39b223FE8D0A0e5C4F27eAD9083C756Cc2,0xDB5fC9080e87eA7C79fED93aB700a3f0DA094CF3
13558,15627921,152288,13159308735,141648,10640,3402,135,0x00000000006c3852cbEf3e08E8dF289169EdE581,0x5bF2eb73b153ec29b52018b90a2f9074bDdE70CF
13559,15627921,217771,13159308735,214987,2784,842,4033,0x68b3465833fb72A70ecDF485E0e4C7bD8665Fc45,0x1541681a72632143E412e918dA772DEaDF6DbC76
13560,15627921,176307,13159308735,164371,11936,3786,856,0x00000000006c3852cbEf3e08E8dF289169EdE581,0x05576913eea5d79B83f28f0Cb0D12BE54Fdae8dC
13561,15627921,55897,13159308735,54953,944,138,826,0xFDBf91A7F2d757A9815326af5E1e60319571984c,0x3FFc0798104E28AaA7B8d4F05C6193035d2916E3
13562,15627921,94795,13159308735,94199,596,138,16,0xdAC17F958D2ee523a2206206994597C13D831ec7,0x305D9BD99f3c9594a2883e10C9208D5649c0d47f
13563,15627921,21000,13159308735,21000,0,2,6,0xFFac163cCBb8b194D0e82a42318ce52EE97020e0,0x88fc3d68D7723770A189a8330B784616bB353C48
13564,15627921,49175,13159308735,48687,488,138,48,0x7f738Ad7072187909384B2ffBaEEdC3C1DA1b686,0x32E1953C3B4E96D3990fe21F611501150566FFB9
13565,15627921,56659,13159308735,55715,944,138,2061,0xda1f37F7d37bcE8ffc3Ef9188d853573236978E9,0x3461F903D434CCf3684D6f82d9F8833799Da177c
13566,15627921,166355,13159308735,159691,6664,1810,593,0x00000000006c3852cbEf3e08E8dF289169EdE581,0xcaAAec015A35499CAdC0229e7c73eC305643f444
13567,15627921,60751,13159308735,53271,7480,2506,645,0x00000000006c3852cbEf3e08E8dF289169EdE581,0x4a58085D2984b2AD2703F5fe9aEBD4352e66C6a5
13568,15627921,21000,13159308735,21000,0,2,0,0x759E19645c57A28D5db3151d9f5d07c7201C006C,0xD00d6f288b358768DB2a437584785a7E8c7fD90E
13569,15627921,250294,13159308735,248330,1964,522,565,0xa6A496B715c8d8665650c79A4b5be4F450f0E323,0xA9c16aBe6F97F35786669098D16b859826ffd737
13570,15627921,309052,13159308735,306648,2404,586,111,0xd9e1cE17f2641f24aE83637ab66a2cca9C378B9F,0xf8f4E0e229fDba143F64ba22F72141D0eCBB51Eb
13571,15627921,27938,13159308735,27874,64,10,311,0xC02aaA39b223FE8D0A0e5C4F27eAD9083C756Cc2,0x6A94d0f10b10A3fe04f8fDf9cAD7B0E08C5bc154
13572,15627921,21000,13159308735,21000,0,2,907,0xf2E9db3c5D06015833Df31eD3C37172a2B34EE7F,0x4248E7C9B1f45FC8C479eA9bE8db719c95B0dCA8
13573,15627921,55953,13159308735,55009,944,138,666,0xD371cE2BeB6b24195E790C561e4d86DD745E3c49,0xCaBA18AE3eD72886b64BFc24e79CD7A98137e536
13574,15627921,163881,13159308735,157217,6664,1810,749,0x00000000006c3852cbEf3e08E8dF289169EdE581,0x271824a5D9EDd3a1D2a039f2C3eEC50F8d213815
13575,15627921,94831,13159308735,94211,620,138,227,0xdAC17F958D2ee523a2206206994597C13D831ec7,0x8cdbaE227f436290035e292580E3e1081E0F669A
13576,15627921,56322,13159308735,54974,1348,394,436,0xe4605d46Fd0B3f8329d936a8b258D69276cBa264,0x216A023E0c19382D895a66A76dd92E898c9BE3a7
13577,15627921,215060,13159308735,212276,2784,842,86,0x68b3465833fb72A70ecDF485E0e4C7bD8665Fc45,0x3dbf7064e9403cf3Ed8e98A8F5338B43cd1Bc2bF
13578,15627921,163636,13159308735,160840,2796,842,167,0x68b3465833fb72A70ecDF485E0e4C7bD8665Fc45,0x7E56b14AA930Abb55E272D6f75f7612Bb6a4DfA2
13579,15627921,41244,13159308735,40600,644,138,93,0xf4d2888d29D722226FafA5d9B24F9164c092421E,0x978D38D8C4389E3B3b6293AEBfBd71b719627Cf1
13580,15627921,46102,13159308735,45614,488,138,41,0x6728d91abACdbac2f326baa384513a523C21b80a,0x97BFEf267e730191bB75Dc185788C5ba1B7866dE
13581,15627921,197401,13159308735,190813,6588,1802,824,0x00000000006c3852cbEf3e08E8dF289169EdE581,0xeE033638d44be47dc01495493985a7FD65Ce28Ee
13582,15627921,21000,13159308735,21000,0,2,2,0xD620Fc46d095eC2C86C730D05ad06E94043dBbAB,0x462C9C877E02B92142E4069aD595D9A11b7e7f7E
13583,15627921,56659,13159308735,55715,944,138,860,0x9431DE2DFE10BDB30995bd3791dE03a6c9570054,0x5E56B1E1e323454578319a7455cB3888Aa58d34E
13584,15627921,21000,13159308735,21000,0,2,2667,0xB3127EFc466AF0F5852631921caeacF584A84EBF,0xAC3588609F3B4BBabdAcC7A4c79b3Da8D50c954d
13585,15627921,234080,13159308735,231260,2820,842,5,0x68b3465833fb72A70ecDF485E0e4C7bD8665Fc45,0x4C8c749BC40fD35623bD36aB6FF0d9b761714D4B
13586,15627921,90000,13000000000,89404,596,138,0,0xdAC17F958D2ee523a2206206994597C13D831ec7,0x7178B4D9BF19C6Ad413E4442bD317f8c8428139F
13587,15627921,394107,12838917860,392671,1436,402,0,0x1111111254fb6c44bAC0beD2854e76F90643097d,0x7E0F7f873849f0A136E8801188c5Acd8fc94061d
13588,15627921,65000,12757134163,64404,596,138,646178,0xdAC17F958D2ee523a2206206994597C13D831ec7,0x29D5527CaA78f1946a409FA6aCaf14A0a4A0274b
13589,15627921,181476,12659308735,179912,1564,394,1217,0x1Fa8559e873f698292766790AeCf8080A66433F6,0x3ED2d52D20c7ac8a3FFA485747869DB1C964e28E
13590,15627921,181476,12659308735,179912,1564,394,855,0x1Fa8559e873f698292766790AeCf8080A66433F6,0x761cdBa599259be2Af5a70923cFFC9CFb78ED8d5
13591,15627921,181476,12659308735,179912,1564,394,226,0x1Fa8559e873f698292766790AeCf8080A66433F6,0x2957Ea63F3C8677EBBf6A7c01B60A2BddfC308Db
13592,15627921,181458,12659308735,179906,1552,394,143,0x1Fa8559e873f698292766790AeCf8080A66433F6,0xCdf70B6A000839B8be0472736Ffc6A32E1c529ef
13593,15627921,260758,12659308735,256950,3808,970,93266,0xa57Bd00134B2850B2a1c55860c9e9ea100fDd6CF,0xFF82BF5238637B7E5E345888BaB9cd99F5Ebe331
13594,15627921,59056,12659308735,58092,964,394,2366,0x645E9324f4be25be581BB62163cfa86c40b01D07,0xc5009AFEd2D6DA219538aD165998F63B553185B1
13595,15627921,200000,12659308735,199404,596,138,63861,0xdAC17F958D2ee523a2206206994597C13D831ec7,0x17F1a51dA68d27c94D2a51d92B27B5Bd4718b986
13596,15627921,144531,12659308735,137931,6600,1802,129,0x00000000006c3852cbEf3e08E8dF289169EdE581,0xD6FC130672dED55A50C276499a87936ffF08262D
13597,15627921,181476,12659308735,179912,1564,394,24,0x1Fa8559e873f698292766790AeCf8080A66433F6,0x8D89092aA5Fd2D60eb31A9eAaFA67A3Ff90B409F
13598,15627921,181476,12659308735,179912,1564,394,236,0x1Fa8559e873f698292766790AeCf8080A66433F6,0xFc41ccc0f67918a3054189FA9630881ff773F5D3
13599,15627921,181476,12659308735,179912,1564,394,292,0x1Fa8559e873f698292766790AeCf8080A66433F6,0x9A85650B98e01E2F49866219c8B20daFb2020529
13600,15627921,181458,12659308735,179906,1552,394,113,0x1Fa8559e873f698292766790AeCf8080A66433F6,0x01FaA4a40BAeA58c5Ebe62D54BaF08adb079472b
13601,15627921,518840,12659308735,515164,3676,1162,72,0x68b3465833fb72A70ecDF485E0e4C7bD8665Fc45,0x6Dca426F1B8c1b953dA60f1fa9a6Ce5b15aa62D4
13602,15627921,270836,12659308735,268616,2220,650,91232,0xA69babEF1cA67A37Ffaf7a485DfFF3382056e78C,0x4603180BBB8221157880AfaA84638E0fc467738D
13603,15627921,181476,12659308735,179912,1564,394,17,0x1Fa8559e873f698292766790AeCf8080A66433F6,0xC993e4EE116C67E4DD3Fdc368469cE5eF614FFe1
13604,15627921,120000,12659308735,119392,608,138,57311,0xdAC17F958D2ee523a2206206994597C13D831ec7,0xCfC0F98f30742B6d880f90155d4EbB885e55aB33
13605,15627921,175110,12659308735,173546,1564,394,187,0x1Fa8559e873f698292766790AeCf8080A66433F6,0x6c0e4a334687bc237F8E0141DC30bA4e72BcD917
13606,15627921,126531,12659308735,126327,204,74,773,0x9b9D659D4f2cF68b6616Cc0a65683f1951Eb725C,0x8101D517d48672392c99dDBE6A5422369C9904A7
13607,15627921,181476,12659308735,179912,1564,394,31,0x1Fa8559e873f698292766790AeCf8080A66433F6,0x5E1a6D27f59Cd8e3853a49f0787E3421c5A992Ce
13608,15627921,181476,12659308735,179912,1564,394,17,0x1Fa8559e873f698292766790AeCf8080A66433F6,0xe94A9bb668bA80c771b982E02130365B319b5684
13609,15627921,181476,12659308735,179912,1564,394,778,0x1Fa8559e873f698292766790AeCf8080A66433F6,0x1bdc2Ee071e91D69CbBbC493876322eFeFbE55b7
13610,15627921,43051,12659308735,42847,204,74,6,0x9b9D659D4f2cF68b6616Cc0a65683f1951Eb725C,0xA616036C23f7e851A322199b2bEbf43B319ef7D2
13611,15627921,181476,12659308735,179912,1564,394,1244,0x1Fa8559e873f698292766790AeCf8080A66433F6,0x2D2Ee6478397Ba3923db7aeEc852121D7CCCc13C
13612,15627921,148298,12469411236,142214,6084,1682,14,0x00000000006c3852cbEf3e08E8dF289169EdE581,0xFfee27d51710C1449290a8BE509F35D472E24dC2
13613,15627921,150000,12228261217,149392,608,138,638780,0xA0b86991c6218b36c1d19D4a2e9Eb0cE3606eB48,0x55FE002aefF02F77364de339a1292923A15844B8
13614,15627921,21000,12000000000,21000,0,2,3,0x4209312b6B86C5A12a97daf47EC8BB0158E3857f,0x0C98135d2e700ECc114cdB9F8a5d1Ff45c5CCd5E
13615,15627921,181476,12000000000,179912,1564,394,123,0x1Fa8559e873f698292766790AeCf8080A66433F6,0x6e6cc183b3fe832c435B8ddFBfb2F2a2F6589262
13616,15627921,394729,11895230560,169477,225252,28340,183261,0x5E4e65926BA27467555EB562121fac00D24E9dD2,0x6887246668a3b87F54DeB3b94Ba47a6f63F32985
13617,15627921,30000,11659308735,30000,0,2,3678,0xd4E96eF8eee8678dBFf4d535E033Ed1a4F7605b7,0xF2f5C73fa04406b1995e397B55c24aB1f3eA726C
13618,15627922,300014,15213502435,298462,1552,394,224464,0x98C3d3183C4b8A650614ad179A1a98be0a8d6B8E,0x91aaE0aAfd9D2d730111b395c6871f248d7Bd728
13619,15627922,21000,14330000000,21000,0,2,0,0x6dfc34609a05bC22319fA4Cce1d1E2929548c0D7,0xA9870662B3C791b866E12C866478c1838a6144A1
13620,15627922,94813,13213502435,94205,608,138,323,0xdAC17F958D2ee523a2206206994597C13D831ec7,0xcEc07Cf2cAce4eA5cA2b65E58b307E9eFD2a2845
13621,15627922,21000,12714502435,21000,0,2,113058,0xAEa84Ece577c0E0b066a13213bf84a4275E4b77b,0x6081258689a75d253d87cE902A8de3887239Fe80
13622,15627922,247431,12713502435,244611,2820,842,6,0x68b3465833fb72A70ecDF485E0e4C7bD8665Fc45,0x7D237E1D82b0f7fe4fd9Fa466271d758e6450ffb
13623,15627922,46135,12713502435,45647,488,138,813,0x1Fa8559e873f698292766790AeCf8080A66433F6,0x96AbdBa824368eE3C8DeAdEaD045031Ab711e624
13624,15627922,21000,12713502435,21000,0,2,1109,0x0999B2c385Bf38E353453730294bBf3d1E894a9D,0x7Db5c1EFCEbE4ce04af24D3B9Ec2FFD528cF2493
13625,15627922,21000,12713502435,21000,0,2,143,0x0bb965d3719758192579550561F74B709D64C10f,0x508a16689A01Ed33a784237ec955E3679F21ec48
13626,15627922,142015,12713502435,135451,6564,1802,109,0x00000000006c3852cbEf3e08E8dF289169EdE581,0x2Fb99221fb673D1bed25204C069879206b481715
13627,15627922,97318,12713502435,82690,14628,4874,336,0x00000000006c3852cbEf3e08E8dF289169EdE581,0xe987408Df55bcCaDa83447cc1ECfbE5765655f4E
13628,15627922,181476,12213502435,179912,1564,394,80,0x1Fa8559e873f698292766790AeCf8080A66433F6,0x143C9491cb649545d9D058163051Dece9252C0bB
13629,15627922,181476,12213502435,179912,1564,394,13,0x1Fa8559e873f698292766790AeCf8080A66433F6,0xe5C10f5ACfd55e81f290C035401A0687dEb831e9
13630,15627922,187160,12134772362,185988,1172,330,12,0x8e8bd01b5A9eb272CC3892a2E40E64A716aa2A40,0xFABeF7a37A26Cf99DDB4989C18e4c75fA7C8953e
13631,15627922,21000,12030697049,21000,0,2,9,0xd5FBDa4C79F38920159fE5f22DF9655FDe292d47,0xa1f0F2D744C1E4447618394B519C1E03F6AFA799
13632,15627922,344214,11449424260,342390,1824,458,31,0x0c17e776CD218252ADFca8D4e761D3fe757e9778,0x79735697A4940d8DB192cB1133d5aE586b433bDE
13633,15627923,312070,81000000000,310174,1896,458,710,0x7a250d5630B4cF539739dF2C5dAcb4c659F2488D,0x3dFdB240Fb476624CCAC60084F3a1F8d146e1ab9
13634,15627923,312070,78000000000,310174,1896,458,1708,0x7a250d5630B4cF539739dF2C5dAcb4c659F2488D,0xf95249038E13A289f04449360de20C7609B920eF
13635,15627923,2000000,78000000000,1998224,1776,458,314,0x7a250d5630B4cF539739dF2C5dAcb4c659F2488D,0xbc026e51b422C55Ce664ce8B7Aa97121Cf934aEB
13636,15627923,420000,33000000000,419392,608,138,1226080,0xdAC17F958D2ee523a2206206994597C13D831ec7,0x5041ed759Dd4aFc3a72b8192C143F72f4724081A
13637,15627923,100000,33000000000,99392,608,138,23,0xdAC17F958D2ee523a2206206994597C13D831ec7,0xBB620924664F8614E429e3d1f2b3263C655E8b67
13638,15627923,100000,33000000000,99392,608,138,5,0xA0b86991c6218b36c1d19D4a2e9Eb0cE3606eB48,0xeB1cdb6012C2ac001B2124EF80BEF8248e246ED5
13639,15627923,100000,33000000000,99344,656,138,934,0x32353A6C91143bfd6C7d363B546e62a9A2489A20,0xA5E0D1Bd2F42c7C0d17B89789fb9da5CFF933ed0
13640,15627923,248563,30000000000,246739,1824,458,2183,0x25553828F22bDD19a20e4F12F052903Cb474a335,0x26899847Cc940eCB4425445E96AF8a0CA90CAAA3
13641,15627923,219341,28724597431,217305,2036,522,355,0x7a250d5630B4cF539739dF2C5dAcb4c659F2488D,0x788296BAb7c874416c34BB5d7Bc0eb2170c97334
13642,15627923,190330,24928099866,184030,6300,1802,1943,0x00000000006c3852cbEf3e08E8dF289169EdE581,0xB58007c1990a0ae29f0D34543714BAf168149F82
13643,15627923,238999,18000000000,232687,6312,1802,9537,0x00000000006c3852cbEf3e08E8dF289169EdE581,0xAa5D1125DcD349455dC5f04911BcB315Af10C847
13644,15627923,350000,17842845840,350000,0,2,6925091,0xB4ABA757b9C3686Cc92d03f89027082A16e8B602,0x46340b20830761efd32832A74d7169B29FEB9758
13645,15627923,350000,17842845840,349392,608,138,6925092,0xdAC17F958D2ee523a2206206994597C13D831ec7,0x46340b20830761efd32832A74d7169B29FEB9758
13646,15627923,900000,17000000000,898152,1848,458,1917,0x7a250d5630B4cF539739dF2C5dAcb4c659F2488D,0xF8d45C9204dEfE8B4Bd4A4961a708D4689094bbf
13647,15627923,21000,16928099866,21000,0,2,2047,0xdF0422f0d8A237Ad6932DA41263a3E24AEAbb42f,0x19F98944322036F391E5842c8b973473bC00a760
13648,15627923,21000,15038371311,21000,0,2,0,0x8B729972a559EaA746e1D8Cf16d2Af8E78F38957,0xC23eeF9c874Df891B0ACEc2B27Fa2dA325E6b9a2
13649,15627923,2000000,15000000000,1999056,944,138,315,0x2b8beC81F648f327B7d8278EE74932845cDa3d19,0xbc026e51b422C55Ce664ce8B7Aa97121Cf934aEB
13650,15627923,600000,14928099866,598012,1988,522,1123,0x7a250d5630B4cF539739dF2C5dAcb4c659F2488D,0xe8d3861316f5732c96559eCFf25701c7aDc7ca7b
13651,15627923,600000,14928099866,598012,1988,522,1975,0x7a250d5630B4cF539739dF2C5dAcb4c659F2488D,0xb46E6dAefED2591385FD5214d0E42806a2d4f2C6
13652,15627923,21000,14870000000,21000,0,2,705900,0x31fF67b5DdCE13C58114eBBE3FE218F08f4bB7Fe,0x6dfc34609a05bC22319fA4Cce1d1E2929548c0D7
13653,15627923,62778,14690700000,62122,656,138,318359,0x95aD61b0a150d79219dCF64E1E6Cc01f0B64C4cE,0x562680a4dC50ed2f14d75BF31f494cfE0b8D10a1
13654,15627923,77773,14465056933,77093,680,138,7,0xd2877702675e6cEb975b4A1dFf9fb7BAF4C91ea9,0xe9292bFD1AaB4e689E3C87723912A9F1d85c849a
13655,15627923,63000,13842838627,63000,0,2,2710072,0x18C8256FFA8ed84923BE6f0816133c2d10937Af5,0xC098B2a3Aa256D2140208C3de6543aAEf5cd3A94
13656,15627923,21000,13000000000,21000,0,2,0,0x7A20527ba5a749b3b054a821950Bfcc2C01b959f,0x2663859Ef9aFB8aEB0bC472663d7c25053660b74
13657,15627923,21000,13000000000,21000,0,2,130,0x7A20527ba5a749b3b054a821950Bfcc2C01b959f,0x92fb397c0Cf18F62218d31894fBB521A119D8740
13658,15627923,21000,13000000000,21000,0,2,4,0x7A20527ba5a749b3b054a821950Bfcc2C01b959f,0x4A196Dea7D3ea9eE7Fec185f4d9d356ad65cDB8d
13659,15627923,180000,13000000000,179392,608,138,444364,0xA0b86991c6218b36c1d19D4a2e9Eb0cE3606eB48,0x48c04ed5691981C42154C6167398f95e8f38a7fF
13660,15627923,495184,12451000000,491000,4184,1098,302802,0x10A0847c2D170008dDCa7C3a688124f493630032,0xF27696C8BCa7D54D696189085Ae1283f59342fA6
13661,15627923,49234,12428099866,48282,952,202,7,0x1Fa8559e873f698292766790AeCf8080A66433F6,0xb3665a5c5639dB0cf3BCfe6DE9273CEDC7917d89
13662,15627923,49234,12428099866,48282,952,202,7,0x1Fa8559e873f698292766790AeCf8080A66433F6,0xB525bde9Af7518fb240ABE591919235e043349a8
13663,15627923,49234,12428099866,48282,952,202,7,0x1Fa8559e873f698292766790AeCf8080A66433F6,0x9B950CC83be64E97592d98ACDaA818B6866d053F
13664,15627923,49234,12428099866,48282,952,202,7,0x1Fa8559e873f698292766790AeCf8080A66433F6,0xb4F6060f1338faBC924bc33461DF47E156D775Bb
13665,15627923,49222,12428099866,48282,940,202,7,0x1Fa8559e873f698292766790AeCf8080A66433F6,0xBC8824821C9335A30eb73a3700C1d8890E5cbEfB
13666,15627923,21000,12030697049,21000,0,2,2,0x4d846dA8257BB0Ebd164EFf513DfF0F0c2C3c0ba,0x8a8C6E80E33b1fc2A4d82E0Cc24c22B33f52eCCe
13667,15627923,283791,12000000000,269903,13888,4618,89,0x83C8F28c26bF6aaca652Df1DbBE0e1b56F8baBa2,0x49d7def8525bEB30f6201aDF61f285ef55a9A9a5
13668,15627923,158488,12000000000,156416,2072,522,63,0x7a250d5630B4cF539739dF2C5dAcb4c659F2488D,0x387EB5232d64578b5689e21B90B0ABB51a3C24D1
13669,15627923,120000,11929099866,119392,608,138,23490,0xdAC17F958D2ee523a2206206994597C13D831ec7,0xD42f958E1C3e2a10e5d66343c4c9a57726E5b4b6
13670,15627923,50000,11929099866,50000,0,2,4,0xE4b3dD9839ed1780351Dc5412925cf05F07A1939,0x42274080309a6Ea30E1f5E9A0D9DA706ea00CcCA
13671,15627923,46114,11928099866,45626,488,138,125,0x9a54988016E97Fdc388D1b084BcbfE32De91b70c,0x289F868D13e034b891fb343DD82F291dD37aEEdd
13672,15627923,200000,11928099866,199344,656,138,1376,0xBB0E17EF65F82Ab018d8EDd776e8DD940327B28b,0xc0D58FE8abf4BD2519c83fb101866e71517D59D2
13673,15627923,31582,11928099866,31582,0,2,6,0xB4375E8aaCf0147aDf6B2a296c61Ad6141010c37,0x8Fbbb24Bf54C0Bf2BdD86A79a910e5d33d01F5B5
13674,15627923,247933,11928099866,242881,5052,1292,30,0x881D40237659C251811CEC9c364ef91dC08D300C,0x40757FD82C0F07794623Fa9990Dc0ef7e31afE3b
13675,15627923,42000,11928099866,42000,0,2,329574,0x0695df53E8DC73FBf4d1c0De38C57af745FFfD51,0x9430801EBAf509Ad49202aaBC5F5Bc6fd8A3dAf8
13676,15627923,80000,11928099866,79056,944,138,0,0xdAC17F958D2ee523a2206206994597C13D831ec7,0x0938330abF1EB9aaC8F8FdD89f371049D332E65C
13677,15627923,70602,11928099866,69902,700,202,5,0x6097004C68F7B350d72226003226Ac089597D579,0xCCA6815482a886227eA5f751445505fbA516215a
13678,15627923,144283,11928099866,137683,6600,1802,882,0x00000000006c3852cbEf3e08E8dF289169EdE581,0xBB056df720a0A0e149eA91300EED071ACDD7ce27
13679,15627923,191077,11928099866,190177,900,266,509,0xd588b586D61C826A0e87919b3D1a239206d58bf2,0x7a58dD25E105e8fA10Aa1A28E4983d9e1a12eA44
13680,15627923,21000,11928099866,21000,0,2,0,0x00B2A45369Eb31c8B0dC9e426045292140F14803,0x999c43e62c0BEF38B3012ed85C73E54be2158B9C
13681,15627923,131198,11928099866,125114,6084,1682,109,0x00000000006c3852cbEf3e08E8dF289169EdE581,0x856e4119E8A49fe269b43270F91aE81F374Ca492
13682,15627923,151748,11928099866,150324,1424,522,63,0x08038283d6710bF62C8Ac76E53E6dA8E8dc4f787,0x1Dc0BA9941847A96F096d25018Df844176066FCA
13683,15627923,389460,11928099866,385844,3616,1162,1234,0x68b3465833fb72A70ecDF485E0e4C7bD8665Fc45,0x2B473732FdD9e90D2BAb7433dA2eE55Cdf6b0248
13684,15627923,545070,11708099866,533662,11408,3210,3,0x3b3ae790Df4F312e745D270119c6052904FB6790,0xF1a043d838197D9AC9577e9eCB83069aE14fa2dd
13685,15627923,21000,11456802603,21000,0,2,1093,0x507515e2330F439DA0112C60b0E037a446269140,0x052B52deB866d3878943484F778303e494F3D260
13686,15627923,55636,11456802603,54692,944,138,479,0xC02aaA39b223FE8D0A0e5C4F27eAD9083C756Cc2,0xa0Be587B81F5f829f70c3329B3cA3868871a9024
13687,15627923,84000,11429099866,83392,608,138,57312,0xA0b86991c6218b36c1d19D4a2e9Eb0cE3606eB48,0xCfC0F98f30742B6d880f90155d4EbB885e55aB33
13688,15627923,123782,11428099866,122814,968,330,37,0x4e32004D8b81847A670b4a1778ACe4dCF2bBA01E,0x333Fb10911383F0a2FeB08d937763e72aA6a3191
13689,15627923,49175,11428099866,48687,488,138,505,0xD27dcbcC8778a8AB33AAc529Df36a634567Be325,0x5711328D6Ad4C27D320E0BE0109e9C003Ef0548F
13690,15627923,21000,11428099866,21000,0,2,147,0x60cb03B643eCCACc5D4a266ED0ffCE657C8870b8,0xB767864f566F97BBB4cD83A0C90B5D9050B27D19
13691,15627923,46280,11428099866,45420,860,138,380,0xC02aaA39b223FE8D0A0e5C4F27eAD9083C756Cc2,0xB5938f76a5850caDeb1F1705bA18A7ae76C897F2
13692,15627923,269745,11428099866,221693,48052,13858,327,0x9EbFB53Fa8526906738856848A27cB11b0285C3f,0xf3d705f9e80552B14D2c07421435d4d84d2b9332
13693,15627923,426008,11428099866,403596,22412,7818,2143,0x00000000006c3852cbEf3e08E8dF289169EdE581,0xCD6DE4e6Ae74267D3eb35cb8e9fbf62da41dB47D
13694,15627923,21000,11428099866,21000,0,2,174,0xDc1D18df7182b285a69502aB7C08d9a2AA2BDfae,0xaa75b925561E6944711b014617767b699C3c4966
13695,15627923,46707,11428099866,46219,488,138,257,0xbef7Dcc0335Ec876e2DC530b883F34c8807d61fc,0xECC417CDbdcE37dda762eB873b836e45Cd2eC1E6
13696,15627923,216992,11428099866,216928,64,10,531,0xBBe3B63484345148D32feabE0912c308a60c879a,0xDB10364CeCe4497a30306706Ba8926264962afD2
13697,15627923,192963,11428099866,190143,2820,842,367,0x68b3465833fb72A70ecDF485E0e4C7bD8665Fc45,0x10EEB1575CAd64A73453b91863f4d81886A68a02
13698,15627923,228723,11428099866,225927,2796,842,29,0x68b3465833fb72A70ecDF485E0e4C7bD8665Fc45,0xe2e5fdBb737057769A55ea8b93D4e8CB81FF631b
13699,15627923,112914,11428099866,112710,204,74,6,0x6250b989ecf7cb82c7892E1CEA604eD813423635,0x8f1CBa5C1F9580BdaF7baD07d1eB4679f02Aa1C0
13700,15627923,182893,11428099866,176041,6852,1802,0,0x00000000006c3852cbEf3e08E8dF289169EdE581,0xf5Ac5Cf5391a129fdF15614Ec9dB52Dee0e3E065
13701,15627923,56803,11428099866,56315,488,138,266,0xc9a0B20D522AeeAC5d8D6ba13146a073A97B326A,0xc3c87912c081d990898113302F12afAc36DDAEf9
13702,15627923,60393,11428099866,59961,432,74,1017,0x6F12179123AB3A9D112b54F7a4Cdd80B11e2bb57,0xC75446A6AdaEF73269dBdEcE73536977B2b639e0
13703,15627923,21000,11428099866,21000,0,2,1412,0x71AD62e97D6e81b6cA51DB64a895ff11A8e4D2Ac,0xaFaA9247B7B0e246A41b1C26337c5E2FE0d6A598
13704,15627923,244796,11428099866,242024,2772,842,100,0x68b3465833fb72A70ecDF485E0e4C7bD8665Fc45,0x2A0fd32DbF864f54858450F02990D39ee464d67f
13705,15627923,92640,11428099866,92436,204,74,45,0x5D004ddB5D92938dAF8448b9eac1CaA593cd26Ca,0xBfFEa57972fc6BD0498992CE29FFb8c14B904327
13706,15627923,183274,11428099866,176686,6588,1802,898,0x00000000006c3852cbEf3e08E8dF289169EdE581,0x3529CA4112d14f217f4E8eb4a2469968C803b55F
13707,15627923,21000,11428099866,21000,0,2,861,0xF20164Eb95a0B7B5447BAeA8a426FC942D40c0Fc,0x1eCd3CaFE9D421B4e6D4892aAA3aD82AFb28E396
13708,15627923,46108,11428099866,45532,576,74,2,0x8F0b256F2e94962587a0159089Fa1E390085447F,0x23180E88bdE1fc5EA9278a41c75a1D35Aeab73FE
13709,15627923,67544,11428099866,66068,1476,458,24,0x5BABc381C7E9EdCF02654a9C30d384dFE54dd4A1,0x030ce9d143332f6D9c287414f08e22c145c43c58
13710,15627923,21000,11428099866,21000,0,2,52,0x8ddd8d371a3F1E31DEA3adc873a6426cc02ce0c9,0xCb5069DCcd57720f48cd9672DdCC5C22f6C2DfB1
13711,15627923,46122,11428099866,45634,488,138,59,0xf54cC94f1F2f5De012B6Aa51F1E7eBdc43Ef5afC,0x9ae6F872bD544Cd20b7086Aab5E965C1E219348a
13712,15627923,46102,11428099866,45614,488,138,26,0x8DFf3cA05B40ACA78DB00F10Ecd9Eb486a13DA2F,0xE478415F71F9a87Df0963BE9660884179637FfaB
13713,15627923,292029,11428099866,277513,14516,4746,90,0x83C8F28c26bF6aaca652Df1DbBE0e1b56F8baBa2,0x2833CBA7aCd5Fccfbe35b1eaBa9E5D7daDDa4C1a
13714,15627923,426008,11428099866,403596,22412,7818,98,0x00000000006c3852cbEf3e08E8dF289169EdE581,0x385c8730a59e32Fc3D493C503CCaEaDc929e43E0
13715,15627923,21000,11428099866,21000,0,2,1980,0xCCf76579Fb8049D6F9546E50F6CaB6123Eab9B1b,0x79cF2507732dF36C6514dcdC1cfB20ae83cF5B5D
13716,15627923,46267,11428099866,45691,576,74,156,0x283Af0B28c62C092C9727F1Ee09c02CA627EB7F5,0x7b89Ad468ECE05D4F437691d0079BcedB042A4c2
13717,15627923,48117,11428099866,47165,952,202,16,0xd4A6669E4787f23A2f711e0b6c6fb5431Ce1594e,0xe71134adC4E393e163DdfF65F0D9BF6f62c647BC
13718,15627923,46267,11428099866,45691,576,74,318,0x283Af0B28c62C092C9727F1Ee09c02CA627EB7F5,0xAbD4d2b15ED7C40A2a37a5C4eb4d204ba6F208dd
13719,15627923,132289,11428099866,125921,6368,1674,1053,0x00000000006c3852cbEf3e08E8dF289169EdE581,0x2F741CB460b60ddef6a11E585F1d0F2F101d9277
13720,15627923,213207,11428099866,211135,2072,522,733,0x7a250d5630B4cF539739dF2C5dAcb4c659F2488D,0x4B90760Cb2174939934e8AAC629E49C75624485D
13721,15627923,238886,11428099866,235246,3640,1162,78,0x68b3465833fb72A70ecDF485E0e4C7bD8665Fc45,0xC8F06c6a16d060B1Cb8d880655Cf7Ad5E1C6522D
13722,15627923,99244,11428099866,98636,608,138,3,0xA0b86991c6218b36c1d19D4a2e9Eb0cE3606eB48,0xe307272471be5FfABaEd1EBE5dDB80cB5C0E2c8a
13723,15627923,46267,11428099866,45691,576,74,41,0x283Af0B28c62C092C9727F1Ee09c02CA627EB7F5,0xA23fC447AF5609258F9DFc3B0Beb1fD344902A83
13724,15627923,252643,11428099866,233299,19344,4862,142,0x97f66251C3DCaD07c373cd46d6287959fe6698CF,0xd1ecD014788e5ba060b6EA5994dcC882574C0d99
13725,15627923,69414,11428099866,68746,668,138,31,0x5e4Efb364071C64Ee3641fe1E68cB5d2D5558709,0xeefAbcb1e2a276a6bB3Ea4489b2982cC7a6F9A94
13726,15627923,55951,11428099866,55007,944,138,599,0xe4b4C008Ff36E3C50c4299c223504a480DE9C833,0x306a2bA64dD4a810a0eC1CED08Cb2acC38bE8f4C
13727,15627923,206774,11428099866,187262,19512,4682,829,0x00000000006c3852cbEf3e08E8dF289169EdE581,0x42fc5B36C9143424D728197b5177f9D3aBd292E5
13728,15627923,220438,11428099866,218386,2052,650,396,0x72Ce9c846789fdB6fC1f34aC4AD25Dd9ef7031ef,0xf0D55F2476bb2b7CE8e9b1F924444A364D6fb731
13729,15627923,46206,11428099866,45634,572,138,60,0xf54cC94f1F2f5De012B6Aa51F1E7eBdc43Ef5afC,0x9ae6F872bD544Cd20b7086Aab5E965C1E219348a
13730,15627923,21000,11428099866,21000,0,2,101,0x9F0773aF2b1d3f7cC7030304548A823B4E6b13bB,0x5bF4eD7f13CD6441834aa0a1aD65D0b79D478951
13731,15627923,165081,11428099866,158481,6600,1802,80,0x00000000006c3852cbEf3e08E8dF289169EdE581,0xF2C0272D384393f3DD8F5F9C4691838aBA74C4E8
13732,15627923,65000,11428099866,64404,596,138,646179,0xdAC17F958D2ee523a2206206994597C13D831ec7,0x29D5527CaA78f1946a409FA6aCaf14A0a4A0274b
13733,15627923,21000,11428099866,21000,0,2,3282,0xB1C438BE81560a91317498AC82763Bf94e506464,0x0B15b27E1739D96FB971DA481FFC2520157dCf66
13734,15627923,80000,11189507832,79056,944,138,0,0x4d224452801ACEd8B2F0aebE155379bb5D594381,0x8e7124D0157a917E1ED4446370180A74a2D57b4a
13735,15627923,80000,11189507832,79056,944,138,0,0xA0b86991c6218b36c1d19D4a2e9Eb0cE3606eB48,0xf4280eFa9DCFFA2C36f4E8AB27C5566CBB40c86B
13736,15627923,191113,11189507832,190189,924,266,91,0xd588b586D61C826A0e87919b3D1a239206d58bf2,0x710E29C9c3bD8904Eb3d993b05E1bE418Bc715aa
13737,15627923,191077,11189507832,190177,900,266,157,0xd588b586D61C826A0e87919b3D1a239206d58bf2,0xFF714e5735424170352E19f0Fcd4Ccb87E86BF2C
13738,15627923,289090,11028099866,286694,2396,522,301,0x283Af0B28c62C092C9727F1Ee09c02CA627EB7F5,0xc4120B8DF72d6A41cD1ed721266c86463B2C978a
13739,15627923,160000,10928099866,159796,204,74,48,0xb967D2335A3879b7CAE42E085f88274EBff90Fc4,0xbf587D2527a4D956a57f777bC310De9385A8B2dB
13740,15627923,55950,10928099866,55006,944,138,4034,0x6097004C68F7B350d72226003226Ac089597D579,0x1541681a72632143E412e918dA772DEaDF6DbC76
13741,15627923,181458,10928099866,179906,1552,394,92,0x1Fa8559e873f698292766790AeCf8080A66433F6,0x620eF02986117d20c1E1927F878B9Fa6306AC7c8
13742,15627923,181476,10928099866,179912,1564,394,21,0x1Fa8559e873f698292766790AeCf8080A66433F6,0xc7CAEd4e09e90ede3153aa3062f2bE170662e7b6
13743,15627923,110760,10928099866,110152,608,138,147,0xA0b86991c6218b36c1d19D4a2e9Eb0cE3606eB48,0x93750D820cA511BCf9d98bE98FB011bE5703CcAe
13744,15627923,21000,10837481745,21000,0,2,0,0x8EB871bbB6F754a04bCa23881A7D25A30aAD3f23,0x55f29b16cd828d6b72b97138736Ae5Bc76142f58
13745,15627923,21000,10736709239,21000,0,2,4,0xBe86277CeEC00a776d021561bC8952fDad5691cC,0xA20C2dfB2952A75e4F372981A3c1Cd3404aFA9fA
13746,15627923,248214,10399943516,246814,1400,402,247,0x1111111254fb6c44bAC0beD2854e76F90643097d,0x17aFdC04CA1D732b3A376Fb9A8131F35D894f563
13747,15627923,21000,10321411186,21000,0,2,92744,0x6202cBd922c40ad27919Ac11d374c4a6189b4741,0xF1300cc9c2Cf347f7902742fEC4dF9dbA952fD7b
13748,15627923,21000,10321411186,21000,0,2,92745,0x7B4c70EabaC082c088a3143Ee8AeC52025B4d0bF,0xF1300cc9c2Cf347f7902742fEC4dF9dbA952fD7b
13749,15627923,28920,10298029227,28668,252,74,73,0x17C8F5aE96487967CE72E78a2A52E0711A87772E,0xBa412D28e82D6f087C7D155c5875A46C97a82442
13750,15627923,94510,10164021691,93306,1204,394,74263,0xa35375621bC9BfC0f264B8eafee1216254fa5DB9,0xC77dCE01a98ebc40f76B2d1F403e52d55b74FdED
13751,15627923,94510,10164021691,93306,1204,394,74264,0xa35375621bC9BfC0f264B8eafee1216254fa5DB9,0xC77dCE01a98ebc40f76B2d1F403e52d55b74FdED
13752,15627923,21000,10164021691,21000,0,2,157062,0x04c9C7f57b8f2Cd22959CBc504C4F0C9c5DDc9f0,0x8C8D7C46219D9205f056f28fee5950aD564d7465
13753,15627923,91668,10164021691,90728,940,202,7,0xe0EcC6D8BbD4Bb40faf348f35C21B120621bBc4D,0x5c37D7eDdB52c1572e6511739529865e14D16300
13754,15627923,29012,10085489361,28820,192,74,10,0xda1f37F7d37bcE8ffc3Ef9188d853573236978E9,0x062d96Dfc60e90c2C40BBA382e3EbA9D3fB91901
13755,15627923,49175,10034203750,48687,488,138,79,0xAC126d5b28852d4392772C07e2C35CDF19571e05,0x58Be12fb15B03D55E4bc91Fbd1F6f9472C45395b
13756,15627923,250000,10000000000,249216,784,202,128518,0x92f0fB6a6Ebcd7c32123288144C7B8C7fbF86021,0xa2AA74D8542a917a51601F0105e03feBbDE52Eed
13757,15627923,250000,10000000000,249000,1000,202,128519,0x92f0fB6a6Ebcd7c32123288144C7B8C7fbF86021,0xa2AA74D8542a917a51601F0105e03feBbDE52Eed
13758,15627923,4386253,10000000000,4081285,304968,102794,143,0x83C8F28c26bF6aaca652Df1DbBE0e1b56F8baBa2,0x888874E5ab7b4F0955Fc07f3400016Ab2e948888
13759,15627923,59607,10000000000,59179,428,138,16,0xC141E3f45c669f2B8EefDb08B2BA3F7C16531bf7,0x27Cda06B00a0ecCF4225371792DdE8f1a5eA97EB
13760,15627923,630403,10000000000,626811,3592,1162,166,0x68b3465833fb72A70ecDF485E0e4C7bD8665Fc45,0x0bAc86B90BdB587edB4aa4033B56341F9C12A643
13761,15627923,191078,10000000000,190178,900,266,151,0xd588b586D61C826A0e87919b3D1a239206d58bf2,0xdF2B5ae21772d879068eC6df25eFBa8Cfb2089b4
13762,15627923,90000,10000000000,89392,608,138,29,0xdAC17F958D2ee523a2206206994597C13D831ec7,0xd59532027cC171FcC6ae4FC1a2fA8bE410aCa818
13763,15627923,244398,10000000000,243966,432,74,10,0xa6439Ca0FCbA1d0F80df0bE6A17220feD9c9038a,0xeEFa187c470437c2C36877bb24A5e36e88945e84
13764,15627923,120000,9994520072,119380,620,138,501,0xdAC17F958D2ee523a2206206994597C13D831ec7,0x2728D0FA57565e58dA5d291bb621E00887A50c73
13765,15627924,309658,9976455586,307474,2184,650,106643,0xA69babEF1cA67A37Ffaf7a485DfFF3382056e78C,0x9AAb3F81604c683a1a0D14019FBfe15bef7aA1ee
13766,15627924,71000,107163831272,71000,0,2,2279,0xa9AA32D4f5442bA135C199d310E80eA2e9FbD866,0xa9AA32D4f5442bA135C199d310E80eA2e9FbD866
13767,15627924,233644,9976455586,231460,2184,650,131301,0xA69babEF1cA67A37Ffaf7a485DfFF3382056e78C,0x60b86AF869f23aEb552fB7F3CaBD11B829f6Ab2F
13768,15627924,172924,9976455586,172188,736,130,5203,0xE8c060F8052E07423f71D445277c61AC5138A2e5,0x971aC48e6F904406edBC22687ED92Bc8966fe551
13769,15627924,286437,30000000000,284565,1872,458,0,0x25553828F22bDD19a20e4F12F052903Cb474a335,0xec092892e4d59B14f39B7afe3De98A683b11F0Dc
13770,15627924,157159,83209468940,156103,1056,170,5204,0xE8c060F8052E07423f71D445277c61AC5138A2e5,0x971aC48e6F904406edBC22687ED92Bc8966fe551
13771,15627924,71000,20543477836,71000,0,2,2280,0x5d983B5A96D5d0d6140Ec0BAAa2c9Da7Ff4CA4C3,0x5d983B5A96D5d0d6140Ec0BAAa2c9Da7Ff4CA4C3
13772,15627924,21000,346622994946,21000,0,2,5166,0x63B7F7C47F5410d3ce86A715dF97F46283187167,0x63B7F7C47F5410d3ce86A715dF97F46283187167
13773,15627924,655796,59336754229,655796,0,2,97409,0x76e40D0a69Fd81826B5eb7D18145626d46EAFdef,0x76e40D0a69Fd81826B5eb7D18145626d46EAFdef
13774,15627924,942240,54129534407,940168,2072,522,100,0x7a250d5630B4cF539739dF2C5dAcb4c659F2488D,0x24B97B003D4BffFd8d05B907582DA2E283a84389
13775,15627924,21000,50000000000,21000,0,2,1,0x8b8a4abc707F16dA24B795e3e46ed22975A9D329,0x16c9dd1EDD52630e79156239a1a2D4F6fa590EA0
13776,15627924,268410,50000000000,256870,11540,3594,582,0x74312363e45DCaBA76c59ec49a7Aa8A65a67EeD3,0xc06D1452131F83b803026949eaF837820faE2095
13777,15627924,700000,47066767089,698708,1292,378,12309,0xBEEFBaBEeA323F07c59926295205d3b7a17E8638,0x9aB9742Af41EF177e0d6136b0f4094aC2f2Df1Bf
13778,15627924,860039,38500000000,858063,1976,522,7020,0x7a250d5630B4cF539739dF2C5dAcb4c659F2488D,0x8FFdD83b2C1541e661c2437B1887844654E050c9
13779,15627924,600000,35000000000,598000,2000,522,662,0x7a250d5630B4cF539739dF2C5dAcb4c659F2488D,0x19B17B12AE586670E9Df3dC982Ea74d8fb83fa6F
13780,15627924,21000,33000000000,21000,0,2,34,0xA7EFAe728D2936e78BDA97dc267687568dD593f3,0x7a5578Cdf35702EE6525CBc520F8605E95EA2fC3
13781,15627924,210000,33000000000,210000,0,2,843598,0x1ba6830c65436C42A06bAffa2f2180B2A2aE90C9,0xA7EFAe728D2936e78BDA97dc267687568dD593f3
13782,15627924,71000,32807642616,71000,0,2,17369,0x69E906c33722F61b854929cd2c6f3427dea9f090,0x69E906c33722F61b854929cd2c6f3427dea9f090
13783,15627924,90000,21000000000,89404,596,138,12624,0x05237E2bd2dfAb39a135d254cABAE94b183C8baD,0xFd25F5A3415e29f0AeeB5746E5D513DE67169225
13784,15627924,306391,19976455586,299979,6412,1738,802,0x00000000006c3852cbEf3e08E8dF289169EdE581,0x265fE3F979598c8a90437CC9aD24DECEB83477F1
13785,15627924,237729,19000000000,231593,6136,1738,637,0x00000000006c3852cbEf3e08E8dF289169EdE581,0xD8c7117D0FBbc5ed73578d61A09A54B81297886A
13786,15627924,55953,19000000000,55009,944,138,456,0x2b8beC81F648f327B7d8278EE74932845cDa3d19,0x5717cdf4bE7BdAed7fE58d12718969dde6211592
13787,15627924,238999,18000000000,232687,6312,1802,575,0x00000000006c3852cbEf3e08E8dF289169EdE581,0xae57349a0C3507b180DF0965a64b8879d2656560
13788,15627924,164127,17101439778,162531,1596,230,2387,0x9507c04B10486547584C37bCBd931B2a4FeE9A41,0xe25a92c98356E7F18702d83107E83EB6fF9abDe5
13789,15627924,100000,16449424260,100000,0,2,28983,0x6615B81d6B014E6E7B19B29dcDEc8BE75ED34D3e,0x5bdf85216ec1e38D6458C870992A69e38e03F7Ef
13790,15627924,100000,16449424260,100000,0,2,4,0xe6a421f24d330967a3Af2F4cDB5c34067E7e4d75,0xa3A08E72f155E8d2A44AE7829ed56a3a33EEDEb5
13791,15627924,90000,16000000000,89392,608,138,1,0xdAC17F958D2ee523a2206206994597C13D831ec7,0xB44A134b235239FD48542c08C820ca35bcAe422F
13792,15627924,600000,15976455586,598164,1836,458,6,0x7a250d5630B4cF539739dF2C5dAcb4c659F2488D,0x801F5b36a7bEB854340bF999CD5CEddB1f75D655
13793,15627924,600000,15976455586,598176,1824,458,6,0x7a250d5630B4cF539739dF2C5dAcb4c659F2488D,0x078cFdf223F7d92B4672ec7299aF4F00bf1Ad318
13794,15627924,96691,15928099866,95143,1548,458,0,0x0BABA1Ad5bE3a5C0a66E7ac838a129Bf948f1eA4,0xF371Cd13429C463C4E87645A2B8056B2eD51218D
13795,15627924,21000,15038371311,21000,0,2,0,0x3b8621b120f7888a906281cf1003E980b407fBBD,0x250C083F0261d2C8eb6b228c19dcd84657702EA3
13796,15627924,140000,15000000000,139048,952,202,295,0x1Fa8559e873f698292766790AeCf8080A66433F6,0x7F312CbF084229166d246d512CB36eDC4902953F
13797,15627924,140000,15000000000,139048,952,202,296,0x1Fa8559e873f698292766790AeCf8080A66433F6,0x7F312CbF084229166d246d512CB36eDC4902953F
13798,15627924,140000,15000000000,139048,952,202,297,0x1Fa8559e873f698292766790AeCf8080A66433F6,0x528502Cfc640fdB4eC2349AB2A9645236b12b23B
13799,15627924,140000,15000000000,139048,952,202,298,0x1Fa8559e873f698292766790AeCf8080A66433F6,0x528502Cfc640fdB4eC2349AB2A9645236b12b23B
13800,15627924,140000,15000000000,139048,952,202,299,0x1Fa8559e873f698292766790AeCf8080A66433F6,0xDFc946bdd0Ec165d8865A133223C4589C81c1099
13801,15627924,140000,15000000000,139048,952,202,300,0x1Fa8559e873f698292766790AeCf8080A66433F6,0xDFc946bdd0Ec165d8865A133223C4589C81c1099
13802,15627924,140000,15000000000,139048,952,202,298,0x1Fa8559e873f698292766790AeCf8080A66433F6,0x661279325BcAbbA343E9368377BB20e53C79667B
13803,15627924,140000,15000000000,139060,940,202,360,0x1Fa8559e873f698292766790AeCf8080A66433F6,0xf96a7Df1C5a8d06E00b1609F914388817BbE2D52
13804,15627924,140000,15000000000,139060,940,202,361,0x1Fa8559e873f698292766790AeCf8080A66433F6,0xf96a7Df1C5a8d06E00b1609F914388817BbE2D52
13805,15627924,140000,15000000000,139048,952,202,299,0x1Fa8559e873f698292766790AeCf8080A66433F6,0x661279325BcAbbA343E9368377BB20e53C79667B
13806,15627924,140000,15000000000,139048,952,202,413,0x1Fa8559e873f698292766790AeCf8080A66433F6,0xCE5f56E421cB5428B91AD586Da37e2a68095cd82
13807,15627924,140000,15000000000,139048,952,202,414,0x1Fa8559e873f698292766790AeCf8080A66433F6,0xCE5f56E421cB5428B91AD586Da37e2a68095cd82
13808,15627924,140000,15000000000,139048,952,202,442,0x1Fa8559e873f698292766790AeCf8080A66433F6,0x7870A3B083752D8F9a79AA78E35D4105120C4174
13809,15627924,140000,15000000000,139048,952,202,589,0x1Fa8559e873f698292766790AeCf8080A66433F6,0xa75be179dc8B36d24F0FdD02aaC8b5740Ec5B615
13810,15627924,140000,15000000000,139048,952,202,443,0x1Fa8559e873f698292766790AeCf8080A66433F6,0x7870A3B083752D8F9a79AA78E35D4105120C4174
13811,15627924,140000,15000000000,139048,952,202,710,0x1Fa8559e873f698292766790AeCf8080A66433F6,0x646ef8b85fd521ab48f214330C563B7B3a15dAE4
13812,15627924,140000,15000000000,139048,952,202,711,0x1Fa8559e873f698292766790AeCf8080A66433F6,0x646ef8b85fd521ab48f214330C563B7B3a15dAE4
13813,15627924,140000,15000000000,139048,952,202,590,0x1Fa8559e873f698292766790AeCf8080A66433F6,0xa75be179dc8B36d24F0FdD02aaC8b5740Ec5B615
13814,15627924,342572,15000000000,340688,1884,458,1918,0x7a250d5630B4cF539739dF2C5dAcb4c659F2488D,0xF8d45C9204dEfE8B4Bd4A4961a708D4689094bbf
13815,15627924,500000,14996455586,499056,944,138,356,0xe4b4C008Ff36E3C50c4299c223504a480DE9C833,0x788296BAb7c874416c34BB5d7Bc0eb2170c97334
13816,15627924,34706,14884251538,34074,632,138,1210296,0x6B175474E89094C44Da98b954EedeAC495271d0F,0x912fD21d7a69678227fE6d08C64222Db41477bA0
13817,15627924,21000,14465056933,21000,0,2,7,0x4526FF4322E9B4CcD52BE38758bb52c573415cC6,0x27e74103AD1418620D8243f8D41b9Efd770c42d4
13818,15627924,79352,14000000000,78744,608,138,137,0xA0b86991c6218b36c1d19D4a2e9Eb0cE3606eB48,0xa9D74B47D9e6F9C0F7E5ff95026373394d683d1D
13819,15627924,211003,14000000000,210659,344,138,7414,0x89Bb49d06610B4b18e355504551809Be5177f3D0,0x09564716E12eB2ca51f64d07d76AA88b7CDC0283
13820,15627924,80149,13891194347,79493,656,138,4709959,0xdBdb4d16EdA451D0503b854CF79D55697F90c8DF,0x2FAF487A4414Fe77e2327F0bf4AE2a264a776AD2
13821,15627924,21000,13740000000,21000,0,2,26,0x292f04a44506c2fd49Bac032E1ca148C35A478c8,0x51D33275856E769e121459A2dDf7242E370FEA57
13822,15627924,600000,13035995073,598756,1244,330,42,0x89B5919bCD78363B15A9C4CC25E90eE49c9caCbE,0x6be0860D624ede3FCdBdA3C4e2A16485aF3ce2Aa
13823,15627924,21000,12976455586,21000,0,2,2148,0x35C5A0DD05ceaFe438d085F3A94c59d568b9cE81,0x0Dc30Dd2f950ef800D14a945eBd02a0031AAF4Db
13824,15627924,56659,12976455586,55715,944,138,532,0xA1360d1Ba4462Ef0B60614f75A0C82E6e9EFdB51,0x96228749EaAb6Ea953787b9b5817762021581495
13825,15627924,403918,12976455586,402474,1444,394,6,0x663A5C229c09b049E36dCc11a9B0d4a8Eb9db214,0x9A4140FFB57D5272ea009c37a18D2A88B54e6063
13826,15627924,21000,12710000000,21000,0,2,0,0x6dfc34609a05bC22319fA4Cce1d1E2929548c0D7,0xd75d6ed8B21C2e9D58cf2a41746806e83f93Ff3a
13827,15627924,52287,12602482863,52083,204,74,18,0x9c5Fb504f12C0ce864A8B0e6B03dE5D9204FE2a3,0xC6DF6e7113979FCe34bd9F1f5eC0833552a0b6a9
13828,15627924,100000,12594366686,100000,0,2,862752,0x50F08d263997dDc92D6131D173804745e1717324,0xA910f92ACdAf488fa6eF02174fb86208Ad7722ba
13829,15627924,21000,12594366686,21000,0,2,0,0xA910f92ACdAf488fa6eF02174fb86208Ad7722ba,0xD227ca993ef9574704Fa35c63b57Ea99B68cA8B2
13830,15627924,122299,12476455586,121599,700,202,130,0x6D7c44773C52D396F43c2D511B81aa168E9a7a42,0xA2950A8Fd11c5a6Dd2F18B51ede439071B6B51e8
13831,15627924,49234,12476455586,48282,952,202,7,0x1Fa8559e873f698292766790AeCf8080A66433F6,0x8c6E43dEDaB5A769E11BdC34aB78c87A2b5E5765
13832,15627924,305890,12476455586,298890,7000,970,23,0x9b3B6974531d8AA15A87908FFd821A64863Ede5B,0x8479FafF3f2371eFdF95E22D0c61cE83c7783204
13833,15627924,49234,12476455586,48282,952,202,7,0x1Fa8559e873f698292766790AeCf8080A66433F6,0x74bde8483142E1e8406A0CeD63628C241D9152aF
13834,15627924,49234,12476455586,48282,952,202,7,0x1Fa8559e873f698292766790AeCf8080A66433F6,0xb22fcad95fe15024c3b05BDDDACc1b8b6c49C76F
13835,15627924,49234,12476455586,48282,952,202,7,0x1Fa8559e873f698292766790AeCf8080A66433F6,0x3380728Cac7b5b4eb1BC8630E04603655F70aD01
13836,15627924,49234,12476455586,48282,952,202,7,0x1Fa8559e873f698292766790AeCf8080A66433F6,0xc544064fcc802a0Cfa9a5e5F7E9F369356aD30D4
13837,15627924,800000,12476455586,798188,1812,458,376,0x7a250d5630B4cF539739dF2C5dAcb4c659F2488D,0x6B485D535E2e6116F82576024B6fEa09b9E1D693
13838,15627924,260918,12451559754,259662,1256,264,12037,0xBEEFBaBEeA323F07c59926295205d3b7a17E8638,0x608B724283F1DDeC86D8F6d4F7F6F51964E8b18D
13839,15627924,150000,12371746703,149392,608,138,12,0xA0b86991c6218b36c1d19D4a2e9Eb0cE3606eB48,0x988E8841Bf28096b2245E1ba5A2d0240486AD08f
13840,15627924,21000,12021895473,21000,0,2,19,0x52A258ED593C793251a89bfd36caE158EE9fC4F8,0x58dacf1cA22BA8279E1D1cD356b00863cb01E20B
13841,15627924,75000,12000000000,74380,620,138,11,0xdAC17F958D2ee523a2206206994597C13D831ec7,0x0685b3741498e02123627C297aD0ca9Da0eb2A2E
13842,15627924,229649,12000000000,227789,1860,458,33,0x7a250d5630B4cF539739dF2C5dAcb4c659F2488D,0xf9Ee594F55d7B6c087c34399FE26c86D9A03BBf3
13843,15627924,120000,11977455586,119392,608,138,17,0xdAC17F958D2ee523a2206206994597C13D831ec7,0x42f76c174269B14687BDCe6C98631397900F599d
13844,15627924,126531,11976455586,126327,204,74,2055,0x9b9D659D4f2cF68b6616Cc0a65683f1951Eb725C,0x508B610a51bed4F2C8fF98CfD820271DA7AC231A
13845,15627924,656090,11976455586,654054,2036,522,590,0x7a250d5630B4cF539739dF2C5dAcb4c659F2488D,0x15A15Fe79A268668eEc2573F81E67Bd648B3c1B9
13846,15627924,21000,11976455586,21000,0,2,2759954,0xAf819d0e374eb8Fc9538204f254a011BBCB364b6,0x267be1C1D684F78cb4F6a176C4911b741E4Ffdc0
13847,15627924,25054,11976455586,25054,0,2,2759955,0x5494BA41C2daA11099D1231328b56CdBD679f437,0x267be1C1D684F78cb4F6a176C4911b741E4Ffdc0
13848,15627924,240444,11976455586,237684,2760,842,897,0x68b3465833fb72A70ecDF485E0e4C7bD8665Fc45,0x44FFCb49cf4F143267d5e3EE74532e1BB7b39236
13849,15627924,484648,11976455586,477152,7496,2058,8,0xe66B31678d6C16E9ebf358268a790B763C133750,0x04EA98704d506Fbd367959EeC46F9B83cEE2EE92
13850,15627924,207128,11976455586,206520,608,138,1312167,0xdAC17F958D2ee523a2206206994597C13D831ec7,0xf60c2Ea62EDBfE808163751DD0d8693DCb30019c
13851,15627924,21000,11976455586,21000,0,2,7,0x519DD79A19ECbb2E3a326D61e8C9680551FCe35b,0xee4c5167EB3f22D741A64e76DccC9dca438db95E
13852,15627924,52017,11976455586,51065,952,202,1068,0x1Fa8559e873f698292766790AeCf8080A66433F6,0xe713a75d8bc2f29F42b0d2C2BE3370E65A62b5Eb
13853,15627924,46677,11976455586,45733,944,138,924,0x853d955aCEf822Db058eb8505911ED77F175b99e,0x5C7ca6A93a46aE786D99D91ED423A91d6fa13879
13854,15627924,480891,11976455586,445899,34992,12242,2702,0x00000000006c3852cbEf3e08E8dF289169EdE581,0x41a420856b3828462eA555c736cAa93Ccf022391
13855,15627924,174212,11976455586,172400,1812,458,0,0xd9e1cE17f2641f24aE83637ab66a2cca9C378B9F,0xAa6ccDA870B6b6fdF97907766470156b13abFBd7
13856,15627924,21000,11976455586,21000,0,2,121,0x490d124dC58eb1a2f9d5d1170F93222BF9EEB717,0x42dC5b0C6b22b5284Ee870ef59D91abF216641C9
13857,15627924,139048,11976455586,138368,680,138,47,0x2b8beC81F648f327B7d8278EE74932845cDa3d19,0x2dACB9CD9b7CF4c3F0b21EF2212cB3Ba085a52c3
13858,15627924,42000,11976455586,42000,0,2,329575,0x86e3776b83fF7362ba07581aF1d9C2e024ED89b6,0x9430801EBAf509Ad49202aaBC5F5Bc6fd8A3dAf8
13859,15627924,207128,11976455586,206484,644,138,4708725,0x6B175474E89094C44Da98b954EedeAC495271d0F,0x28C6c06298d514Db089934071355E5743bf21d60
13860,15627924,207128,11976455586,207128,0,2,1679544,0xeF9Cd3DbD6Be5D231E886253f73edF8F7d336E16,0x4976A4A02f38326660D17bf34b431dC6e2eb2327
13861,15627924,207128,11976455586,206496,632,138,4468983,0xBBbbCA6A901c926F240b89EacB641d8Aec7AEafD,0x21a31Ee1afC51d94C2eFcCAa2092aD1028285549
13862,15627924,207128,11976455586,207128,0,2,3492300,0x7069f5A8feF0D601AE2c7538eF7182dcd329391b,0x56Eddb7aa87536c09CCc2793473599fD21A8b17F
13863,15627924,207128,11976455586,206520,608,138,3199193,0xdAC17F958D2ee523a2206206994597C13D831ec7,0x9696f59E4d72E237BE84fFD425DCaD154Bf96976
13864,15627924,207128,11976455586,206520,608,138,4232359,0xA0b86991c6218b36c1d19D4a2e9Eb0cE3606eB48,0xDFd5293D8e347dFe59E90eFd55b2956a1343963d
13865,15627924,207128,11976455586,206520,608,138,4232360,0xdAC17F958D2ee523a2206206994597C13D831ec7,0xDFd5293D8e347dFe59E90eFd55b2956a1343963d
13866,15627924,207128,11976455586,207128,0,2,3199194,0x0305f3ecEC1b0f6A2A181C9747FE914b3F20958a,0x9696f59E4d72E237BE84fFD425DCaD154Bf96976
13867,15627924,207128,11976455586,206520,608,138,3492301,0xdAC17F958D2ee523a2206206994597C13D831ec7,0x56Eddb7aa87536c09CCc2793473599fD21A8b17F
13868,15627924,207128,11976455586,207128,0,2,4708726,0x082C0bD24D4CD9c3c3A74a8F6D5f120e619B2329,0x28C6c06298d514Db089934071355E5743bf21d60
13869,15627924,110408,11976455586,109676,732,266,2128,0x283Af0B28c62C092C9727F1Ee09c02CA627EB7F5,0xD15e7ab216AdDB92Bd95d96cb5D0F3f43719C679
13870,15627924,207128,11976455586,207128,0,2,4468984,0x70aBAdba19294dE3f9123F8F497ac0dD2fB26C82,0x21a31Ee1afC51d94C2eFcCAa2092aD1028285549
13871,15627924,207128,11976455586,206520,608,138,4468985,0xdAC17F958D2ee523a2206206994597C13D831ec7,0x21a31Ee1afC51d94C2eFcCAa2092aD1028285549
13872,15627924,148298,11976455586,142214,6084,1682,169,0x00000000006c3852cbEf3e08E8dF289169EdE581,0x4D9a66Cc8B2DA9774Bd5CAdF77355A0f66c2146C
13873,15627924,56659,11976455586,55715,944,138,69,0xAD13C2a8d418d01F3236F4d8b9d724575a4e9d24,0x3356fb868bD89709c7401b34B70b4f09AA810077
13874,15627924,207128,11976455586,206484,644,138,4708727,0x4a220E6096B25EADb88358cb44068A3248254675,0x28C6c06298d514Db089934071355E5743bf21d60
13875,15627924,100000,11976455586,99392,608,138,88948,0xdAC17F958D2ee523a2206206994597C13D831ec7,0x3018018c44338B9728d02be12d632C6691E020d1
13876,15627924,207128,11976455586,207128,0,2,4232361,0x5B9Bb8C4d3D8d518ac78c48105FaeE96A4B2D196,0xDFd5293D8e347dFe59E90eFd55b2956a1343963d
13877,15627924,207128,11976455586,206472,656,138,4232362,0xc00e94Cb662C3520282E6f5717214004A7f26888,0xDFd5293D8e347dFe59E90eFd55b2956a1343963d
13878,15627924,46135,11976455586,45647,488,138,442,0x1Fa8559e873f698292766790AeCf8080A66433F6,0xce364F5E9d2b59e4C99621723388a81e9ec65630
13879,15627924,21000,11895230560,21000,0,2,53,0x3B794929566e3Ba0f25e4263e1987828b5c87161,0x7E508f108c0b2F988Aa200F807d539b30593711b
13880,15627924,183245,11476455586,175797,7448,1938,317,0x00000000006c3852cbEf3e08E8dF289169EdE581,0xDA7aa07F0d6EA1062F65314e8a3b3F3C0e5CC53b
13881,15627924,740000,11476455586,729064,10936,2506,43649,0x5E3c7bdf06C35f88c6c0De739ed1c04767e330F9,0xa938d77590aF1d98BaB7dc4a0bde594fC3F9c403
13882,15627924,21000,11476455586,21000,0,2,50,0xf85823506cB6A9B2e6168D3e73f7d6D3dDEb7Dd7,0xAFFd45062E6181376159DA1d984a66140ADBd118
13883,15627924,21000,11476455586,21000,0,2,5,0xA1A252e4e9B8dfaE6b58C6C88a04791dc6B9E558,0x60977363dF347355CAD48cd0c55935Be049609D8
13884,15627924,46150,11476455586,45662,488,138,308,0xFCc57058Ec232a5234D495d95Fb7e593E31756Bd,0x644A374620A088445820aE76b20B8Bb542BfCE72
13885,15627924,52906,11476455586,52250,656,138,11,0x12b6893cE26Ea6341919FE289212ef77e51688c8,0xEA305EfFf03edACc7cF4C8cC6344fEbaAd14fc1A
13886,15627924,55951,11476455586,55007,944,138,327,0x4764C1FdbfF66c62027Eb3f643c0BE27A1E84cd5,0x14Bd613f47C2048cB2F78853ab49bd654caF2ABA
13887,15627924,280327,11476455586,276215,4112,1290,71,0x68b3465833fb72A70ecDF485E0e4C7bD8665Fc45,0xC11b8b749d433a76570677743CF9bc8cf79729eE
13888,15627924,400000,11476455586,393700,6300,1802,247,0x00000000006c3852cbEf3e08E8dF289169EdE581,0x6E36Efec92219538444A964F136fB57cF5ae3b3E
13889,15627924,228154,11476455586,221554,6600,1802,3,0x00000000006c3852cbEf3e08E8dF289169EdE581,0x0A9c4BDEe89a9318881441f6a99105fbdda0A025
13890,15627924,46135,11476455586,45647,488,138,1048,0x1Fa8559e873f698292766790AeCf8080A66433F6,0xf890Da5aB205741ebC49691eacFE127cfFD90599
13891,15627924,238371,11476455586,235599,2772,842,158,0x68b3465833fb72A70ecDF485E0e4C7bD8665Fc45,0x297aC2a7eEFB04C44444F22dBE82dC394662Ce86
13892,15627924,56322,11476455586,54974,1348,394,437,0xe4605d46Fd0B3f8329d936a8b258D69276cBa264,0x216A023E0c19382D895a66A76dd92E898c9BE3a7
13893,15627924,46206,11476455586,45634,572,138,61,0xf54cC94f1F2f5De012B6Aa51F1E7eBdc43Ef5afC,0x9ae6F872bD544Cd20b7086Aab5E965C1E219348a
13894,15627924,46135,11476455586,45647,488,138,6,0x1Fa8559e873f698292766790AeCf8080A66433F6,0x5CCFe5Cf56Efb67BF960ec0A73296476906E1E14
13895,15627924,29591,11476455586,29031,560,138,2486,0x127F8910CEF9ba8464aA1AFcA2e3B9C2C45992C0,0xA17138c0675173B8Ea506Fb1b96FA754BC316cc2
13896,15627924,53786,11476455586,52842,944,138,228,0xdAC17F958D2ee523a2206206994597C13D831ec7,0x3EB4BD4e17f51b09Bfa3E842b90d5293404376b6
13897,15627924,46150,11476455586,45662,488,138,4,0xDCf68c8eBB18Df1419C7DFf17ed33505Faf8A20C,0x715A8689f2bF8A1cBE05D507Ba4CbC08CC756187
13898,15627924,46135,11476455586,45647,488,138,128,0x1Fa8559e873f698292766790AeCf8080A66433F6,0x9C4C8539FbDc0A1ab8d461E192d20c554fEb9B99
13899,15627924,54864,11476455586,54368,496,202,7,0x63d85ec7B1561818Ec03E158ec125a4113038A00,0xFda13fFab1D19b97094580AFC05a8A7c1427e0cA
13900,15627924,127866,11476455586,127262,604,202,17,0x084b1c3C81545d370f3634392De611CaaBFf8148,0x69a28644001eCA50420ef6B5Cb30D886936AeDAB
13901,15627924,21000,11476455586,21000,0,2,987,0x9Ad83e1fBBF7d4d86f5B395Be4002e8679314859,0xa04c72592849B57c6830B36C43f77faC9A7886B2
13902,15627924,616308,11476455586,570276,46032,16082,4782,0x00000000006c3852cbEf3e08E8dF289169EdE581,0xd8b07BC1bC3bAe553BCA5E94E99935dC12Df24Ff
13903,15627924,46135,11476455586,45647,488,138,1418,0x1Fa8559e873f698292766790AeCf8080A66433F6,0xE7de2fF245bcf840d0d20C04c00fEc2779861f36
13904,15627924,242488,11476455586,239740,2748,842,227,0x68b3465833fb72A70ecDF485E0e4C7bD8665Fc45,0xceB7Bc1098138e850195698F4Ff2726031CDe545
13905,15627924,21000,11476455586,21000,0,2,116,0x97FFE6e22BB6436B90a7B452899fBE6F2A78dd2c,0x84CEA2A5d09bF9325B40C2022fadF46dbEE9E5f6
13906,15627924,1000000,11476455586,999344,656,138,4121143,0x1A3496C18d558bd9C6C8f609E1B129f67AB08163,0x0D0707963952f2fBA59dD06f2b425ace40b492Fe
13907,15627924,1000000,11476455586,999380,620,138,4121144,0x467719aD09025FcC6cF6F8311755809d45a5E5f3,0x0D0707963952f2fBA59dD06f2b425ace40b492Fe
13908,15627924,105000,11476455586,105000,0,2,4121145,0x2CE4d3Ac9a0a5547C5cb4DbBe285D0FE88478c2f,0x0D0707963952f2fBA59dD06f2b425ace40b492Fe
13909,15627924,105000,11476455586,105000,0,2,4121146,0xdB9d5D8F4337f6c94acf6fC7ED4d5772EE190d05,0x0D0707963952f2fBA59dD06f2b425ace40b492Fe
13910,15627924,329530,11476455586,329466,64,10,2,0x2cac916b2A963Bf162f076C0a8a4a8200BCFBfb4,0xb63cF3F5469be8A06f2dB72116f3Bb9708fF1DEE
13911,15627924,388286,11476455586,387662,624,266,29,0xC5622f143972A5Da6aaBC5F5379311eE5EB48568,0x619f32C16797B4FC7ec6609A1de42BA7E77cd8E2
13912,15627924,76984,11476455586,76388,596,138,37,0x083D41d6DD21EE938f0c055CA4fb12268DF0EfaC,0x03abBb58DfE52B58CaFd50239AB0606D8C2E1cAe
13913,15627924,45038,11476455586,44974,64,10,6,0xC02aaA39b223FE8D0A0e5C4F27eAD9083C756Cc2,0x5123fB0593F9dCdBeB609B827bBF908B6A362153
13914,15627924,21000,11476455586,21000,0,2,0,0xf54611A627aFA7c00a58569932554372dD3F4b3B,0x80C2fA12BD8009E0CC5F7b0F0A8F3d40236D1313
13915,15627924,21000,11476455586,21000,0,2,326,0x0457bDD7d70c82f4cb1C850bd49064a544630978,0xC2dC853b149EA213f0C995c92C98E001Ed9F6627
13916,15627924,1000000,11476455586,999332,668,138,4121147,0x41dBECc1cdC5517C6f76f6a6E836aDbEe2754DE3,0x0D0707963952f2fBA59dD06f2b425ace40b492Fe
13917,15627924,105000,11476455586,105000,0,2,4121148,0x585C3d4Da9b533C7e3dF8AC7356C882859298cEe,0x0D0707963952f2fBA59dD06f2b425ace40b492Fe
13918,15627924,109567,11476455586,108899,668,138,112,0x815C23eCA83261b6Ec689b60Cc4a58b54BC24D8D,0xf8f4E0e229fDba143F64ba22F72141D0eCBB51Eb
13919,15627924,179907,11476455586,169287,10620,3410,654,0x00000000006c3852cbEf3e08E8dF289169EdE581,0x8b2BE334F5516c947B617cc89F81Cc2bBB8DDce2
13920,15627924,55946,11476455586,55002,944,138,195,0x464FdB8AFFC9bac185A7393fd4298137866DCFB8,0xD12EC12A77D3f30844a58c2E992273B8152A2eD5
13921,15627924,21000,11476455586,21000,0,2,206,0x7e18a43CA10BfC872AdD7DD1572DD7FCc60CDBb0,0xd22a72ab392998f365220f34Cb7b8dcBA3653c62
13922,15627924,311655,11476455586,305887,5768,1674,822,0x59728544B08AB483533076417FbBB2fD0B17CE3a,0x8Ad52C3AB4233341f7a5B25DD0eBC4dcc26C53Ee
13923,15627924,21000,11476455586,21000,0,2,2,0xddbd56555a702D9a177E68E37bD30a57B01E29Fe,0xfc7ec79c814ff15e2Ab1301EE21dEAB8a1e76eC8
13924,15627924,36933,11476455586,36717,216,74,855,0x59728544B08AB483533076417FbBB2fD0B17CE3a,0x1Dad1d2C851DC9A0622Dbb0876f12daB68eDC0C9
13925,15627924,324524,11476455586,324236,288,74,203,0x2941F68fe10c16C8d710F4C51De91a82d7e89BE2,0x43A86525d2B359977F59C37EA83D4F7017670c2c
13926,15627924,46545,11476455586,45601,944,138,5,0x3845badAde8e6dFF049820680d1F14bD3903a5d0,0xE3957D8De772F695Ae9586973F64Bffa922a9440
13927,15627924,109343,11476455586,107747,1596,458,57,0x3666f603Cc164936C1b87e207F36BEBa4AC5f18a,0x79cAF31d34521BD0a2a03a33a8119e09FcC80769
13928,15627924,179557,11476455586,176737,2820,842,12,0x68b3465833fb72A70ecDF485E0e4C7bD8665Fc45,0xC6ec52e232Ac5E33607cd205987be673F38798ea
13929,15627924,53915,11476455586,53427,488,138,167,0x6de7aC835EC6841Af9b94fd1273dB83B8d69e3f7,0xb6e6b058289d5296Ad992b7907006f96714b8523
13930,15627924,202363,11476455586,199099,3264,1034,58,0x68b3465833fb72A70ecDF485E0e4C7bD8665Fc45,0x74ad56Fa24D1163CfCaB69f20a6016b6Ef9C325d
13931,15627924,21000,11476455586,21000,0,2,66,0x7E16BFA814f0C91DEFC26D8bbB8D36BD65820867,0xb0c0A76fD05adcAeaf18aa4FF326Fb64d9005C22
13932,15627924,21000,11476455586,21000,0,2,6,0x51916CF87cBEAF92e8C47948d4354C0F17D40fE0,0xBAcd8fe39D074e21f0f7E529287cC851Ef501450
13933,15627924,593430,11476455586,560818,32612,11274,2144,0x00000000006c3852cbEf3e08E8dF289169EdE581,0xCD6DE4e6Ae74267D3eb35cb8e9fbf62da41dB47D
13934,15627924,197149,11476455586,193581,3568,1162,426,0x68b3465833fb72A70ecDF485E0e4C7bD8665Fc45,0x0A633Ef96f3F906ec042453f66926c6Ea03566a1
13935,15627924,147776,11476455586,141152,6624,1802,538,0x00000000006c3852cbEf3e08E8dF289169EdE581,0x14d381Ef2E4482415bBed654016B28566fC624D3
13936,15627924,313393,11476455586,299385,14008,4618,524,0x83C8F28c26bF6aaca652Df1DbBE0e1b56F8baBa2,0x4EeE48c710b2253DCfCE9dF38d72c39E05a8d3d5
13937,15627924,36015,11476455586,35751,264,74,739,0xC02aaA39b223FE8D0A0e5C4F27eAD9083C756Cc2,0xa0704a5914E8cd0b4724a0536f1f3295ED4A755C
13938,15627924,60727,11476455586,53271,7456,2506,928,0x00000000006c3852cbEf3e08E8dF289169EdE581,0x17b76551FF8d26D692DA2B9ba02Dea9D3EcDDE55
13939,15627924,48801,11476455586,48217,584,138,3,0x49cF6f5d44E70224e2E23fDcdd2C053F30aDA28B,0xEF7050EDC2a1F26f4996acF8aEA6ACb11a5e1113
13940,15627924,46135,11476455586,45647,488,138,219,0x1Fa8559e873f698292766790AeCf8080A66433F6,0xae6B81d5BA50c50ea31Bc6c25F939a2876cd31f5
13941,15627924,21000,11476455586,21000,0,2,253,0xaa93af7537135B480d304102B5F82C597E227EFc,0x5BDd4E1F51E8Ba6E1e62E259730bCD5581feFc03
13942,15627924,46685,11476455586,46197,488,138,135,0x9a38DEC0590aBC8c883d72E52391090e948DdF12,0x788286cb76164e783CBC2F3882b629797F34e148
13943,15627924,196138,11476455586,189526,6612,1802,326,0x00000000006c3852cbEf3e08E8dF289169EdE581,0xc20b23462377bea7A7C1253057F8Ce1a74406Fcf
13944,15627924,1469526,11476455586,1347878,121648,42130,1700,0x00000000006c3852cbEf3e08E8dF289169EdE581,0x41Fc5DE56b095F594a7fe0e758FD6769D060a376
13945,15627924,21000,11476455586,21000,0,2,237,0x66208416CB1dAF88716af68E405fcC8994c059D2,0x15deb8F264B20d052671866AeCf48F5e89D2d351
13946,15627924,46135,11476455586,45647,488,138,727,0x1Fa8559e873f698292766790AeCf8080A66433F6,0xA62ad3B7a2d5A3F2875eFf278bE34A3F0512F272
13947,15627924,95864,11476455586,95660,204,74,0,0x7F9306FC1978938d5C1C57Bf6044dc67E07eeB8a,0x9f3594aC99317537364c6DAa7532C8E98a648c0E
13948,15627924,146717,11476455586,140117,6600,1802,33,0x00000000006c3852cbEf3e08E8dF289169EdE581,0xf5b75474d006495C82dBbf010e230d5D2F86226f
13949,15627924,46135,11476455586,45647,488,138,200,0x1Fa8559e873f698292766790AeCf8080A66433F6,0x68a1F25D55230A9224395Db7f50F57e7b460C93D
13950,15627924,1240547,11476455586,1140303,100244,34770,581,0x00000000006c3852cbEf3e08E8dF289169EdE581,0x0db7b27b7A3Ea8035D3F66F3ba7532221eF06abE
13951,15627924,310380,11476455586,307548,2832,842,889,0x68b3465833fb72A70ecDF485E0e4C7bD8665Fc45,0x92FA4cB1C987A3494BfdE001cC37fb0A0E35F8bb
13952,15627924,153092,11476455586,146440,6652,1810,173,0x00000000006c3852cbEf3e08E8dF289169EdE581,0xef194B0Ece11bf1521bbAaD8b3BB673512666524
13953,15627924,71709,11476455586,69513,2196,458,6,0x74312363e45DCaBA76c59ec49a7Aa8A65a67EeD3,0x07b3103f8ECEEE53f233e58d6B4481EDab2784a1
13954,15627924,650923,11476455586,647331,3592,1162,861,0x68b3465833fb72A70ecDF485E0e4C7bD8665Fc45,0x5E56B1E1e323454578319a7455cB3888Aa58d34E
13955,15627924,49267,11476455586,48779,488,138,509,0x7DF64F69544c5bf71171dc5ab69b8602C2FF1E27,0x2eAE5AF37267007CF956803ce0DFb66468E2df77
13956,15627924,219518,11476455586,216758,2760,650,1893244,0xD1669Ac6044269b59Fa12c5822439F609Ca54F41,0xD2C82F2e5FA236E114A81173e375a73664610998
13957,15627924,56322,11476455586,54974,1348,394,438,0xe4605d46Fd0B3f8329d936a8b258D69276cBa264,0x216A023E0c19382D895a66A76dd92E898c9BE3a7
13958,15627924,21000,11476455586,21000,0,2,40,0xDAcb89a7E2041885706EFd897E451954f3925bC5,0x41eec5bf8382BAaa340067b869510B66D06A1C51
13959,15627924,192312,11476455586,192120,192,74,434,0x6a9f9d6F5D672a9784c5E560a9648de6cbe2c548,0xC697d0316dC61C8912fa28E446ba752FEb94e87D
13960,15627924,416132,11476455586,412468,3664,1162,667,0x68b3465833fb72A70ecDF485E0e4C7bD8665Fc45,0xCaBA18AE3eD72886b64BFc24e79CD7A98137e536
13961,15627924,29566,11476455586,29090,476,138,2487,0x2Ad0ED1621EaaB92C71f53DdE4BABa88e5C0BC44,0xA17138c0675173B8Ea506Fb1b96FA754BC316cc2
13962,15627924,21000,11476455586,21000,0,2,37,0xfDC1FE1AA8970f61FaB8f78B0baeAe7D7EF3fb6d,0xc488ba63E643B90cbe91ffF718dE6c97724207df
13963,15627924,383079,11476455586,378227,4852,1546,402,0x68b3465833fb72A70ecDF485E0e4C7bD8665Fc45,0x1a9d02c3b92676DAd6a463b1e1446267CA59e462
13964,15627924,300000,11449424260,299344,656,138,150331,0x4a220E6096B25EADb88358cb44068A3248254675,0x1C727a55eA3c11B0ab7D3a361Fe0F3C47cE6de5d
13965,15627924,600000,11449424260,599404,596,138,138590,0xdAC17F958D2ee523a2206206994597C13D831ec7,0x974CaA59e49682CdA0AD2bbe82983419A2ECC400
13966,15627924,191113,11449424260,190189,924,266,92,0xd588b586D61C826A0e87919b3D1a239206d58bf2,0x710E29C9c3bD8904Eb3d993b05E1bE418Bc715aa
13967,15627924,84000,11318455586,83392,608,138,57313,0xA0b86991c6218b36c1d19D4a2e9Eb0cE3606eB48,0xCfC0F98f30742B6d880f90155d4EbB885e55aB33
13968,15627924,270916,11311088887,270916,0,2,119385,0x0cac3d1a887206e0f6169222C4504301A8b4b993,0x0cac3d1a887206e0f6169222C4504301A8b4b993
13969,15627924,270690,11311088887,270690,0,2,43190,0xBf2D5d8eBF05947245B3D7f38b2776A6a49710DD,0xBf2D5d8eBF05947245B3D7f38b2776A6a49710DD
13970,15627924,252714,11188656586,252714,0,2,117904,0x26bce6eCb5b10138e4bf14aC0ffcc8727FEF3B2e,0x26bce6eCb5b10138e4bf14aC0ffcc8727FEF3B2e
13971,15627924,282271,11000000000,278855,3416,522,686,0x9b3B6974531d8AA15A87908FFd821A64863Ede5B,0x8c97B171738aA8fdbD0bb73a440Be2424F840635
13972,15627924,21000,11000000000,21000,0,2,168680,0xB2AE354B673826Fa193941b7e3711530489AD496,0x4E5B2e1dc63F6b91cb6Cd759936495434C7e972F
13973,15627924,21000,10976455586,21000,0,2,346927,0xff4106b8483f9f28e337555980C37F1fd54eE134,0x77696bb39917C91A0c3908D577d5e322095425cA
13974,15627924,2000000,10976455586,1988700,11300,2634,171066,0xA9D1e08C7793af67e9d92fe308d5697FB81d3E43,0x7830c87C02e56AFf27FA8Ab1241711331FA86F43
13975,15627924,2000000,10976455586,1990228,9772,2122,171067,0xA9D1e08C7793af67e9d92fe308d5697FB81d3E43,0x7830c87C02e56AFf27FA8Ab1241711331FA86F43
13976,15627924,21000,10976455586,21000,0,2,8804473,0xE97da7c344A2e268e005198E8426Cdf4a5c14410,0x3cD751E6b0078Be393132286c442345e5DC49699
13977,15627924,181476,10976455586,179912,1564,394,2471,0x1Fa8559e873f698292766790AeCf8080A66433F6,0x3D49B36Ba897ba8693c3A86834c5906a07bf1a0B
13978,15627924,21000,10976455586,21000,0,2,346928,0x3AE7A41042EA6B646646A52413c6deaAeb98023d,0x77696bb39917C91A0c3908D577d5e322095425cA
13979,15627924,118453,10976455586,118249,204,74,42,0x5DAC20CEabd1cfC989Ab4C48AF95e563631556c9,0xa41d089D03A2CdCdc324F8F779E43457fC961150
13980,15627924,181476,10976455586,179912,1564,394,1015,0x1Fa8559e873f698292766790AeCf8080A66433F6,0x05F8E15D6D0EA924fc3c67D17d7CAE4F8243c9Ae
13981,15627924,113310,10976455586,113106,204,74,419,0x5D004ddB5D92938dAF8448b9eac1CaA593cd26Ca,0x26DC5D39Bd7A8bc2d792dcAAAC55FE6DCef25593
13982,15627924,100881,10976455586,100677,204,74,774,0x9b9D659D4f2cF68b6616Cc0a65683f1951Eb725C,0x8101D517d48672392c99dDBE6A5422369C9904A7
13983,15627924,114298,10976455586,114094,204,74,6,0x4556561740B7B5F858967A6a4E54e506609704Bd,0x90080f967bfF98761cB1A6cb26EDdcd247aBc574
13984,15627924,99786,10976455586,97906,1880,330,463,0x000000000000509081d6FCD3ee63e791aD1db763,0x4142c8E2b0713BEFC3DabE9FFec6073F2af3e091
13985,15627924,21000,10976455586,21000,0,2,8265762,0xacB6Da2f8F9972C2D2Ef9479569854A9d1cA56B9,0xb5d85CBf7cB3EE0D56b3bB207D5Fc4B82f43F511
13986,15627924,21000,10976455586,21000,0,2,6578042,0x8356837eAb94c834aB7EaE008855E8b3F902ecB9,0xeB2629a2734e272Bcc07BDA959863f316F4bD4Cf
13987,15627924,21000,10976455586,21000,0,2,469176,0x4e45D0bB53715A7d1434dE249972D625802d80df,0xb739D0895772DBB71A89A3754A160269068f0D45
13988,15627924,21000,10976455586,21000,0,2,1783219,0x867805cc764D075cdBc100a4C163Ebe28Da685ae,0x503828976D22510aad0201ac7EC88293211D23Da
13989,15627924,21000,10976455586,21000,0,2,6578043,0xd76A310cfD6Ff45b8DD7F18bD3b57C39d01a621c,0xeB2629a2734e272Bcc07BDA959863f316F4bD4Cf
13990,15627924,21000,10976455586,21000,0,2,52389,0x45Fc4249979B13Ac0e39B7543E911C8344Fe1196,0x7c195D981AbFdC3DDecd2ca0Fed0958430488e34
13991,15627924,21000,10976455586,21000,0,2,8265763,0xFdF70ADEaBE5495d1E4F1bf1190e30101ed51B7E,0xb5d85CBf7cB3EE0D56b3bB207D5Fc4B82f43F511
13992,15627924,113310,10976455586,113106,204,74,420,0x5D004ddB5D92938dAF8448b9eac1CaA593cd26Ca,0x26DC5D39Bd7A8bc2d792dcAAAC55FE6DCef25593
13993,15627924,113310,10976455586,113106,204,74,421,0x5D004ddB5D92938dAF8448b9eac1CaA593cd26Ca,0x26DC5D39Bd7A8bc2d792dcAAAC55FE6DCef25593
13994,15627924,140406,10976455586,134386,6020,1674,393,0x00000000006c3852cbEf3e08E8dF289169EdE581,0x41D42207EDc025E219425Aa1b19013f7F8114fD7
13995,15627924,250000,10976455586,250000,0,2,45337171,0x6AD2129eed313Ef0e528A21F820Ef6bC5061EF78,0xEA674fdDe714fd979de3EdF0F56AA9716B898ec8
13996,15627924,113310,10976455586,113106,204,74,422,0x5D004ddB5D92938dAF8448b9eac1CaA593cd26Ca,0x26DC5D39Bd7A8bc2d792dcAAAC55FE6DCef25593
13997,15627924,223812,10976455586,220980,2832,842,67,0x68b3465833fb72A70ecDF485E0e4C7bD8665Fc45,0x4f52F2777277426Cd4d769D758E7dc44DEa2715F
13998,15627924,113310,10976455586,113106,204,74,423,0x5D004ddB5D92938dAF8448b9eac1CaA593cd26Ca,0x26DC5D39Bd7A8bc2d792dcAAAC55FE6DCef25593
13999,15627924,46135,10976455586,45647,488,138,40,0x1Fa8559e873f698292766790AeCf8080A66433F6,0x95827d2Ab16a42e3A4A4c8451100e8c6fAcC9FA8
14000,15627924,180333,10976455586,176741,3592,1162,695,0x68b3465833fb72A70ecDF485E0e4C7bD8665Fc45,0x8d894500675C860D86619cC77742b8Dca7eF74e2
14001,15627924,113310,10976455586,113106,204,74,424,0x5D004ddB5D92938dAF8448b9eac1CaA593cd26Ca,0x26DC5D39Bd7A8bc2d792dcAAAC55FE6DCef25593
14002,15627924,113310,10976455586,113106,204,74,425,0x5D004ddB5D92938dAF8448b9eac1CaA593cd26Ca,0x26DC5D39Bd7A8bc2d792dcAAAC55FE6DCef25593
14003,15627924,126531,10976455586,126327,204,74,912,0x9b9D659D4f2cF68b6616Cc0a65683f1951Eb725C,0x52EBBaC7F44eE564Da74a319874D74713E8297a1
14004,15627924,46267,10785064959,45691,576,74,3,0x283Af0B28c62C092C9727F1Ee09c02CA627EB7F5,0xeeE20d5c36A28a9c3285c2aE805D7892206264c9
14005,15627924,1000000,10228891938,998276,1724,330,109721,0x2796317b0fF8538F253012862c06787Adfb8cEb6,0x230A1AC45690B9Ae1176389434610B9526d2f21b
14006,15627924,100000,10212377411,99392,608,138,705901,0xdAC17F958D2ee523a2206206994597C13D831ec7,0x6dfc34609a05bC22319fA4Cce1d1E2929548c0D7
14007,15627924,339596,10212377411,160288,179308,22618,183262,0x5E4e65926BA27467555EB562121fac00D24E9dD2,0x6887246668a3b87F54DeB3b94Ba47a6f63F32985
14008,15627924,105000,10164021691,105000,0,2,138591,0x8fC24a8951Fe506c419f25a70a707ddB202B3AcA,0x974CaA59e49682CdA0AD2bbe82983419A2ECC400
14009,15627924,30000,9976455586,30000,0,2,642,0x58d230e0b34Ab6AD1bc47f35DAC3983BE9cb73C2,0xf573d99385C05c23B24ed33De616ad16a43a0919
14010,15627925,105000,90000000000,104332,668,138,2,0x1A3496C18d558bd9C6C8f609E1B129f67AB08163,0xe5c372A7473eeC65921d1fee79FCD0Ce074155Cb
14011,15627925,105000,90000000000,104332,668,138,1,0x1A3496C18d558bd9C6C8f609E1B129f67AB08163,0xdeE65BfFb477c3b705846ed8b19f3b1330E1C1B8
14012,15627925,312070,81000000000,311126,944,138,711,0x2b8beC81F648f327B7d8278EE74932845cDa3d19,0x3dFdB240Fb476624CCAC60084F3a1F8d146e1ab9
14013,15627925,268642,12023351662,265290,3352,970,193,0x68b3465833fb72A70ecDF485E0e4C7bD8665Fc45,0x6BfE59e8fEaDDfBdBb97F7Da8c6B4550a8bD4ffd
14014,15627925,253832,10523351662,251696,2136,650,96401,0xA69babEF1cA67A37Ffaf7a485DfFF3382056e78C,0xBbAD96336943A36E3e292D973B3382dd0bA4D1EF
14015,15627925,21000,45000000000,21000,0,2,0,0x18bA7bC782B7747f3d9Aa3D0EFb137E6651A6b39,0x18b19a330C1B58c9965778e03A5C00FA0ea4F672
14016,15627925,800000,40000000000,799344,656,138,3,0x7db5af2B9624e1b3B4Bb69D6DeBd9aD1016A58Ac,0x6615B81d6B014E6E7B19B29dcDEc8BE75ED34D3e
14017,15627925,190330,25523351662,184030,6300,1802,1944,0x00000000006c3852cbEf3e08E8dF289169EdE581,0xB58007c1990a0ae29f0D34543714BAf168149F82
14018,15627925,241462,23619655200,239218,2244,650,100942,0xA69babEF1cA67A37Ffaf7a485DfFF3382056e78C,0x431B5A84aCC1297Eda88259f300262F1bc3A74f3
14019,15627925,874718,20216030363,861226,13492,4042,2875,0xcD6F65A972551FFaC9B52Fa2D4a561D9b7AB4741,0x027d24217F18822e6ce11821524c212F507D0787
14020,15627925,21000,17488963102,21000,0,2,33039,0xCeF71F470BBbFf23957DF3Bf4666047FE493d6F1,0xBd9B34cCbb8db0FDECb532B1EAF5D46f5b673fE8
14021,15627925,5049368,17000000000,5042268,7100,1098,307,0x0a39DA505DfB5E0BBc6bd84428281A8ba1bC7753,0x495E889d1A6cEB447a57dcc1C68410299392380c
14022,15627925,300000,16523351662,299056,944,138,7,0x978cB8306E6ed25867d0E2A88E127aC5a681Ad1B,0x801F5b36a7bEB854340bF999CD5CEddB1f75D655
14023,15627925,300000,16523351662,299056,944,138,7,0x978cB8306E6ed25867d0E2A88E127aC5a681Ad1B,0x078cFdf223F7d92B4672ec7299aF4F00bf1Ad318
14024,15627925,80000,16058561256,80000,0,2,2852,0x0E5A92F08bD06EE47BF94B8145220f7bC7C37F3c,0x1786D0Ca2B790e80e8c78C4Eaa496CaE806Ff668
14025,15627925,259180,15976231524,257968,1212,164,3746,0xb21F51DC9f3067574946D1A530447D9037675CbC,0x10763988715993EaF59905029CE3414adA0b5200
14026,15627925,500000,15218638694,498172,1828,586,6498,0x79c0BD8c38B00074f62197E8324a703a83d63bF1,0xbe2c1479B24ffF0B3b69B37A3fb99a737F46B0da
14027,15627925,75808,15000000000,75212,596,138,40,0xdAC17F958D2ee523a2206206994597C13D831ec7,0x80A60C62Ec41AAEb1D496F2C10D0b3D4Dd5C046E
14028,15627925,51706,14250000000,51086,620,138,51,0x467719aD09025FcC6cF6F8311755809d45a5E5f3,0xD0c10500c50CE5BD054Cae8a829f2610B225d7Ac
14029,15627925,51706,14250000000,51086,620,138,2,0x467719aD09025FcC6cF6F8311755809d45a5E5f3,0x21B88Ba587b6DAD30C74A0922B7dE2EC0e381c9c
14030,15627925,51706,14250000000,51098,608,138,26,0x467719aD09025FcC6cF6F8311755809d45a5E5f3,0xF0687F0006474D8184ddb65084Db595A5279C98d
14031,15627925,55192,14250000000,54512,680,138,4051,0x6123B0049F904d730dB3C36a31167D9d4121fA6B,0xD9408f29026E32852AFf8C5C9C8Ea834b44b4e1C
14032,15627925,46267,13998477760,45691,576,74,50,0x283Af0B28c62C092C9727F1Ee09c02CA627EB7F5,0xabAa7c82cC40b8d97c753E9f0BF605B89adD06E9
14033,15627925,1658707,13533351662,1502511,156196,53194,17990,0x00000000006c3852cbEf3e08E8dF289169EdE581,0x3A8713065e4DAa9603b91Ef35d6a8336eF7b26C6
14034,15627925,350000,13023351662,348640,1360,394,53279,0x1758Edff3b5f072f5ACA18DaDbACf0Ab89342640,0x7b9d4D8772b8705dDc7456Daf821c3022DDa0504
14035,15627925,21000,13023351662,21000,0,2,9,0xf950d6C533BCa87Ec6AAC30694E7e3A7Bb224D43,0x4d6DCBEA6bDE4C7D80392a68E093a1EF949764d6
14036,15627925,49234,13023351662,48282,952,202,7,0x1Fa8559e873f698292766790AeCf8080A66433F6,0x79e8046fa0EB11538DD954611f5de90F77FB83fc
14037,15627925,49234,13023351662,48282,952,202,7,0x1Fa8559e873f698292766790AeCf8080A66433F6,0x929748860A2c383604e9EFD8672B642305e20F13
14038,15627925,49234,13023351662,48282,952,202,7,0x1Fa8559e873f698292766790AeCf8080A66433F6,0x3a7a4C0591435A78650FE2481eC57599B7d3ad5D
14039,15627925,49234,13023351662,48282,952,202,7,0x1Fa8559e873f698292766790AeCf8080A66433F6,0x587Ae434cfe131bc736a3Da35B2cEaF365fAb452
14040,15627925,49234,13023351662,48282,952,202,7,0x1Fa8559e873f698292766790AeCf8080A66433F6,0x0E0637Ee49bD32eebdB040f75be6e30dac21b5E7
14041,15627925,46628,13023351662,45684,944,138,1709,0x2b8beC81F648f327B7d8278EE74932845cDa3d19,0xf95249038E13A289f04449360de20C7609B920eF
14042,15627925,46135,13023351662,45647,488,138,40,0x1Fa8559e873f698292766790AeCf8080A66433F6,0x1711D08DAc1BC9C01706Ac709f348c52DE7C9001
14043,15627925,69201,13023351662,68581,620,138,12,0x6B175474E89094C44Da98b954EedeAC495271d0F,0x9AFbfC0AD50c707ecBddF0916427eD37819fc941
14044,15627925,269178,13000000000,268562,616,202,1588,0xbEbc44782C7dB0a1A60Cb6fe97d0b483032FF1C7,0x4846AEe6d7C9f176F3F329E01A014c2794E21B92
14045,15627925,21000,12913719839,21000,0,2,0,0x57BcB8f0c5638b2fE56c0e6cE39BD63F85Fda10e,0xFAEF0A272436e2C634E348c8B1Dc7846e3C9fC25
14046,15627925,21000,12913719839,21000,0,2,174,0xDa1E2b23d526dCe2FEB7C73EC4CA4b3CD7d23bDA,0xeDE4794bDB3FaeF8E23Cdf68B9799AA844D1c1B5
14047,15627925,287121,12523351662,283941,3180,1034,662,0x68b3465833fb72A70ecDF485E0e4C7bD8665Fc45,0xd3A108D5F06A417A2625136f18442F809f6B0Ebf
14048,15627925,151748,12523351662,150324,1424,522,64,0xCd48eCd9110979D6e343Bc5AE4Cc8035339A35c9,0x1Dc0BA9941847A96F096d25018Df844176066FCA
14049,15627925,77839,12523351662,77159,680,138,64,0x0E1fe60bc4aC0e3102343752ae7E49d01d444c0b,0xF3da896068b5dfcbcB851284f09300b51E088BF5
14050,15627925,249066,12523351662,245826,3240,1034,41,0x68b3465833fb72A70ecDF485E0e4C7bD8665Fc45,0xA83236C27717D16e78155cAcE656Ada0273Dcd2E
14051,15627925,21000,12523351662,21000,0,2,4,0xFF43df9C57e01b6A3680A82c42D0d260909E246d,0x88ea5282b972D3fb05F6f5476775aa7360b0b6Fb
14052,15627925,500000,12523351662,498272,1728,458,542325,0xa24787320ede4CC19D800bf87B41Ab9539c4dA9D,0xAe2D4617c862309A3d75A0fFB358c7a5009c673F
14053,15627925,70000,12523351662,69392,608,138,1,0xdAC17F958D2ee523a2206206994597C13D831ec7,0x9cdf37470AC6d984EC8fB055d7905C9Bbe110151
14054,15627925,42000,12523351662,42000,0,2,329576,0x7F9c998e04B3CeF7b1A1Cf72cB98E334A2ee42cd,0x9430801EBAf509Ad49202aaBC5F5Bc6fd8A3dAf8
14055,15627925,271624,12523351662,267260,4364,1098,1,0xe66B31678d6C16E9ebf358268a790B763C133750,0xF2EF227d686c37B80268867B2bFFE7728297E144
14056,15627925,400000,12523351662,393864,6136,1738,3151,0x00000000006c3852cbEf3e08E8dF289169EdE581,0x2d1cb5ED13C731604A3F1d48dc206D85fe5e52B1
14057,15627925,21000,12523351662,21000,0,2,27,0xFC5E14a2818E36fb4AA791BD7535F6EC54610Abc,0x3f2E4c348D33Ddd7a20787451661E8911dc5a48b
14058,15627925,21000,12523351662,21000,0,2,37,0x41Ad5F539133Dc08b22D55098a855a0b95de85cF,0x50829b25b51Cd08205dae2dA586B849Cc7B02bD8
14059,15627925,21000,12523351662,21000,0,2,84,0x75A477dCD2bFed62d2C94C56212c88C7e7aA26DF,0x50EF317df901568c76931086e69D394904435fbA
14060,15627925,80000,12523351662,79392,608,138,568595,0xA0b86991c6218b36c1d19D4a2e9Eb0cE3606eB48,0xB02f1329d6a6AcEF07a763258f8509c2847A0a3E
14061,15627925,200000,12254852893,198632,1368,266,25868,0x5a54fe5234E811466D5366846283323c954310B2,0xBa573A99C0748EAA35Ff422faD29c4D3c4Bc23E5
14062,15627925,152620,12133351662,152124,496,202,10,0x99C9fc46f92E8a1c0deC1b1747d010903E884bE1,0x9c7B1712879271a3B3C4c80987dC1fc4A66AF3D1
14063,15627925,67544,12023351662,66068,1476,458,25,0x5BABc381C7E9EdCF02654a9C30d384dFE54dd4A1,0x030ce9d143332f6D9c287414f08e22c145c43c58
14064,15627925,183110,12023351662,181486,1624,394,64,0x7a250d5630B4cF539739dF2C5dAcb4c659F2488D,0x64c952FBec6a6b16Ffd95eD728c21900337Aa8Cf
14065,15627925,266724,12023351662,263964,2760,842,1141,0x68b3465833fb72A70ecDF485E0e4C7bD8665Fc45,0x6d01af8711133DEE2B2edfC54DC6Ce38223f8396
14066,15627925,146836,12023351662,140260,6576,1802,55,0x00000000006c3852cbEf3e08E8dF289169EdE581,0x423a056d9AA86d9F215EDc0D6f11491dc7429F95
14067,15627925,21000,12023351662,21000,0,2,0,0x7ddF116663C9fc027c3D688F8b772651c8f1e616,0xE11fA33eea7B80db90530c087e09cB3F7b81e46C
14068,15627925,216493,12023351662,213757,2736,650,1893245,0xD1669Ac6044269b59Fa12c5822439F609Ca54F41,0xD2C82F2e5FA236E114A81173e375a73664610998
14069,15627925,235550,12023351662,231958,3592,1162,1458,0x68b3465833fb72A70ecDF485E0e4C7bD8665Fc45,0x43C1Bf1a33506d2d3f023a1F354e608e7784aC46
14070,15627925,338541,12023351662,333425,5116,1018,105729,0x0000000000007F150Bd6f54c40A34d7C3d5e9f56,0x60530f5Ca4CB9907e0FBE67cA3AFCbFE56D19A5c
14071,15627925,242150,12023351662,238270,3880,1354,39474,0x7Ed7382D0EcfeE9Bf1085671CCe4b0A5774a6E89,0x79b7a69d90c82E014Bf0315e164208119B510FA0
14072,15627925,270840,12023351662,269316,1524,266,15248,0xF71530c1f043703085B42608ff9DCcCc43210a8E,0xbB4452482320BEA8787458B31f71906C6862d2ca
14073,15627925,420171,12023351662,418063,2108,522,86,0x25553828F22bDD19a20e4F12F052903Cb474a335,0x7099742Bb172eE9164AdA25Ad263c1d2742877Ca
14074,15627925,164038,12023351662,157450,6588,1802,317,0x00000000006c3852cbEf3e08E8dF289169EdE581,0x2e2AaB72B6Aadb2e1eBe65326bb0a97BF7752477
14075,15627925,686343,12023351662,645727,40616,14154,545,0x83C8F28c26bF6aaca652Df1DbBE0e1b56F8baBa2,0x0968de68479390807f4097140bb67BB52B1E6dC2
14076,15627925,237881,12023351662,231581,6300,1802,975,0x00000000006c3852cbEf3e08E8dF289169EdE581,0x46e910953D4Bb7d32E630aB9d45f56E4AFE34Fe1
14077,15627925,57322,12023351662,55582,1740,458,1417,0x495f947276749Ce646f68AC8c248420045cb7b5e,0x397fBd1E27352175cC5B6baf171A30911268823c
14078,15627925,152276,12023351662,141648,10628,3402,136,0x00000000006c3852cbEf3e08E8dF289169EdE581,0x5bF2eb73b153ec29b52018b90a2f9074bDdE70CF
14079,15627925,21000,12023351662,21000,0,2,11,0xD06a1dba2aFD6DfE08815241bbC4c86807580D06,0xfBccbDf92f1033D260ea8B9E74F44Cf04ae233f4
14080,15627925,94813,12023351662,94205,608,138,157,0xdAC17F958D2ee523a2206206994597C13D831ec7,0xf372F5B54d293990c639B531a16206246FC17680
14081,15627925,251587,12023351662,251383,204,74,30,0x6E6a074aE4bC830406B7766685f4e25f7cA81f1d,0xcceBC183A4F621B7f017fC2609B8b8C8e7fB9542
14082,15627925,21000,12023351662,21000,0,2,179,0xaa99361eb72C80A820F0EACD401d6B8c6A81Fdb1,0x1FB42B3AdECaaac6443011A20e15a2C56ca4C1f5
14083,15627925,21000,12023351662,21000,0,2,7,0xfE24D2770069C54B2b4e850dc11B10c823109956,0x88fc3d68D7723770A189a8330B784616bB353C48
14084,15627925,21000,12023351662,21000,0,2,23,0x14451984659Ae67FEB192c41373A763281dF8537,0x10947Ad8EfFf33df3F3d3b1deC61787121E10272
14085,15627925,184186,12023351662,177534,6652,1810,90,0x00000000006c3852cbEf3e08E8dF289169EdE581,0xB3A7d93a97e23f1DA0Ca13faf47F7D1f7dCADf87
14086,15627925,1711590,12023351662,1699194,12396,4106,1005,0x67f57d9C4dc6fbEE423B15B6bBe488c3896AfBc3,0xEd03c484f4e22095CA89BF41c2eb2c4B23a443bD
14087,15627925,21000,12023351662,21000,0,2,172,0x0bC62D5Bb927295Db6D46D98EABf32eCbd55c01A,0xcE64da4caf4c7D5A65c74Fbacb16E170d300285d
14088,15627925,389431,12023351662,385839,3592,1162,214,0x68b3465833fb72A70ecDF485E0e4C7bD8665Fc45,0x9AC3b437ce4D8F10210955D7A7829f3312612D90
14089,15627925,177236,12023351662,175548,1688,330,11,0xb5d2A992442988D0E4bFd1447eba4b8dC1D1A362,0x7eA5C91565a1104bc3227248a7c5E34dAa848a6E
14090,15627925,67254,12023351662,67050,204,74,44,0x9b9D659D4f2cF68b6616Cc0a65683f1951Eb725C,0xa04159bd2521f6d7Cd48083daD6c6c4D7dabCb7a
14091,15627925,73188,12023351662,72580,608,138,8,0xA0b86991c6218b36c1d19D4a2e9Eb0cE3606eB48,0xb201Bd0Ee5dC51936176235566A0598778383324
14092,15627925,46280,12023351662,45420,860,138,784,0xC02aaA39b223FE8D0A0e5C4F27eAD9083C756Cc2,0x8841e5a990f242Fdfd24413969F214b28ccC6161
14093,15627925,21000,12023351662,21000,0,2,5,0x69334e638297E37999ef876aDE880C1209DDFC2b,0xDA7A7F4624FFBc47735190041371aE91Ba85c902
14094,15627925,79564,12023351662,79172,392,138,37,0x2b591e99afE9f32eAA6214f7B7629768c40Eeb39,0xCd20418Fc29288Ff61eEC92bfe49Ef8A655Db373
14095,15627925,68988,12023351662,68416,572,138,984,0xC02aaA39b223FE8D0A0e5C4F27eAD9083C756Cc2,0x004eccB6fD0dab797aeb0Eb1045c4fA523D78B91
14096,15627925,46135,12023351662,45647,488,138,1195,0x1Fa8559e873f698292766790AeCf8080A66433F6,0x39af7F3790Eaf739C6aD27b541169252A3D152DC
14097,15627925,46859,12023351662,46371,488,138,20,0x197492CCB4B1acaAAcd43432657A17832E36AB49,0xffAE3Cc0620469716356E8bad190bB53c5600d21
14098,15627925,100000,12023351662,99344,656,138,1774,0xD057B63f5E69CF1B929b356b579Cba08D7688048,0x07c2af75788814BA7e5225b2F5c951eD161cB589
14099,15627925,21000,12023351662,21000,0,2,8,0x03e0881BF67bB1cd95A93E9517E298D54E564B70,0x45e7F4D93B33c2296Cb1B410992f5420d4CCD518
14100,15627925,27938,12023351662,27874,64,10,2755,0xC02aaA39b223FE8D0A0e5C4F27eAD9083C756Cc2,0xA36CFf02f9A5B894444ae95f64B62824080b54A9
14101,15627925,21000,12023351662,21000,0,2,7,0x6dE5bCDe67Ba942820866763f023C10F4dc14837,0x9cD6F9Fd2F8aaf1c871d92CE5d99472530391A82
14102,15627925,390612,12023351662,385344,5268,1610,2203,0x68b3465833fb72A70ecDF485E0e4C7bD8665Fc45,0x0AddBf7cf800eAdD5bDbeFA31CfE167824B05E48
14103,15627925,218243,12023351662,216555,1688,330,34,0xC08D1c7B0cf30fAFF0Bd1940fA429A91e490cb3A,0xB96Ab28F90b838435152148032392ea0da3AC7DA
14104,15627925,50719,12023351662,50111,608,138,75,0xdAC17F958D2ee523a2206206994597C13D831ec7,0xA534651A29e4538708be186f4B5CA5BB95A17BE1
14105,15627925,69529,12023351662,68921,608,138,32,0xdAC17F958D2ee523a2206206994597C13D831ec7,0x55263F3e82Eea6eE7E6a7033F91FC8e2C38cCE13
14106,15627925,380572,12023351662,378828,1744,394,1468,0x897249FEf87Fa6D1E7FeDCB960c2A01Ec99ecC6C,0x6905435fa2e1cB31972bb0F0bFF16F5744A91876
14107,15627925,199366,12023351662,199010,356,138,46,0xE60fE8C4C60Fd97f939F5136cCeb7c41EaaA624d,0xfc4d5f7a7d7D10c6Fc89F520325AB3AD420D6465
14108,15627925,218944,12023351662,218880,64,10,119,0xa0B329EA79e09Fa19fFDC781Eca58cC8916Ee855,0xB38c18E15Dd16437D27b3fF1d22B200C8dE31697
14109,15627925,104467,12023351662,101191,3276,1034,201,0x0000000000c2d145a2526bD8C716263bFeBe1A72,0x68a1F25D55230A9224395Db7f50F57e7b460C93D
14110,15627925,130734,12023351662,130458,276,74,19,0x7f39C581F595B53c5cb19bD0b3f8dA6c935E2Ca0,0x31437e500Ead4285A717f5F23017a05450FCb1c1
14111,15627925,298808,12023351662,296000,2808,842,11,0x68b3465833fb72A70ecDF485E0e4C7bD8665Fc45,0x9b69eB5b4c5B1B69c2ec07B2f93017BF1d14de27
14112,15627925,99007,12023351662,97691,1316,330,6,0xA0c68C638235ee32657e8f720a23ceC1bFc77C77,0xE3957D8De772F695Ae9586973F64Bffa922a9440
14113,15627925,46135,12023351662,45647,488,138,738,0x1Fa8559e873f698292766790AeCf8080A66433F6,0x3bc232768C62eA03ED2cbDc9315223d1dF820f64
14114,15627925,50719,12023351662,50111,608,138,25,0xdAC17F958D2ee523a2206206994597C13D831ec7,0x227D2f1F7A018dC24767A6eA512937A202DdF672
14115,15627925,21000,12023351662,21000,0,2,1119,0xCEF557e276AE24293904BA0F2bbbD1FBa8Ef3338,0x270b53a7B1b2A57e0c90b96a09604B8186633D20
14116,15627925,181676,12023351662,178084,3592,1162,18,0x68b3465833fb72A70ecDF485E0e4C7bD8665Fc45,0x98A0d237cd78E45F900014212A9A067e9D5EeDCa
14117,15627925,238963,12023351662,236167,2796,842,33,0x68b3465833fb72A70ecDF485E0e4C7bD8665Fc45,0xd605639f9438F0A9D4FD2B86D32780E6FE160934
14118,15627925,21000,12023351662,21000,0,2,8,0xAb872b1358DE9Aaa6b94a414b5D5f3Df3Dd3C13c,0xe9292fa198778331496E114Be2B906a2D179DcB2
14119,15627925,29039,12023351662,28563,476,138,2488,0x69690fa25f3c2D4CCBf0e4395b098951f7473CcB,0xA17138c0675173B8Ea506Fb1b96FA754BC316cc2
14120,15627925,236779,12023351662,233603,3176,906,594,0x68b3465833fb72A70ecDF485E0e4C7bD8665Fc45,0xCa1eE57390f16B67855D200Cebf59804277a9DDd
14121,15627925,340400,11987456986,332092,8308,2188,35,0x881D40237659C251811CEC9c364ef91dC08D300C,0x5e8433cAC99A1b5F0E117A62360EE9D8542Dd2fC
14122,15627925,90000,11864042927,90000,0,2,784427,0x5AbBC5a82Db5E6F515AeC24213dB66D7957B44Fa,0xcaD621da75a66c7A8f4FF86D30A2bF981Bfc8FdD
14123,15627925,54298,11702960787,53354,944,138,871,0xAD13C2a8d418d01F3236F4d8b9d724575a4e9d24,0xC96E36494656073AFC25E1b6299C73330898B37a
14124,15627925,65000,11678566766,64392,608,138,646180,0xdAC17F958D2ee523a2206206994597C13D831ec7,0x29D5527CaA78f1946a409FA6aCaf14A0a4A0274b
14125,15627925,113310,11523351662,113106,204,74,426,0x5D004ddB5D92938dAF8448b9eac1CaA593cd26Ca,0x26DC5D39Bd7A8bc2d792dcAAAC55FE6DCef25593
14126,15627925,113397,11523351662,108873,4524,1418,697,0xc30141B657f4216252dc59Af2e7CdB9D8792e1B0,0xCD133D337eAD9C2AC799eC7524A1e0f8Aa30c3b1
14127,15627925,113310,11523351662,113106,204,74,427,0x5D004ddB5D92938dAF8448b9eac1CaA593cd26Ca,0x26DC5D39Bd7A8bc2d792dcAAAC55FE6DCef25593
14128,15627925,65951,11523351662,64651,1300,202,97,0x57f1887a8BF19b14fC0dF6Fd9B2acc9Af147eA85,0x072B6AaC774fFe93371f8085D4a082EA8d92db3B
14129,15627925,113310,11523351662,113106,204,74,428,0x5D004ddB5D92938dAF8448b9eac1CaA593cd26Ca,0x26DC5D39Bd7A8bc2d792dcAAAC55FE6DCef25593
14130,15627925,113310,11523351662,113106,204,74,429,0x5D004ddB5D92938dAF8448b9eac1CaA593cd26Ca,0x26DC5D39Bd7A8bc2d792dcAAAC55FE6DCef25593
14131,15627925,21000,11523351662,21000,0,2,6,0x1CC6eDc1950989b7EAe4b673F0e1E25835D04Ba3,0xF2673cb3b22212005f1cCE6515c942B7cD4Aa31c
14132,15627925,181476,11523351662,179912,1564,394,93,0x1Fa8559e873f698292766790AeCf8080A66433F6,0x80b44B67d0dE29d64fDfc5bD7227b21a52556Fc8
14133,15627925,113310,11523351662,113106,204,74,430,0x5D004ddB5D92938dAF8448b9eac1CaA593cd26Ca,0x26DC5D39Bd7A8bc2d792dcAAAC55FE6DCef25593
14134,15627925,113310,11523351662,113106,204,74,431,0x5D004ddB5D92938dAF8448b9eac1CaA593cd26Ca,0x26DC5D39Bd7A8bc2d792dcAAAC55FE6DCef25593
14135,15627925,177822,11523351662,174230,3592,1162,1,0x68b3465833fb72A70ecDF485E0e4C7bD8665Fc45,0xD604fE2Dc2D5f3A400F72f5EEb5d7429665B23cA
14136,15627925,113310,11523351662,113106,204,74,432,0x5D004ddB5D92938dAF8448b9eac1CaA593cd26Ca,0x26DC5D39Bd7A8bc2d792dcAAAC55FE6DCef25593
14137,15627925,113310,11523351662,113106,204,74,433,0x5D004ddB5D92938dAF8448b9eac1CaA593cd26Ca,0x26DC5D39Bd7A8bc2d792dcAAAC55FE6DCef25593
14138,15627925,2000000,11180423860,1997940,2060,522,477,0x7a250d5630B4cF539739dF2C5dAcb4c659F2488D,0xCa6b060a4E795473a2205ebD1ff2599A8bEF1DF8
14139,15627925,2000000,11180423860,1997928,2072,522,413,0x7a250d5630B4cF539739dF2C5dAcb4c659F2488D,0xC598DE2944734AF41EeB92dFD24Aac8803aDca0E
14140,15627925,199060,11097082359,197936,1124,210,5862,0x0000000000304a767881fDcCB30FCEB51f6221e2,0x1185Be8dA26B2AE0a6950f9587589536f9DDA9e8
14141,15627925,127890,11071991054,127262,628,202,180,0x084b1c3C81545d370f3634392De611CaaBFf8148,0x465169037Da9f80F3bA4bf6d3e6DA74e5c1BE182
14142,15627925,21000,11071991054,21000,0,2,33,0xca9a727cb44007206cB419955CCa7729199fB256,0xe77574207a1321a01721346B2bFe975FA6214Eef
14143,15627925,389431,11071991054,385839,3592,1162,60,0x68b3465833fb72A70ecDF485E0e4C7bD8665Fc45,0x9226286eaA0252e6FAd096609b823C524958772d
14144,15627925,51288,11000000000,50344,944,138,8,0xd031edafac6a6ae5425e77F936022E506444C242,0x1384037377FE12445c56628d1926b977af4a1560
14145,15627925,1896811,10759273487,309931,1586880,199370,7139,0x1c479675ad559DC151F6Ec7ed3FbF8ceE79582B6,0xa4b1E63Cb4901E327597bc35d36FE8a23e4C253f
14146,15627925,158992,10759273487,117972,41020,5428,3578,0xfBd2541e316948B259264c02f370eD088E04c3Db,0xfa46908B587f9102E81CE6C43b7B41b52881c57F
14147,15627925,26000,10523351662,26000,0,2,12040,0xeBec795c9c8bBD61FFc14A6662944748F299cAcf,0xDAFEA492D9c6733ae3d56b7Ed1ADB60692c98Bc5
14148,15627926,233672,10709678477,231488,2184,650,119487,0xA69babEF1cA67A37Ffaf7a485DfFF3382056e78C,0x93F635372008B7c5d770AAa6Ff313454c8dc498c
14149,15627926,228672,10709678477,226500,2172,650,117905,0xA69babEF1cA67A37Ffaf7a485DfFF3382056e78C,0x26bce6eCb5b10138e4bf14aC0ffcc8727FEF3B2e
14150,15627926,27938,11919680677,27874,64,10,392,0xC02aaA39b223FE8D0A0e5C4F27eAD9083C756Cc2,0xb58489Ca644513558e2836377B15a7c1514e722b
14151,15627926,332312,12040682107,318564,13748,4236,4,0x881D40237659C251811CEC9c364ef91dC08D300C,0x6EB7C7B8A4953F9ac495ee6d338019da1E1aa16a
14152,15627926,45038,12173783801,44974,64,10,676,0xC02aaA39b223FE8D0A0e5C4F27eAD9083C756Cc2,0x99E8A13E77CEC29a3C64cEA54A82a53A22496917
14153,15627926,424424,24000000000,422424,2000,522,963,0x7a250d5630B4cF539739dF2C5dAcb4c659F2488D,0xbaAbc782E6Ca0F76072301461aaC0d8A27209F58
14154,15627926,400000,20709678477,393700,6300,1802,248,0x00000000006c3852cbEf3e08E8dF289169EdE581,0x6E36Efec92219538444A964F136fB57cF5ae3b3E
14155,15627926,150000,17842845840,149344,656,138,16188,0xdDF7Fd345D54ff4B40079579d4C4670415DbfD0A,0x1785ee8Dd9E22F14E7D538b32c505905cFDE3eB2
14156,15627926,212560,17000000000,206260,6300,1802,576,0x00000000006c3852cbEf3e08E8dF289169EdE581,0xae57349a0C3507b180DF0965a64b8879d2656560
14157,15627926,164248,16048211682,162652,1596,230,2397,0x9507c04B10486547584C37bCBd931B2a4FeE9A41,0xeDa2ec928a39Db51d18AFC4875F6B807C85D66b3
14158,15627926,21000,15550558940,21000,0,2,1,0x2FAF487A4414Fe77e2327F0bf4AE2a264a776AD2,0x3823026CDc7351635a794dCBC5c969BF5D42C0B1
14159,15627926,21000,15550558940,21000,0,2,1,0x2FAF487A4414Fe77e2327F0bf4AE2a264a776AD2,0x8430db4174219A3F95aEfa64DFdc746844A86E55
14160,15627926,21000,15550558940,21000,0,2,4,0x2FAF487A4414Fe77e2327F0bf4AE2a264a776AD2,0xb48a96541353a1E1Cc91a8E1Bf1c405FBCAA5B6b
14161,15627926,21000,15550558940,21000,0,2,1,0x2FAF487A4414Fe77e2327F0bf4AE2a264a776AD2,0x2cEffB37450C9f7cA503d43570C89f279108b210
14162,15627926,21000,15550558940,21000,0,2,2,0x2FAF487A4414Fe77e2327F0bf4AE2a264a776AD2,0x5e580d693ad9b5C2bf7CaaF9001eA5c9FeB74B44
14163,15627926,21000,15550558940,21000,0,2,1,0x2FAF487A4414Fe77e2327F0bf4AE2a264a776AD2,0xD79CDbfd70bAE0010751830f660CbBD2d5a74d1a
14164,15627926,21000,15470000000,21000,0,2,8,0x2FAF487A4414Fe77e2327F0bf4AE2a264a776AD2,0xB0B5932cFA198ed6a5Fb45e900a6e05aeE4C99af
14165,15627926,21000,15306258385,21000,0,2,1,0x7abE0cE388281d2aCF297Cb089caef3819b13448,0x162fa4e82e828fcC379706b334D17E912eb0308A
14166,15627926,21000,15306258385,21000,0,2,3,0x7abE0cE388281d2aCF297Cb089caef3819b13448,0xE9D4a19868DcD0d0A713322B56673F1AbE8e0a07
14167,15627926,48780,15235187052,48184,596,138,36,0xA0b86991c6218b36c1d19D4a2e9Eb0cE3606eB48,0x8AbC49647FcfF7c1Da7bFdD89416fF2a0cA98e75
14168,15627926,750000,14709678477,748248,1752,458,1284,0x7a250d5630B4cF539739dF2C5dAcb4c659F2488D,0x9f394569A5D2Af700A5e6eaEFA067373d1b12C3C
14169,15627926,79956,14624417238,79300,656,138,4709960,0x111111111117dC0aa78b770fA6A738034120C302,0x2FAF487A4414Fe77e2327F0bf4AE2a264a776AD2
14170,15627926,76676,14624417238,75732,944,138,0,0xdAC17F958D2ee523a2206206994597C13D831ec7,0x40AbC97EEB69E480AFB743e2286D1A0b9b9ef65c
14171,15627926,76533,14624417238,75509,1024,202,4709961,0x320623b8E4fF03373931769A31Fc52A4E78B5d70,0x2FAF487A4414Fe77e2327F0bf4AE2a264a776AD2
14172,15627926,84261,14611690621,83297,964,202,355164,0xA0b86991c6218b36c1d19D4a2e9Eb0cE3606eB48,0x7abE0cE388281d2aCF297Cb089caef3819b13448
14173,15627926,700000,14009678477,698516,1484,330,1163,0x95B05Bc8f6c59847E7d2D484E8542363D422e341,0x47ec31abc6b86e49933dC7B2969EBEbE3De662cA
14174,15627926,88958,14000000000,87594,1364,330,14,0x4976fb03C32e5B8cfe2b6cCB31c09Ba78EBaBa41,0x03cc71FBe5E1620f5a3D9aC2135642260ADC82bb
14175,15627926,183262,13709678477,176686,6576,1802,333,0x00000000006c3852cbEf3e08E8dF289169EdE581,0x4dE89519c7AE636270dBEC47D819B6a738a8330B
14176,15627926,275439,13709678477,273687,1752,458,1290,0x7a250d5630B4cF539739dF2C5dAcb4c659F2488D,0x1DC26ff48AbEf2d01c2A572b74117D7a19a2cD02
14177,15627926,245697,13709678477,239285,6412,1738,516,0x00000000006c3852cbEf3e08E8dF289169EdE581,0x9918d00765aACBa31507E5Ddb82421bc640FF45B
14178,15627926,21000,13450000000,21000,0,2,0,0x6dfc34609a05bC22319fA4Cce1d1E2929548c0D7,0x28f29912aeE5746725db40BF75A737893B3c1f72
14179,15627926,197441,13334678477,190865,6576,1802,664,0x00000000006c3852cbEf3e08E8dF289169EdE581,0xBCa5F00f856538dDFa1aC416221232fDbBb60f13
14180,15627926,197454,13334678477,190854,6600,1802,1583,0x00000000006c3852cbEf3e08E8dF289169EdE581,0x203ff37CD6820FB445eA9ECab7cEEd595fF70D7c
14181,15627926,49234,13209678477,48282,952,202,7,0x1Fa8559e873f698292766790AeCf8080A66433F6,0xCc8E92824ab726090FC5f935a64F5d86bf752B4c
14182,15627926,49234,13209678477,48282,952,202,7,0x1Fa8559e873f698292766790AeCf8080A66433F6,0xC0958535524f1D3883ce12858d32A8d6e4e412BB
14183,15627926,49234,13209678477,48282,952,202,7,0x1Fa8559e873f698292766790AeCf8080A66433F6,0x6E3F2b4c87f18bA249fe99a5D1F2b7884Fdc9b48
14184,15627926,49234,13209678477,48282,952,202,7,0x1Fa8559e873f698292766790AeCf8080A66433F6,0x8521725f3bc9D4Fc518eC431C2d7964a9B4dBD20
14185,15627926,49234,13209678477,48282,952,202,7,0x1Fa8559e873f698292766790AeCf8080A66433F6,0x7404dDc7aFF5923429AbF632A7f99EF71C6fa613
14186,15627926,339997,13209678477,338773,1224,266,25,0x79bAB004d5DbAf80A73e1633800EC51BeEa5F1DF,0x41d04ff02Bb7b4C159E2D010e30eB70001579095
14187,15627926,305965,13209678477,298965,7000,970,12,0x9b3B6974531d8AA15A87908FFd821A64863Ede5B,0xAa0671Ea356476E67533c760EA4D8DE86872F593
14188,15627926,57419,12760000000,56023,1396,394,7,0xf13F29330DcA76Be26A6c7E268da836Aef978E11,0xb42697100CABeb246323fE4D6801f1d8c7f7c7C4
14189,15627926,229603,12709678477,226843,2760,842,2411,0x68b3465833fb72A70ecDF485E0e4C7bD8665Fc45,0x41B9Ba8B989Ba0a1d73168278522550350df9E3B
14190,15627926,86811,12709678477,85859,952,202,829,0x1Fa8559e873f698292766790AeCf8080A66433F6,0x52b4AE6798DDd241f0e882960FAF3F966d488493
14191,15627926,86811,12709678477,85859,952,202,671,0x1Fa8559e873f698292766790AeCf8080A66433F6,0x4131918DbCeB7F8cB6C115188095aA6fCd9D2B7D
14192,15627926,86811,12709678477,85859,952,202,853,0x1Fa8559e873f698292766790AeCf8080A66433F6,0x1eb2Cbd1c6D5B6d16aBf1b2760eDf296DE7a1e10
14193,15627926,86811,12709678477,85859,952,202,984,0x1Fa8559e873f698292766790AeCf8080A66433F6,0x0E642E32974470085e362FE76DE5C43330632bdb
14194,15627926,86811,12709678477,85859,952,202,1201,0x1Fa8559e873f698292766790AeCf8080A66433F6,0xBDd4F4d83f67A09A3BF7d57638E1Dcd32387E331
14195,15627926,34315,12709678477,33135,1180,394,2612,0x1A90B3Dead0113740266b7F7Ea1136e8ED1b48C5,0x24245e6c515187aB9b103BD278dAd0d5A08EdBaA
14196,15627926,100000,12709678477,100000,0,2,220348,0xC1C90C851d4C5a215EC3CB5D9DBCF14D0f2752Fa,0x079A892628EBf28d0Ed8f00151cff225A093dc63
14197,15627926,42000,12709678477,42000,0,2,329577,0x3c01e706Af9f91d227D921144D656cf6Bea38Ff1,0x9430801EBAf509Ad49202aaBC5F5Bc6fd8A3dAf8
14198,15627926,237266,12709678477,233590,3676,1162,310,0x68b3465833fb72A70ecDF485E0e4C7bD8665Fc45,0xeC11Cae419177e6ecE61c6C35DBD0F8e08B89982
14199,15627926,60760,12709678477,59816,944,138,925,0xA0b86991c6218b36c1d19D4a2e9Eb0cE3606eB48,0x5C7ca6A93a46aE786D99D91ED423A91d6fa13879
14200,15627926,21000,12709678477,21000,0,2,1228783,0x3cE0b055d78DB2d119bd5758c9065F71430AA71b,0x71660c4005BA85c37ccec55d0C4493E66Fe775d3
14201,15627926,46219,12709678477,45647,572,138,59,0x1Fa8559e873f698292766790AeCf8080A66433F6,0xA619F080255d6f02b0622b7fc1509C93B4A314bB
14202,15627926,202010,12709678477,196218,5792,1170,2305,0xDef1C0ded9bec7F1a1670819833240f027b25EfF,0x81FD0A1D13059E473C1E02D73705124315E14CbA
14203,15627926,21000,12709678477,21000,0,2,1211355,0xB13AC574fbA131a2dda0820307E9E3DE1406de05,0x95A9bd206aE52C4BA8EecFc93d18EACDd41C88CC
14204,15627926,21000,12709678477,21000,0,2,52390,0xaA300f476058385E3F38C77F3EAdDb42929a5323,0x7c195D981AbFdC3DDecd2ca0Fed0958430488e34
14205,15627926,21000,12709678477,21000,0,2,1783220,0x68E0E463DCDD8FBC7D4E3301117ee073e1b8e754,0x503828976D22510aad0201ac7EC88293211D23Da
14206,15627926,21000,12709678477,21000,0,2,1783221,0x9730cd6cE284C7B902dc7720D0b9647CC1B5775D,0x503828976D22510aad0201ac7EC88293211D23Da
14207,15627926,23300,12709678477,23300,0,2,1,0xA9D1e08C7793af67e9d92fe308d5697FB81d3E43,0x4B7DcCf7003C8De993D227E4d744b13Bbb5Ea779
14208,15627926,23300,12709678477,23300,0,2,7,0xA9D1e08C7793af67e9d92fe308d5697FB81d3E43,0xe487c99619045DCf27a637E15CAbF456e2f3fef3
14209,15627926,23300,12709678477,23300,0,2,1,0xA9D1e08C7793af67e9d92fe308d5697FB81d3E43,0x61004D57c0a11849DedCf38d0D63145a7CB83E08
14210,15627926,23300,12709678477,23300,0,2,6,0xA9D1e08C7793af67e9d92fe308d5697FB81d3E43,0xa2AF66e585ed4e684dD76598dA1E1B6814B3aE37
14211,15627926,23300,12709678477,23300,0,2,22,0xA9D1e08C7793af67e9d92fe308d5697FB81d3E43,0x0bb965d3719758192579550561F74B709D64C10f
14212,15627926,23300,12709678477,23300,0,2,4,0xA9D1e08C7793af67e9d92fe308d5697FB81d3E43,0x4818F19A7B6912aeF8F431eEf0601C72408Fa979
14213,15627926,23300,12709678477,23300,0,2,1,0xA9D1e08C7793af67e9d92fe308d5697FB81d3E43,0x9844872fEb6619004C7eA7A89e65714700e93B68
14214,15627926,23300,12709678477,23300,0,2,0,0xA9D1e08C7793af67e9d92fe308d5697FB81d3E43,0x5Ed339baBa6D4E3c7e341882B1C4B98B858090bB
14215,15627926,21000,12709678477,21000,0,2,38,0x3cD751E6b0078Be393132286c442345e5DC49699,0xEcc97236B886ED2F4C947eF4e795FB80d3140Fe1
14216,15627926,21000,12709678477,21000,0,2,0,0x3cD751E6b0078Be393132286c442345e5DC49699,0x17831e4EB0E6DFDbF8B5fF132FCCA4D4a750A0a3
14217,15627926,23300,12709678477,23300,0,2,1,0xA9D1e08C7793af67e9d92fe308d5697FB81d3E43,0x2b4D95B73d5809B55728ab762B1005af926f8f7e
14218,15627926,23300,12709678477,23300,0,2,5727,0xA9D1e08C7793af67e9d92fe308d5697FB81d3E43,0x4675C7e5BaAFBFFbca748158bEcBA61ef3b0a263
14219,15627926,21000,12709678477,21000,0,2,0,0x3cD751E6b0078Be393132286c442345e5DC49699,0x6FF5ef76466c6ec11c1E5f582F49DB9dd48917d2
14220,15627926,23300,12709678477,23300,0,2,0,0xA9D1e08C7793af67e9d92fe308d5697FB81d3E43,0xAB15041Ce6859A3724044913111111b47496aAFe
14221,15627926,23300,12709678477,23300,0,2,11,0xA9D1e08C7793af67e9d92fe308d5697FB81d3E43,0x26687033F470CF31D40D3BD42fDe9AC4BD6a53cc
14222,15627926,23300,12709678477,23300,0,2,42,0xA9D1e08C7793af67e9d92fe308d5697FB81d3E43,0x31fF67b5DdCE13C58114eBBE3FE218F08f4bB7Fe
14223,15627926,21000,12709678477,21000,0,2,0,0x3cD751E6b0078Be393132286c442345e5DC49699,0x0F9539B9Cb59e7DA18521e63840AD30cd4aDFe47
14224,15627926,23300,12709678477,23300,0,2,0,0xA9D1e08C7793af67e9d92fe308d5697FB81d3E43,0x0ea6B1e6Fe034691C57524C37A007f617d47fFd7
14225,15627926,46135,12709678477,45647,488,138,319,0x1Fa8559e873f698292766790AeCf8080A66433F6,0x337F4D863564C0C82BF45EEc9B1A4286Ba683811
14226,15627926,309219,12709678477,303095,6124,1546,19,0xc9154424B823b10579895cCBE442d41b9Abd96Ed,0x582DE6cfdB6a5cD2cDd0E8432b4001C8BbdF4094
14227,15627926,46135,12709678477,45647,488,138,6939,0x1Fa8559e873f698292766790AeCf8080A66433F6,0x0653e299Ee741808F12427277FC8a062d9C718E1
14228,15627926,21000,12709678477,21000,0,2,0,0x3cD751E6b0078Be393132286c442345e5DC49699,0x5c50CfEF14e54Eb72804097641E9C5Ed7FebD12B
14229,15627926,46135,12709678477,45647,488,138,316,0x1Fa8559e873f698292766790AeCf8080A66433F6,0xBC4AD49BE7A12d771FC9F5ca9707547A71bf6455
14230,15627926,46135,12709678477,45647,488,138,316,0x1Fa8559e873f698292766790AeCf8080A66433F6,0x5c79F4B2535185D86d3A022b28FCCcA504c8B0D8
14231,15627926,23300,12709678477,23300,0,2,42,0xA9D1e08C7793af67e9d92fe308d5697FB81d3E43,0x267F481B18Be284d1470563f863352148d3705f2
14232,15627926,23300,12709678477,23300,0,2,1,0xA9D1e08C7793af67e9d92fe308d5697FB81d3E43,0x1b1173968d76aa664eF03872f3f95fF4659BA66a
14233,15627926,23300,12709678477,23300,0,2,3,0xA9D1e08C7793af67e9d92fe308d5697FB81d3E43,0x8D9458f516aFC753Ce3466090c77e27972896C59
14234,15627926,21000,12709678477,21000,0,2,1,0x3cD751E6b0078Be393132286c442345e5DC49699,0x8fC24a8951Fe506c419f25a70a707ddB202B3AcA
14235,15627926,46135,12709678477,45647,488,138,275,0x1Fa8559e873f698292766790AeCf8080A66433F6,0x134b4Ccb9D178F893687948337AAC079cC5F55ec
14236,15627926,21000,12709678477,21000,0,2,5,0x3cD751E6b0078Be393132286c442345e5DC49699,0x6709085463EbFb3Cc0B416596569e1f5eFB4DF87
14237,15627926,46135,12709678477,45647,488,138,113,0x1Fa8559e873f698292766790AeCf8080A66433F6,0xf844B9C29FEC74ED26C8aD77cEA077bad0AB151d
14238,15627926,217785,12709678477,214989,2796,842,903,0x68b3465833fb72A70ecDF485E0e4C7bD8665Fc45,0x1aa4bf5728Cd3a415D9aEcea807C1292d1C96f1C
14239,15627926,21000,12669112349,21000,0,2,11,0x3F54924636cdF87Bb21017b1CBA6f707f528a0Ec,0xd192E0e9dD9710D63DE2D591CC08aC648Ca173fe
14240,15627926,55432,12210678477,54752,680,138,869,0x6B175474E89094C44Da98b954EedeAC495271d0F,0xA5D62640081d2a1bc5deD398F2AA5aC6e463746b
14241,15627926,46135,12209678477,45647,488,138,156,0x1Fa8559e873f698292766790AeCf8080A66433F6,0xde40131e0d03104F86Adc112798e8D460880A84b
14242,15627926,46638,12209678477,46150,488,138,0,0xc816BAAE5fC77395c333CA78625A0F420a16fB99,0x8ddd8d371a3F1E31DEA3adc873a6426cc02ce0c9
14243,15627926,1329187,12209678477,1218463,110724,38354,927,0x00000000006c3852cbEf3e08E8dF289169EdE581,0x71042f6B3AAAE4B7cceaa0Abee9B151a0C109Cc0
14244,15627926,56322,12209678477,54974,1348,394,439,0xe4605d46Fd0B3f8329d936a8b258D69276cBa264,0x216A023E0c19382D895a66A76dd92E898c9BE3a7
14245,15627926,52017,12209678477,51065,952,202,43,0x1Fa8559e873f698292766790AeCf8080A66433F6,0xDe2FBcDfd564D2D2Be6066eE88ABCdd889c79F90
14246,15627926,73188,12209678477,72580,608,138,7,0xA0b86991c6218b36c1d19D4a2e9Eb0cE3606eB48,0x5b1605966694fc732a0fCE2A56e9475a5EaFEe32
14247,15627926,88960,12209678477,88352,608,138,22,0xfc4913214444aF5c715cc9F7b52655e788A569ed,0x6EAEe718d196f58E7Cf55eeE746683D1b8f733e3
14248,15627926,57012,12209678477,55536,1476,458,58,0x76BE3b62873462d2142405439777e971754E8E77,0x698b88C1991e77719Fe333a46ed98E9d6700Bc64
14249,15627926,184395,12209678477,177731,6664,1810,94,0x00000000006c3852cbEf3e08E8dF289169EdE581,0xE8C11c5e7eb6CF8C7277377FD4fb877F05Da418C
14250,15627926,188215,12209678477,184539,3676,1162,27314,0x68b3465833fb72A70ecDF485E0e4C7bD8665Fc45,0x6dD91BdaB368282dc4Ea4f4beFc831b78a7C38C0
14251,15627926,99786,12209678477,97906,1880,330,503,0x000000000000509081d6FCD3ee63e791aD1db763,0xb46d81875005228e1da4eDB50e229683972a8375
14252,15627926,196344,12209678477,194656,1688,330,3,0x4DfA658c22b9A6E37dB4a89D6eB9F70090361a7e,0x79cbD246d8f2b2885e63427dE9Cb75b3140bECb6
14253,15627926,46135,12209678477,45647,488,138,203,0x1Fa8559e873f698292766790AeCf8080A66433F6,0x224617bB5a040a41Eb3a26A0890AC132898b09A9
14254,15627926,21000,12209678477,21000,0,2,4062,0x212A4A9BfE2eF64Fb1eDDd7693c3334d1E9136D5,0x017347cb75aC8725608e593EA35d83f9B2b3cfb8
14255,15627926,46135,12209678477,45647,488,138,349,0x1Fa8559e873f698292766790AeCf8080A66433F6,0xF93d1397F2f245F6d602fa199D5E5C1cE17026bf
14256,15627926,46135,12209678477,45647,488,138,129,0x1Fa8559e873f698292766790AeCf8080A66433F6,0x369b313684770B3d3C3A7F43467F221701922884
14257,15627926,109765,12209678477,108213,1552,394,12,0x3ee18B2214AFF97000D974cf647E7C347E8fa585,0x6B3F6c0500FEFE3438102b5379095Da7BA765F63
14258,15627926,132236,12209678477,125968,6268,1618,26,0x00000000006c3852cbEf3e08E8dF289169EdE581,0x4DBB6b7cF4BD8E9C72763cCd7cBc1c77600d308d
14259,15627926,28754,12209678477,28550,204,74,3,0x8F0b256F2e94962587a0159089Fa1E390085447F,0x23180E88bdE1fc5EA9278a41c75a1D35Aeab73FE
14260,15627926,46747,12209678477,46175,572,138,579,0x2D0Ee46b804f415Be4dC8aa1040834F5125EBD2E,0x16be9CC6C13641Fdfe66868b3743E133A218E8A6
14261,15627926,236520,12209678477,235584,936,266,148,0xa356867fDCEa8e71AEaF87805808803806231FdC,0x93750D820cA511BCf9d98bE98FB011bE5703CcAe
14262,15627926,197401,12209678477,190837,6564,1802,825,0x00000000006c3852cbEf3e08E8dF289169EdE581,0xeE033638d44be47dc01495493985a7FD65Ce28Ee
14263,15627926,185018,12209678477,178478,6540,1802,97,0x00000000006c3852cbEf3e08E8dF289169EdE581,0x0A8C3777162CAb5B2063C3587dE3E02bf0568ddc
14264,15627926,46286,12209678477,45642,644,138,168,0x1EA48B9965bb5086F3b468E50ED93888a661fc17,0x7E56b14AA930Abb55E272D6f75f7612Bb6a4DfA2
14265,15627926,27938,12209678477,27874,64,10,130,0xC02aaA39b223FE8D0A0e5C4F27eAD9083C756Cc2,0x3F37489c83fC9D8F2C2D7188DF1aEF37b4f320D2
14266,15627926,46135,12209678477,45647,488,138,11,0x1Fa8559e873f698292766790AeCf8080A66433F6,0xfFC42c19966D0f2999a01960D66C22aED6bC9673
14267,15627926,21000,12209678477,21000,0,2,923,0x754bf9D3fB825f75e15e6eB3A01aC77B33d9D08A,0x9BC66deb421FAf05041eE69f8dB194F6a34bdC37
14268,15627926,45387,12209678477,44447,940,202,407,0xC86664e7d2608f881f796ee8E24FA9d4d7598406,0x7D3E5dD617EAF4A3d42EA550C41097086605c4aF
14269,15627926,221127,12209678477,219163,1964,522,104,0x1B671CdB1F41Ec3d30f6402Bdf3c0e5C4eF277f0,0xBCD24deBaB6fEe07c960606c5bbaFbd61B5D1Bc3
14270,15627926,29566,12209678477,29090,476,138,2489,0xe5B4D6B5F37cae9Dc4c7384cd97038CD0573d7D2,0xA17138c0675173B8Ea506Fb1b96FA754BC316cc2
14271,15627926,105218,12209678477,105166,52,10,446,0xC67e9Cdf599369130DD0841Ee5CB8eBF9BB661C4,0xa6c6CA43bf2E0E354026B49a085307E275341b7F
14272,15627926,46135,12209678477,45647,488,138,586,0x1Fa8559e873f698292766790AeCf8080A66433F6,0xbe358587cCFae29891022C66A13F8a9868cd4CC7
14273,15627926,60760,12209678477,59816,944,138,858,0xA0b86991c6218b36c1d19D4a2e9Eb0cE3606eB48,0xAa4B6B4c7417248dF49dc484d5Eb9a4377A4C7e1
14274,15627926,135332,12209678477,133112,2220,650,707,0xC45f3c76FeeEa53aAE5AFA9b51F166E025145400,0x7355cA5613e3c943F6df3652E7fc4e4A8b800976
14275,15627926,46219,12209678477,45647,572,138,1010,0x1Fa8559e873f698292766790AeCf8080A66433F6,0xf26695516E5418e534e8d466afA8857411cb1E36
14276,15627926,166273,12209678477,159645,6628,1810,120,0x00000000006c3852cbEf3e08E8dF289169EdE581,0xa982bA5645A1b04c256EcE852Cb87ca742612Ca4
14277,15627926,142079,12209678477,135451,6628,1810,110,0x00000000006c3852cbEf3e08E8dF289169EdE581,0x2Fb99221fb673D1bed25204C069879206b481715
14278,15627926,722326,12209678477,721626,700,202,388,0x8ffb9b504d497e4000967391e70D542b8cC6748A,0x72847C8Bdc54b338E787352bceC33ba90cD7aFe0
14279,15627926,46103,12209678477,45615,488,138,68,0x34Bc797F40Df0445c8429d485232874B15561728,0x4237E57e82B1Ec2e572c0eF64689fb2886A5E5E6
14280,15627926,46135,12209678477,45647,488,138,28,0x1Fa8559e873f698292766790AeCf8080A66433F6,0x10c699e993857eB0430d5c63AF0d9E74Bc5637bb
14281,15627926,46135,12209678477,45647,488,138,31,0x1Fa8559e873f698292766790AeCf8080A66433F6,0xF5ca89D5d79Bee75f40fe74bAda1239Ac44B0032
14282,15627926,21000,12209678477,21000,0,2,103,0x0f6006Bb2B990dD4cA90D9c86317308bf7506F47,0x57AE0c4F3BEe8F074C3A2d029F735F4dF90a1A12
14283,15627926,229603,12209678477,226843,2760,842,175,0x68b3465833fb72A70ecDF485E0e4C7bD8665Fc45,0xF698f0768e74AFFE1913084f85B81E25dDF17370
14284,15627926,171188,12209678477,161044,10144,2122,178,0x0B9857ae2D4A3DBe74ffE1d7DF045bb7F96E4840,0x6792c4bDc1b45EfA131ecCa985A28EF5c4622E48
14285,15627926,55953,12209678477,55009,944,138,368,0x5ad15adF0e72E77D6d4A302Ea49fAF48AB999B12,0x10EEB1575CAd64A73453b91863f4d81886A68a02
14286,15627926,21000,12209678477,21000,0,2,1,0x2930ce6eBDfCcd0A7CCcb8B6EA87e6d336D8081E,0xc392171052E3D51e01526935476fCAA0cEEE387e
14287,15627926,200000,12209678477,194052,5948,1674,1,0x00000000006c3852cbEf3e08E8dF289169EdE581,0xA6dE2fE8E983C896F4ec61D567466ba524615CB8
14288,15627926,29468,12209678477,28992,476,138,2490,0x07a13eea351D501cFedf96BDA8528bBC71CA5D80,0xA17138c0675173B8Ea506Fb1b96FA754BC316cc2
14289,15627926,244882,12209678477,238294,6588,1802,324,0x00000000006c3852cbEf3e08E8dF289169EdE581,0x8fFa26E287C697Ea57c6D31372179CD3a4d35E53
14290,15627926,113310,11709678477,113106,204,74,434,0x5D004ddB5D92938dAF8448b9eac1CaA593cd26Ca,0x26DC5D39Bd7A8bc2d792dcAAAC55FE6DCef25593
14291,15627926,113310,11709678477,113106,204,74,435,0x5D004ddB5D92938dAF8448b9eac1CaA593cd26Ca,0x26DC5D39Bd7A8bc2d792dcAAAC55FE6DCef25593
14292,15627926,340803,11709678477,336795,4008,1226,109,0x68b3465833fb72A70ecDF485E0e4C7bD8665Fc45,0x8ffc399De3A87CbA90f0645826Bd16f0cb0585Fe
14293,15627926,113310,11709678477,113106,204,74,436,0x5D004ddB5D92938dAF8448b9eac1CaA593cd26Ca,0x26DC5D39Bd7A8bc2d792dcAAAC55FE6DCef25593
14294,15627926,113310,11709678477,113106,204,74,437,0x5D004ddB5D92938dAF8448b9eac1CaA593cd26Ca,0x26DC5D39Bd7A8bc2d792dcAAAC55FE6DCef25593
14295,15627926,113310,11709678477,113106,204,74,438,0x5D004ddB5D92938dAF8448b9eac1CaA593cd26Ca,0x26DC5D39Bd7A8bc2d792dcAAAC55FE6DCef25593
14296,15627926,113310,11709678477,113106,204,74,439,0x5D004ddB5D92938dAF8448b9eac1CaA593cd26Ca,0x26DC5D39Bd7A8bc2d792dcAAAC55FE6DCef25593
14297,15627926,113310,11709678477,113106,204,74,440,0x5D004ddB5D92938dAF8448b9eac1CaA593cd26Ca,0x26DC5D39Bd7A8bc2d792dcAAAC55FE6DCef25593
14298,15627926,181920,11709678477,179076,2844,842,2343,0x68b3465833fb72A70ecDF485E0e4C7bD8665Fc45,0xc44C70fBFEf750862fbCf73F5197a28bCAA11253
14299,15627926,113310,11709678477,113106,204,74,441,0x5D004ddB5D92938dAF8448b9eac1CaA593cd26Ca,0x26DC5D39Bd7A8bc2d792dcAAAC55FE6DCef25593
14300,15627926,113310,11709678477,113106,204,74,442,0x5D004ddB5D92938dAF8448b9eac1CaA593cd26Ca,0x26DC5D39Bd7A8bc2d792dcAAAC55FE6DCef25593
14301,15627926,386988,11702960787,381304,5684,1866,328,0x68b3465833fb72A70ecDF485E0e4C7bD8665Fc45,0x8ff30523088a50Bbac9e2CB240d74AA676d7Bb77
14302,15627926,46382,11258317869,45726,656,138,13,0xC631bE100F6Cf9A7012C23De5a6ccb990EAFC133,0xAdf5249Bf641a75b094e0AE986500A9520fD9889
14303,15627926,318604,10945600302,157680,160924,20314,183263,0x5E4e65926BA27467555EB562121fac00D24E9dD2,0x6887246668a3b87F54DeB3b94Ba47a6f63F32985
14304,15627926,30000,10709678477,30000,0,2,643,0x388C818CA8B9251b393131C08a736A67ccB19297,0xf573d99385C05c23B24ed33De616ad16a43a0919
14305,15627927,238999,37000000000,232687,6312,1802,1270,0x00000000006c3852cbEf3e08E8dF289169EdE581,0x6C4F2b82e1396aEf113d90b2FbF6C1DeDE1f8Bf5
14306,15627927,216769,25411069170,210457,6312,1802,1945,0x00000000006c3852cbEf3e08E8dF289169EdE581,0xB58007c1990a0ae29f0D34543714BAf168149F82
14307,15627927,44700,16498800000,44056,644,138,13131,0x9f8F72aA9304c8B593d555F12eF6589cC3A579A2,0x7FB63CC0Fe905eC1D3C11Af30EF6C72B3BcB0069
14308,15627927,212591,15411069170,206267,6324,1802,1222,0x00000000006c3852cbEf3e08E8dF289169EdE581,0xC541BC01c71D83f10f42f5040094cdFfED5741b1
14309,15627927,207128,12411069170,206472,656,138,4232363,0x0F5D2fB29fb7d3CFeE444a200298f468908cC942,0xDFd5293D8e347dFe59E90eFd55b2956a1343963d
14310,15627927,207128,12411069170,207128,0,2,3492302,0x93C03bBAda376904094EbA343438F2F307D84B87,0x56Eddb7aa87536c09CCc2793473599fD21A8b17F
14311,15627927,207128,12411069170,206532,596,138,3199195,0xdAC17F958D2ee523a2206206994597C13D831ec7,0x9696f59E4d72E237BE84fFD425DCaD154Bf96976
14312,15627927,207128,12411069170,206532,596,138,4468986,0xdAC17F958D2ee523a2206206994597C13D831ec7,0x21a31Ee1afC51d94C2eFcCAa2092aD1028285549
14313,15627927,207128,12411069170,206472,656,138,4708728,0x0F5D2fB29fb7d3CFeE444a200298f468908cC942,0x28C6c06298d514Db089934071355E5743bf21d60
14314,15627927,207128,12411069170,207128,0,2,4468987,0x4b968332e200Ec13282B97b50Ff080d9b3AD0917,0x21a31Ee1afC51d94C2eFcCAa2092aD1028285549
14315,15627927,238999,12411069170,232687,6312,1802,1823,0x00000000006c3852cbEf3e08E8dF289169EdE581,0x9686ef5e52E51FA6c8bbfAcCb2Ff6b958C4625a9
14316,15627927,287370,12411069170,285010,2360,522,610,0x283Af0B28c62C092C9727F1Ee09c02CA627EB7F5,0x476c8712bf3A84f5a04db2D6a81d374f3F1AAD99
14317,15627927,39617,12411069170,39353,264,74,97,0xC02aaA39b223FE8D0A0e5C4F27eAD9083C756Cc2,0xe3B20027E43A73e97a0BD4044DcC79D2954a95b6
14318,15627927,46267,12411069170,45691,576,74,442,0x283Af0B28c62C092C9727F1Ee09c02CA627EB7F5,0xf7c7cA163DDFe69218377Ab7086bdFc9a50F4E1E
14319,15627927,184245,11911069170,178313,5932,1618,155,0x00000000006c3852cbEf3e08E8dF289169EdE581,0x7b5258ef89AfDeb8423A912077CCa907f4A20100
14320,15627927,348526,11911069170,348334,192,74,469,0x72a19342e8F1838460eBFCCEf09F6585e32db86E,0x1bE8218bE61797e26066Bd91968fFd8b745bf851
14321,15627927,99244,11911069170,98636,608,138,7,0xA0b86991c6218b36c1d19D4a2e9Eb0cE3606eB48,0x2299cdAa37016608552A94C6dded0832EA204af7
14322,15627927,268507,11911069170,264819,3688,1162,890,0x68b3465833fb72A70ecDF485E0e4C7bD8665Fc45,0x92FA4cB1C987A3494BfdE001cC37fb0A0E35F8bb
14323,15627927,46280,11911069170,45420,860,138,172,0xC02aaA39b223FE8D0A0e5C4F27eAD9083C756Cc2,0xe7184D38e439C2065F3b458f2a7ee18ee6E979C4
14324,15627927,45038,11911069170,44974,64,10,86,0xC02aaA39b223FE8D0A0e5C4F27eAD9083C756Cc2,0xFb53E3ebfE3BB33F5987A3399de84dfE4AEdd29A
14325,15627927,56679,11911069170,55735,944,138,79,0x92fF563cE14fC62A5A87961CaBf1f98748fbBaEe,0xC8F06c6a16d060B1Cb8d880655Cf7Ad5E1C6522D
14326,15627927,21000,11911069170,21000,0,2,14,0xda99B60E53423dBB94b745cf20543C8e1A73e4B8,0x6eF314FE7C08Cb78D58Df1995dE6CdF2060435F9
14327,15627927,59906,11911069170,52558,7348,2122,55,0x00000000006c3852cbEf3e08E8dF289169EdE581,0x4182f447E10620c19532cA658Ac6cBa29c747328
14328,15627927,110590,11911069170,110386,204,74,0,0xd5dF338F6C32476ef2A3FB341416ddA981c0F310,0x913a5b9dD577B278cd12b49935D82A250616a19d
14329,15627927,110542,11911069170,109834,708,266,598,0x283Af0B28c62C092C9727F1Ee09c02CA627EB7F5,0x761989CF4dB9d6a878F924c91B53a68e647f28fC
14330,15627927,176650,11911069170,170010,6640,1810,1379,0x00000000006c3852cbEf3e08E8dF289169EdE581,0xA2B0E6cF670740e0c0DF7bfcAf6B79684988a6F3
14331,15627927,150756,11911069170,150692,64,10,25,0x65c2e54a4c75ff6da7b6B32369c1677250075fb2,0xf629547E917Bf1408fd425114c3a0b9Fb8751F13
14332,15627927,392248,11911069170,388620,3628,1162,464,0x68b3465833fb72A70ecDF485E0e4C7bD8665Fc45,0x87eaA58fEF2C5180e48152E1E469E90bFb3e7b9C
14333,15627927,21000,11911069170,21000,0,2,474,0x6AF71b3aD135d102e08139B15D507303CBFe6EcF,0x154c7bFa1df595F08FfD758385Eb7BDb035ca14B
14334,15627927,146788,11911069170,140188,6600,1802,106,0x00000000006c3852cbEf3e08E8dF289169EdE581,0x0CCf24E5075F835Afa230B6aa0A387F9eb6D219e
14335,15627927,21000,11911069170,21000,0,2,221,0xa90b3998ED04fB9df812Ed184f0A7641F4b605a3,0x6AbBf31304371B64AD96652c4DFdbAe989656DDF
14336,15627927,46135,11911069170,45647,488,138,9538,0x1Fa8559e873f698292766790AeCf8080A66433F6,0xAa5D1125DcD349455dC5f04911BcB315Af10C847
14337,15627927,46135,11911069170,45647,488,138,24,0x9b9D659D4f2cF68b6616Cc0a65683f1951Eb725C,0x096748d0d94eFf7f9e1d9E0E5A823A041E180c06
14338,15627927,276183,11911069170,269595,6588,1802,35,0x00000000006c3852cbEf3e08E8dF289169EdE581,0x3F457EAd446A52DB61801803338C3dCdc68c712f
14339,15627927,113310,11411069170,113106,204,74,443,0x5D004ddB5D92938dAF8448b9eac1CaA593cd26Ca,0x26DC5D39Bd7A8bc2d792dcAAAC55FE6DCef25593
14340,15627927,113310,11411069170,113106,204,74,444,0x5D004ddB5D92938dAF8448b9eac1CaA593cd26Ca,0x26DC5D39Bd7A8bc2d792dcAAAC55FE6DCef25593
14341,15627928,235560,9361774208,233376,2184,650,96402,0xA69babEF1cA67A37Ffaf7a485DfFF3382056e78C,0xBbAD96336943A36E3e292D973B3382dd0bA4D1EF
14342,15627928,154840,10861774208,152980,1860,458,34,0xd9e1cE17f2641f24aE83637ab66a2cca9C378B9F,0x1e720251f62CB8A60C4503fbb9fBeDFEAFF97E32
14343,15627928,234769,53039131329,229709,5060,1386,44447,0x0000E0Ca771e21bD00057F54A68C30D400000000,0x000000007Cb2bD00Ae5Eb839930Bb7847ae5B039
14344,15627928,228700,9361774208,226528,2172,650,106644,0xA69babEF1cA67A37Ffaf7a485DfFF3382056e78C,0x9AAb3F81604c683a1a0D14019FBfe15bef7aA1ee
14345,15627928,243972,9361774208,241836,2136,650,43191,0x5050e08626c499411B5D0E0b5AF0E83d3fD82EDF,0xBf2D5d8eBF05947245B3D7f38b2776A6a49710DD
14346,15627928,63589,10461775208,63325,264,74,64,0xC02aaA39b223FE8D0A0e5C4F27eAD9083C756Cc2,0xeE1540d957B571E3E43dE545942b6fE483Bc60BC
14347,15627928,220946,40000000000,214358,6588,1802,2145,0x00000000006c3852cbEf3e08E8dF289169EdE581,0xCD6DE4e6Ae74267D3eb35cb8e9fbf62da41dB47D
14348,15627928,238984,37000000000,232684,6300,1802,1271,0x00000000006c3852cbEf3e08E8dF289169EdE581,0x6C4F2b82e1396aEf113d90b2FbF6C1DeDE1f8Bf5
14349,15627928,150000,30000000000,149344,656,138,11173687,0x7D1AfA7B718fb893dB30A3aBc0Cfc608AaCfeBB0,0xFBb1b73C4f0BDa4f67dcA266ce6Ef42f520fBB98
14350,15627928,216754,29000000000,210454,6300,1802,2731,0x00000000006c3852cbEf3e08E8dF289169EdE581,0x1243D01e42eEF90C72d88e665647dd50b0f49f6D
14351,15627928,55951,28000000000,55007,944,138,2184,0xe4b4C008Ff36E3C50c4299c223504a480DE9C833,0x26899847Cc940eCB4425445E96AF8a0CA90CAAA3
14352,15627928,218577,27819633000,206265,12312,3530,511,0x617Dee16B86534a5d792A4d7A62FB491B544111E,0x918403Accc9F319c724E9e57d016dbA8CA6c7aae
14353,15627928,86169,19026273555,85513,656,138,2188256,0xc00e94Cb662C3520282E6f5717214004A7f26888,0x75e89d5979E4f6Fba9F97c104c2F0AFB3F1dcB88
14354,15627928,100000,18500000000,99392,608,138,4,0xdAC17F958D2ee523a2206206994597C13D831ec7,0xcE55e46ae411310a3168f74f679BB22e099200d8
14355,15627928,5049304,17000000000,5042216,7088,1098,308,0x0a39DA505DfB5E0BBc6bd84428281A8ba1bC7753,0x495E889d1A6cEB447a57dcc1C68410299392380c
14356,15627928,276165,17000000000,269589,6576,1802,2168,0x00000000006c3852cbEf3e08E8dF289169EdE581,0x948AdE8e848aD86291f81c0c6Ea284bec78DE15f
14357,15627928,255375,15361774208,253351,2024,522,245,0x7a250d5630B4cF539739dF2C5dAcb4c659F2488D,0x4Fd47Ead21BA0be8F1efe7217be88ddD82ec40e2
14358,15627928,260182,15361774208,256530,3652,1162,1042,0x68b3465833fb72A70ecDF485E0e4C7bD8665Fc45,0x51c41955e444c48a79978c02E1f0D8d23f6F1192
14359,15627928,191137,15361774208,189313,1824,458,1072,0x7a250d5630B4cF539739dF2C5dAcb4c659F2488D,0x463303Eb6d47caC34B671a13867Dfb49E3Aca79F
14360,15627928,350000,15318566117,349392,608,138,6925093,0xA0b86991c6218b36c1d19D4a2e9Eb0cE3606eB48,0x46340b20830761efd32832A74d7169B29FEB9758
14361,15627928,350000,15318566117,350000,0,2,6925094,0x1be70F64b2f5A0c92f85812D799634B2576d7f8c,0x46340b20830761efd32832A74d7169B29FEB9758
14362,15627928,270708,14361774208,268968,1740,458,68,0x7a250d5630B4cF539739dF2C5dAcb4c659F2488D,0xf03FCe97291C605bAFF3e2541a8225F71d963A00
14363,15627928,245694,14361774208,239106,6588,1802,1819,0x00000000006c3852cbEf3e08E8dF289169EdE581,0xb2e33A00a167c04ca2a008F1e4Be276aa964C490
14364,15627928,650923,14361774208,647331,3592,1162,167,0x68b3465833fb72A70ecDF485E0e4C7bD8665Fc45,0x0bAc86B90BdB587edB4aa4033B56341F9C12A643
14365,15627928,212320,14361774208,209092,3228,1034,1689,0x68b3465833fb72A70ecDF485E0e4C7bD8665Fc45,0x8b5E270C19eb8f28050a561D0bE08690cc33e73D
14366,15627928,238999,14361774208,232687,6312,1802,1223,0x00000000006c3852cbEf3e08E8dF289169EdE581,0xC541BC01c71D83f10f42f5040094cdFfED5741b1
14367,15627928,270631,14000000000,270287,344,138,7415,0x89Bb49d06610B4b18e355504551809Be5177f3D0,0x09564716E12eB2ca51f64d07d76AA88b7CDC0283
14368,15627928,212576,14000000000,206264,6312,1802,1345,0x00000000006c3852cbEf3e08E8dF289169EdE581,0xf54611A627aFA7c00a58569932554372dD3F4b3B
14369,15627928,50000,13987055533,50000,0,2,464128,0x2505d66ADa21Cd9134273F409dF788C1eF298C7F,0x3B794929566e3Ba0f25e4263e1987828b5c87161
14370,15627928,21000,13851614172,21000,0,2,7,0x1CC6eDc1950989b7EAe4b673F0e1E25835D04Ba3,0xF2673cb3b22212005f1cCE6515c942B7cD4Aa31c
14371,15627928,40960,13682000377,40528,432,74,155630,0x13cD4dD3c6CdEF548197Ea9d2e0dF5f47Dfa047e,0xcDd37Ada79F589c15bD4f8fD2083dc88E34A2af2
14372,15627928,21000,13548388286,21000,0,2,33,0x5EB0F43998f4ccD1274E1C818B274FD112Bd0Ade,0x55263F3e82Eea6eE7E6a7033F91FC8e2C38cCE13
14373,15627928,164282,13361774208,162686,1596,230,5352,0x9507c04B10486547584C37bCBd931B2a4FeE9A41,0xF42508a3f1F3F097E7cfe5080feba1A8FD97D192
14374,15627928,164371,13361774208,162775,1596,230,2328,0x9507c04B10486547584C37bCBd931B2a4FeE9A41,0x0f2De9AE421d6951dE9AE7128b4C8074fdD07c89
14375,15627928,500000,13276512969,489348,10652,2442,8607,0x47A1e129A4632c342c449468442231F213f11710,0x47b9161Daf189017BF1b499455c65F9234DF3FA3
14376,15627928,63000,13269739644,63000,0,2,2710073,0x0D57B3B4AC68EB19E021c5dA7386A6431714d8EC,0xC098B2a3Aa256D2140208C3de6543aAEf5cd3A94
14377,15627928,63000,13269739644,63000,0,2,2710074,0xe21c26fFeD850866ac8994E693659C839De007b2,0xC098B2a3Aa256D2140208C3de6543aAEf5cd3A94
14378,15627928,63000,13269739644,63000,0,2,2710075,0x439A0537d347D6E6B1e06B4B24728ED7526f082F,0xC098B2a3Aa256D2140208C3de6543aAEf5cd3A94
14379,15627928,63000,13269739644,63000,0,2,2710076,0x67a3F34a476579FcAe3f2B6730044a35F9b18769,0xC098B2a3Aa256D2140208C3de6543aAEf5cd3A94
14380,15627928,21000,13200000000,21000,0,2,15,0x32A06C161156947b7C80F74EF29882E8226C32D4,0xa636a88102a7821b7e42292a4A3920A25a5d49b5
14381,15627928,67000,13000000000,66392,608,138,0,0xA0b86991c6218b36c1d19D4a2e9Eb0cE3606eB48,0x46484Ad770a27b283267c26C573F63B6567AA2D8
14382,15627928,69872,12361774208,68928,944,138,1291,0xFDBf91A7F2d757A9815326af5E1e60319571984c,0x1DC26ff48AbEf2d01c2A572b74117D7a19a2cD02
14383,15627928,270834,12361774208,269010,1824,458,189,0x7a250d5630B4cF539739dF2C5dAcb4c659F2488D,0x7d5477377bD9D25d0aC5c2BF22fA4940090cD115
14384,15627928,298936,12361774208,297064,1872,458,87,0x25553828F22bDD19a20e4F12F052903Cb474a335,0x7099742Bb172eE9164AdA25Ad263c1d2742877Ca
14385,15627928,2000000,12040160332,1997940,2060,522,326,0x7a250d5630B4cF539739dF2C5dAcb4c659F2488D,0x158318657de819928C935ae3436Ae2a796bcd681
14386,15627928,46109,12000000000,45501,608,138,136,0xdAC17F958D2ee523a2206206994597C13D831ec7,0x7c43440BEcf8eF400385161E760ae75DE6Db6F73
14387,15627928,244866,12000000000,238290,6576,1802,902,0x00000000006c3852cbEf3e08E8dF289169EdE581,0x8902823f879B30ecFcC97B5532038694e5E2B655
14388,15627928,300000,12000000000,299200,800,138,4,0xBE682C3E3beB8e82623D30e9608Ca2313e47bA4D,0x632f83ad969c3376a879884Fcb73f3E93c99B795
14389,15627928,197441,11986774208,190853,6588,1802,665,0x00000000006c3852cbEf3e08E8dF289169EdE581,0xBCa5F00f856538dDFa1aC416221232fDbBb60f13
14390,15627928,49234,11861774208,48282,952,202,7,0x1Fa8559e873f698292766790AeCf8080A66433F6,0x40Ff1087eE1B85285A8D8A3638e80dAfd7A628De
14391,15627928,49234,11861774208,48282,952,202,7,0x1Fa8559e873f698292766790AeCf8080A66433F6,0xe1Da94f0087398b90a33124d1B116EAAa560AAbC
14392,15627928,49234,11861774208,48282,952,202,7,0x1Fa8559e873f698292766790AeCf8080A66433F6,0x33DC75A71f17D85AE789f8562CE5Eaa261929C52
14393,15627928,49234,11861774208,48282,952,202,7,0x1Fa8559e873f698292766790AeCf8080A66433F6,0x402BD064Efeee5c8cD2c2D78cA3Db4CE22CB5730
14394,15627928,49234,11861774208,48282,952,202,7,0x1Fa8559e873f698292766790AeCf8080A66433F6,0xEA7Df239Ec8b07f85433eFa8763Cea7B5c3a7bE3
14395,15627928,46581,11861774208,45637,944,138,1285,0xFDBf91A7F2d757A9815326af5E1e60319571984c,0x9f394569A5D2Af700A5e6eaEFA067373d1b12C3C
14396,15627928,40993,11861774208,40993,0,2,97,0x835bb955BC4D73a9d774B8eD7655cF9Bb915dfD8,0xEEA80cBED6E6f4C4EfBE6bF9f13562e3C562257e
14397,15627928,133956,11861774208,132448,1508,330,437,0xc8DF9479d31994eba04C38C947478F0D674AD700,0x29A1b09E1a3e2355A9fBbcC5e4a137F4Ebb00B76
14398,15627928,70824,11861774208,69880,944,138,77,0x12b6893cE26Ea6341919FE289212ef77e51688c8,0x7a5D1A19151390Fc136CB8d387b9bC7974665D56
14399,15627928,109660,11861774208,109456,204,74,1227,0x9b9D659D4f2cF68b6616Cc0a65683f1951Eb725C,0x6EADE8eD7e7527208F468Ea8d401AFC7F4E48592
14400,15627928,69000,11761774208,68512,488,138,3704,0x1Fa8559e873f698292766790AeCf8080A66433F6,0x0d917a622ed9a5773e52cCb1fAc82A75a8a6d9D9
14401,15627928,69000,11761774208,68512,488,138,1956,0x1Fa8559e873f698292766790AeCf8080A66433F6,0xD545aD1D535E88C017f4F27B7cDb9aA46c9308d5
14402,15627928,69000,11761774208,68512,488,138,272,0xD27dcbcC8778a8AB33AAc529Df36a634567Be325,0xe561FA3FB75f3857B21EcB582051D1A9baF7e7AF
14403,15627928,69000,11761774208,68512,488,138,278,0xD27dcbcC8778a8AB33AAc529Df36a634567Be325,0xDc5527e6ED7A951b8C2DF10078f2FA1af850c5a6
14404,15627928,69000,11761774208,68512,488,138,279,0xD27dcbcC8778a8AB33AAc529Df36a634567Be325,0xdEf28d9031af805cB6891Aea9041b79d8533eeF6
14405,15627928,69000,11761774208,68512,488,138,289,0xD27dcbcC8778a8AB33AAc529Df36a634567Be325,0xFFBE9da79EEDb5750EE72b6FE25F6492032725F4
14406,15627928,69000,11761774208,68512,488,138,274,0xD27dcbcC8778a8AB33AAc529Df36a634567Be325,0x746dDdE7B851daeb90E389fdf869e93B3c6E3772
14407,15627928,46135,11711690095,45647,488,138,736,0x1Fa8559e873f698292766790AeCf8080A66433F6,0xe28E8446E049fB79b5501Ec5F467130aD9194c9A
14408,15627928,21000,11411774208,21000,0,2,251069,0xbc406B0FCb192558F10C669e5Fe9720532543132,0x8216874887415e2650D12D53Ff53516F04a74FD7
14409,15627928,90000,11361774208,89392,608,138,93935,0xdAC17F958D2ee523a2206206994597C13D831ec7,0xf89d7b9c864f589bbF53a82105107622B35EaA40
14410,15627928,62420,11361774208,61468,952,202,1202,0x1Fa8559e873f698292766790AeCf8080A66433F6,0xBDd4F4d83f67A09A3BF7d57638E1Dcd32387E331
14411,15627928,62420,11361774208,61468,952,202,830,0x1Fa8559e873f698292766790AeCf8080A66433F6,0x52b4AE6798DDd241f0e882960FAF3F966d488493
14412,15627928,238999,11361774208,232687,6312,1802,976,0x00000000006c3852cbEf3e08E8dF289169EdE581,0x46e910953D4Bb7d32E630aB9d45f56E4AFE34Fe1
14413,15627928,62420,11361774208,61468,952,202,985,0x1Fa8559e873f698292766790AeCf8080A66433F6,0x0E642E32974470085e362FE76DE5C43330632bdb
14414,15627928,62420,11361774208,61468,952,202,854,0x1Fa8559e873f698292766790AeCf8080A66433F6,0x1eb2Cbd1c6D5B6d16aBf1b2760eDf296DE7a1e10
14415,15627928,240458,11361774208,237686,2772,842,898,0x68b3465833fb72A70ecDF485E0e4C7bD8665Fc45,0x44FFCb49cf4F143267d5e3EE74532e1BB7b39236
14416,15627928,63197,11361774208,62601,596,138,1820,0xdAC17F958D2ee523a2206206994597C13D831ec7,0x201912D9d8CAD88e7cB98a207FbeF6Df82C8cEBB
14417,15627928,62420,11361774208,61468,952,202,672,0x1Fa8559e873f698292766790AeCf8080A66433F6,0x4131918DbCeB7F8cB6C115188095aA6fCd9D2B7D
14418,15627928,21000,11361774208,21000,0,2,33,0x4a43dC3cb5d86fa29bC41f207486215799f830ca,0xC3Ff40AC92645D01aFb4485d38800A09E572b740
14419,15627928,100000,11361774208,99024,976,202,88949,0xdAC17F958D2ee523a2206206994597C13D831ec7,0x3018018c44338B9728d02be12d632C6691E020d1
14420,15627928,42000,11361774208,42000,0,2,329578,0x0d36B4450109781A3a7Ca2000981964aeF06FB6e,0x9430801EBAf509Ad49202aaBC5F5Bc6fd8A3dAf8
14421,15627928,212576,11361774208,206264,6312,1802,1824,0x00000000006c3852cbEf3e08E8dF289169EdE581,0x9686ef5e52E51FA6c8bbfAcCb2Ff6b958C4625a9
14422,15627928,55978,11361774208,55034,944,138,1224,0xd4cB651749953988647eEE9b51DDB8DB5aeb3410,0x9cA213288C3cFb4f7be4dD66Bde1E025a4c8c856
14423,15627928,21000,11361774208,21000,0,2,29,0x3ACcF3B4a1Df338901d59606Fd2eB77b059382e3,0x71f39c13d8BC5e4699D05122060998ee0918A3dB
14424,15627928,49542,11361774208,49478,64,10,374,0xC02aaA39b223FE8D0A0e5C4F27eAD9083C756Cc2,0xdE385722bB8aC2b2fAAaae7D6D2F4357B4f0Bbdc
14425,15627928,21000,11361774208,21000,0,2,1783222,0x2055D9bbfb2A0991931De1EAfB924dDF1CACe33F,0x503828976D22510aad0201ac7EC88293211D23Da
14426,15627928,21000,11361774208,21000,0,2,7,0xb8Ad9A9e8C35314CA8D0A20bee690Cd6a6B8Eb80,0xcf0F91818877377381FFA664456E78cdf2C98202
14427,15627928,21000,11361774208,21000,0,2,8804474,0x6f2860422Cb6EE7177e2ecadc392bcE5E3f74A95,0x3cD751E6b0078Be393132286c442345e5DC49699
14428,15627928,21000,11361774208,21000,0,2,1783223,0x2EAE35B0954eAF0d447549454B99acDF8050aC6b,0x503828976D22510aad0201ac7EC88293211D23Da
14429,15627928,2000000,11361774208,1993244,6756,1610,171068,0xA9D1e08C7793af67e9d92fe308d5697FB81d3E43,0x7830c87C02e56AFf27FA8Ab1241711331FA86F43
14430,15627928,21000,11361774208,21000,0,2,8804475,0x50E02E38c02f8b532fd217152930eaD65d7c6744,0x3cD751E6b0078Be393132286c442345e5DC49699
14431,15627928,2000000,11361774208,1991224,8776,1930,171069,0xA9D1e08C7793af67e9d92fe308d5697FB81d3E43,0x7830c87C02e56AFf27FA8Ab1241711331FA86F43
14432,15627928,47204,11361774208,46272,932,138,42,0xb12494C8824fc069757F47d177E666c571Cd49aE,0x6a11983081395667d9D3D365f8155b6E0c7ab2FE
14433,15627928,748656,11361774208,746860,1796,522,6,0x71B5759d73262FBb223956913ecF4ecC51057641,0xCCA6815482a886227eA5f751445505fbA516215a
14434,15627928,56659,11361774208,55715,944,138,569,0xaDE9F1205a82aa61e0c15538093a4DFB37c92a28,0xD21817D89969125D55Ee88Ac80c06dfAf3c5D130
14435,15627928,99244,11361774208,98636,608,138,2,0xA0b86991c6218b36c1d19D4a2e9Eb0cE3606eB48,0xEAF08c75689A23557080E9631c51aE34a8b66b80
14436,15627928,544748,11361774208,543576,1172,330,926,0x08780fb7E580e492c1935bEe4fA5920b94AA95Da,0x5C7ca6A93a46aE786D99D91ED423A91d6fa13879
14437,15627928,251577,11361774208,248781,2796,842,36,0x68b3465833fb72A70ecDF485E0e4C7bD8665Fc45,0xa71352457E323bA4f3194398247eD89d930A032F
14438,15627928,50949,11361774208,50269,680,138,28,0x2b8beC81F648f327B7d8278EE74932845cDa3d19,0xB2cAa03F8e8abaf89186A8Ce30591CE4C36286A5
14439,15627928,401916,11361774208,398336,3580,1162,70,0x68b3465833fb72A70ecDF485E0e4C7bD8665Fc45,0x3356fb868bD89709c7401b34B70b4f09AA810077
14440,15627928,63209,11096148396,62601,608,138,45,0xdAC17F958D2ee523a2206206994597C13D831ec7,0x82267650EA92D228f6D2cA15D02f42cCe9688a02
14441,15627928,800000,11052036943,779928,20072,6546,46632,0x1111111254fb6c44bAC0beD2854e76F90643097d,0x839d4641F97153b0ff26aB837860c479E2Bd0242
14442,15627928,300000,10945600302,299392,608,138,150332,0xA0b86991c6218b36c1d19D4a2e9Eb0cE3606eB48,0x1C727a55eA3c11B0ab7D3a361Fe0F3C47cE6de5d
14443,15627928,247333,10895266070,245493,1840,466,91,0x1111111254fb6c44bAC0beD2854e76F90643097d,0xe45419390B38f2A90645a8930cE4039D99F116f7
14444,15627928,21000,10862774208,21000,0,2,24680,0xDb7b89F723F8B0D4c0472c0EfF7B40e262987B3e,0x9be7B0f285d04701f27682F591a60417C47d095A
14445,15627928,174751,10861774208,174511,240,74,475,0xf11ED77fD65840b64602526DDC38311E9923c81B,0x13257E056112D578414e5d291926c9D684d5D9eF
14446,15627928,46135,10861774208,45647,488,138,1022,0x1Fa8559e873f698292766790AeCf8080A66433F6,0x7B17fF234a0C625a454ebBdBcbF2DcC34c341CD8
14447,15627928,150129,10861774208,143273,6856,1810,139,0x00000000006c3852cbEf3e08E8dF289169EdE581,0x69e33AbB1d0E5c5a3bCb000BeBc962651f27DD97
14448,15627928,205578,10861774208,201962,3616,1162,4214,0x68b3465833fb72A70ecDF485E0e4C7bD8665Fc45,0x4Ed952edDB2DF5EcB924Cab763cC926f10F3F070
14449,15627928,21000,10861774208,21000,0,2,57,0xa3BC74ca2bC33F84B3d4b36b895Ef35A7Ae06Ea2,0x7331280885DB16DD2e5280571C94d59E28286425
14450,15627928,21000,10861774208,21000,0,2,52,0xf783Cf6c0717c3e5277564bBF846EEFaE2a52E50,0x86Ac47a7dA793AFa2408052ac63e70e1CfC17caf
14451,15627928,275775,10861774208,271627,4148,1290,116,0xC36442b4a4522E871399CD717aBDD847Ab11FE88,0x42A07990e8eEf3029713D3A5690b126E925D0fF6
14452,15627928,51406,10861774208,50918,488,138,935,0x5b9236707Ab7F5d43b889b5aFFC0A780D2c734Ad,0x1AC03ef8272FabD680c7Bf307119406f52802126
14453,15627928,61471,10861774208,53271,8200,2506,310,0x00000000006c3852cbEf3e08E8dF289169EdE581,0x14451984659Ae67FEB192c41373A763281dF8537
14454,15627928,314833,10861774208,309933,4900,1546,196,0x68b3465833fb72A70ecDF485E0e4C7bD8665Fc45,0xD12EC12A77D3f30844a58c2E992273B8152A2eD5
14455,15627928,176127,10861774208,169247,6880,1810,142,0x00000000006c3852cbEf3e08E8dF289169EdE581,0x2D07Cb4D2550775665F6Be52397afCd0b9DeD706
14456,15627928,21000,10861774208,21000,0,2,1120,0x056C0d929dED045DCe37d1f9DD0b08016861880E,0x270b53a7B1b2A57e0c90b96a09604B8186633D20
14457,15627928,21000,10861774208,21000,0,2,264,0x1850147C15F6e25261B9c5Bba65a83a0Bd7b2B63,0x18A57dA87A37eAAd6E380afCE94803a87E9b2446
14458,15627928,740000,10861774208,728788,11212,2506,59260,0xe3f0dEdE4B499c07e12475087AB1A084b5F93bc0,0x2a4a7afA40a9D03B425752fb4cFd5f0FF5b3964C
14459,15627928,21000,10861774208,21000,0,2,43,0x9FB4f3d93205F4a50512223582C91056b057a4Ea,0x425E5c03ba731806191404359A5402A96A22745f
14460,15627928,740000,10861774208,728992,11008,2506,58944,0x1D244648d5a63618751d006886268Ae3550d0Dfd,0xCe859E48f6cE9834a119Ba04FdC53c1D4F1082A7
14461,15627928,81706,10861774208,79930,1776,458,420,0xFbdDaDD80fe7bda00B901FbAf73803F2238Ae655,0xA3407ebF30a39b1d0a4875644C8819c8dA0FA55d
14462,15627928,184064,10861774208,180460,3604,1162,206,0x68b3465833fb72A70ecDF485E0e4C7bD8665Fc45,0xfE05fE13B4a2A2B03Bc62958CB95a4DC1137Af97
14463,15627928,117533,10861774208,117341,192,74,26,0xfc33E8b6E160A81DdB442B07355D01DF711EFEee,0xE231A247F090A57d6315dA6B516501673630e543
14464,15627928,370192,10861774208,364700,5492,1482,131,0x68b3465833fb72A70ecDF485E0e4C7bD8665Fc45,0xfe2c34Fc3573e6Ad53f8C7019dA9C97291219762
14465,15627928,824244,10861774208,823956,288,74,204,0x1d9DC26A9067DA6C8e6038eBF176b7eB3E394149,0x43A86525d2B359977F59C37EA83D4F7017670c2c
14466,15627928,217771,10861774208,214987,2784,842,486,0x68b3465833fb72A70ecDF485E0e4C7bD8665Fc45,0xbb26DC6452577c09FAbd8882e04D628ae49089a1
14467,15627928,21000,10861774208,21000,0,2,558,0x22F3cb62897363572E39Dc46CDa9e0C907266559,0x0AFd25e81f126d87beE5347AAbBbDBF725f02AbD
14468,15627928,56322,10861774208,54974,1348,394,440,0xe4605d46Fd0B3f8329d936a8b258D69276cBa264,0x216A023E0c19382D895a66A76dd92E898c9BE3a7
14469,15627928,76920,10861774208,76480,440,138,3,0xd32AE11F584BB9f3B3D6e56dDC9a4897dB51C055,0x38834189F1F92BF15ad38DAe4cE58DBE52D28681
14470,15627928,51706,10861774208,51086,620,138,442,0x467719aD09025FcC6cF6F8311755809d45a5E5f3,0x2d31d56EDe06aF21Fd6eac97242351EC192e178E
14471,15627928,49175,10861774208,48687,488,138,1285,0x7f738Ad7072187909384B2ffBaEEdC3C1DA1b686,0xA567E497a1F13ca67B45dcfBbeB9D25078e1BA3f
14472,15627928,46280,10861774208,45420,860,138,224,0xC02aaA39b223FE8D0A0e5C4F27eAD9083C756Cc2,0xc68FA88Db5888a909D1127cA7F57DD13300eeF5f
14473,15627928,276183,10861774208,269595,6588,1802,2998,0x00000000006c3852cbEf3e08E8dF289169EdE581,0x679F1C7De559cF077aF7BFF879E8E8FED76a0B58
14474,15627928,121839,10861774208,118563,3276,1034,29,0x0000000000c2d145a2526bD8C716263bFeBe1A72,0x10c699e993857eB0430d5c63AF0d9E74Bc5637bb
14475,15627928,46219,10861774208,45647,572,138,43,0x1Fa8559e873f698292766790AeCf8080A66433F6,0x0c36550A5E25Cf3BaF746217439774d48766aa2E
14476,15627928,413674,10861774208,412066,1608,458,782,0x150f94B44927F078737562f0fcF3C95c01Cc2376,0xB8B31cBCeE619583045c0b80f76f9610D7D67F6B
14477,15627928,245900,10861774208,242284,3616,1162,4035,0x68b3465833fb72A70ecDF485E0e4C7bD8665Fc45,0x1541681a72632143E412e918dA772DEaDF6DbC76
14478,15627928,188756,10861774208,188564,192,74,25,0x6a9f9d6F5D672a9784c5E560a9648de6cbe2c548,0x79d2a236aa643AACA706A56ff16c3a45b0f14C0C
14479,15627928,46219,10861774208,45647,572,138,170,0x1Fa8559e873f698292766790AeCf8080A66433F6,0xcb30A8456D7AebE76cDacb12A4ddA17b6fdc6BBD
14480,15627928,51492,10861774208,51004,488,138,0,0x406C60C2e8038a0E90D2f28efF7260CC7Af84EE6,0xddbd56555a702D9a177E68E37bD30a57B01E29Fe
14481,15627928,46547,10861774208,46059,488,138,24,0xaE351b8Ae55B69A5007618E598dDe89d0a092c37,0x0348B1b75a1d4013FD0F4666177891A9f902C283
14482,15627928,104467,10861774208,101191,3276,1034,32,0x0000000000c2d145a2526bD8C716263bFeBe1A72,0xF5ca89D5d79Bee75f40fe74bAda1239Ac44B0032
14483,15627928,1910582,10861774208,1784230,126352,43018,17635,0x00000000006c3852cbEf3e08E8dF289169EdE581,0x6EEf09B526d883F98762a7005FABD2c800DfCA44
14484,15627928,21000,10861774208,21000,0,2,626,0x254d87eE737911194a8590F0Bf7fFb3B0a43ED15,0x61D7aABfD210e7A5D5D60083ae0A221Fa37EEbA6
14485,15627928,253835,10861774208,248339,5496,1082,105730,0x0000000000007F150Bd6f54c40A34d7C3d5e9f56,0x60530f5Ca4CB9907e0FBE67cA3AFCbFE56D19A5c
14486,15627928,46135,10861774208,45647,488,138,11,0x1Fa8559e873f698292766790AeCf8080A66433F6,0x38f10F5fc8242dD75197583B9467b8F7C866945e
14487,15627928,246979,10861774208,244159,2820,842,267,0x68b3465833fb72A70ecDF485E0e4C7bD8665Fc45,0x26e35CDb264614d6843B57D444082EA62709c4f9
14488,15627928,21000,10861774208,21000,0,2,384,0xcfaEfe6E1a5A8d97F561fBA29fa6dA9552d1A1cA,0xe341d077a0cfba74f492cd0d06F6be3b7C0aF1C9
14489,15627928,159761,10861774208,153301,6460,1738,327,0x00000000006c3852cbEf3e08E8dF289169EdE581,0xc20b23462377bea7A7C1253057F8Ce1a74406Fcf
14490,15627928,453090,10861774208,430642,22448,7818,99,0x00000000006c3852cbEf3e08E8dF289169EdE581,0x385c8730a59e32Fc3D493C503CCaEaDc929e43E0
14491,15627928,46103,10861774208,45615,488,138,1238,0x346378C67d0F71343F80299ed8C0407aC2Df05eB,0x50aB2fA4341d85D37CB30b8f30E2B4aa7294EcC1
14492,15627928,46219,10861774208,45647,572,138,165,0x1Fa8559e873f698292766790AeCf8080A66433F6,0xb7B1568E2A54784b29AEC162AC34012fa9938B90
14493,15627928,52017,10861774208,51065,952,202,56,0x1Fa8559e873f698292766790AeCf8080A66433F6,0xf187D6c732C88158fA5bec0DF4d006B7284403fd
14494,15627928,46135,10861774208,45647,488,138,54,0x1Fa8559e873f698292766790AeCf8080A66433F6,0x758AdE17A8C57056d211c63963b703e86CD0E260
14495,15627928,29067,10861774208,28591,476,138,2491,0xA23147f7757f94DF82Bc9C062B9F58ff1e1D69bC,0xA17138c0675173B8Ea506Fb1b96FA754BC316cc2
14496,15627928,77745,10861774208,77089,656,138,10,0x6B175474E89094C44Da98b954EedeAC495271d0F,0xE7949D6E52b3E49Bb3D15F8e93600585FCbD8E15
14497,15627928,639194,10861774208,593054,46140,16082,1701,0x00000000006c3852cbEf3e08E8dF289169EdE581,0x41Fc5DE56b095F594a7fe0e758FD6769D060a376
14498,15627928,21000,10861774208,21000,0,2,1,0x367829b5a53B0947281cBe032B6613838e143e30,0xB75334cBbe9E69EEc7296CE03CD3796b4903b90B
14499,15627928,122218,10861774208,121942,276,74,92,0x27A9B8065Af3A678CD121A435BEA9253C53Ab428,0xE5E218c82681e3900850e6E67873fe71C9F38CD2
14500,15627928,46135,10861774208,45647,488,138,371,0x1Fa8559e873f698292766790AeCf8080A66433F6,0x790781E8985d51c60Aa141743B5E8080D22B4dC8
14501,15627928,21000,10861774208,21000,0,2,0,0x00F20b139d89F0dcdA9025F425fB9437037f235a,0x2Df6aDF370B2aD9ce0F7833B6F2b9ac50aA47992
14502,15627928,106876,10861774208,103448,3428,906,35,0xBA12222222228d8Ba445958a75a0704d566BF2C8,0x1e720251f62CB8A60C4503fbb9fBeDFEAFF97E32
14503,15627928,244866,10861774208,238290,6576,1802,343,0x00000000006c3852cbEf3e08E8dF289169EdE581,0x9BcA96A9f04499aA5F57a6FAC42EF5836D96Ba5e
14504,15627928,46135,10861774208,45647,488,138,429,0x1Fa8559e873f698292766790AeCf8080A66433F6,0xF8001B3B01cf566982F5135174657e7959f3A64b
14505,15627928,61463,10861774208,53271,8192,2514,54,0x00000000006c3852cbEf3e08E8dF289169EdE581,0x7436aDb2b5166BeBC100B98d293A3cCeaf28Cd90
14506,15627928,46280,10861774208,45420,860,138,7,0xC02aaA39b223FE8D0A0e5C4F27eAD9083C756Cc2,0x5123fB0593F9dCdBeB609B827bBF908B6A362153
14507,15627928,358003,10861774208,354815,3188,1098,859,0x8731d54E9D02c286767d56ac03e8037C07e01e98,0xAa4B6B4c7417248dF49dc484d5Eb9a4377A4C7e1
14508,15627928,36003,10861774208,35751,252,74,309,0xC02aaA39b223FE8D0A0e5C4F27eAD9083C756Cc2,0x644A374620A088445820aE76b20B8Bb542BfCE72
14509,15627928,55950,10861774208,55006,944,138,34,0x6097004C68F7B350d72226003226Ac089597D579,0xd605639f9438F0A9D4FD2B86D32780E6FE160934
14510,15627928,63463,10861774208,62991,472,202,7,0x59728544B08AB483533076417FbBB2fD0B17CE3a,0x07b3103f8ECEEE53f233e58d6B4481EDab2784a1
14511,15627928,360349,10861774208,336117,24232,8530,334,0x00000000006c3852cbEf3e08E8dF289169EdE581,0xb18a9c3cd49855D15bC22b9960813336d37d2C54
14512,15627928,21000,10861774208,21000,0,2,9,0xA1A252e4e9B8dfaE6b58C6C88a04791dc6B9E558,0xb201Bd0Ee5dC51936176235566A0598778383324
14513,15627928,60412,10861774208,59816,596,138,0,0xA0b86991c6218b36c1d19D4a2e9Eb0cE3606eB48,0x82c10d08c5407cCDb29Ba2cA6fDbF5661AA5eEd3
14514,15627928,52872,10861774208,51920,952,202,33,0x83565d91809Ab9c0D4d4d5a74610095264aBa4Ce,0x7542eB9FA33Cd07EFf75D20F0dC4015321546F85
14515,15627928,79564,10861774208,79172,392,138,38,0x2b591e99afE9f32eAA6214f7B7629768c40Eeb39,0xCd20418Fc29288Ff61eEC92bfe49Ef8A655Db373
14516,15627928,46135,10861774208,45647,488,138,974,0x1Fa8559e873f698292766790AeCf8080A66433F6,0xB8f8130787015d2055B0aE2A34590546c4F261c0
14517,15627928,351108,10861774208,348300,2808,842,325,0x68b3465833fb72A70ecDF485E0e4C7bD8665Fc45,0xf18c47E22aB2352C6fbF39Ed87F53F54Bd476ffF
14518,15627928,73170,10861774208,72574,596,138,21,0xA0b86991c6218b36c1d19D4a2e9Eb0cE3606eB48,0xbb71cc02B7b5F2708Fd913889c90FBe3ECb14514
14519,15627928,97761,10861774208,97329,432,74,204,0x69F0b8C5e94f6B64D832B7D9B15F3A88cB2f6F4b,0xc77b9a1EfdA8f3D87022cc8d323225a5a67Fa902
14520,15627928,70570,10759273487,69626,944,138,1835,0xcAfE001067cDEF266AfB7Eb5A286dCFD277f3dE5,0x62Fe7EFe0f3B58d93a3dE3063937409372A83686
14521,15627928,46219,10500000000,45647,572,138,165,0x1Fa8559e873f698292766790AeCf8080A66433F6,0x5f3c2F785C6e180Acc1ff0389C92eAAb24c981b0
14522,15627928,270912,10462774208,268692,2220,650,97410,0xA69babEF1cA67A37Ffaf7a485DfFF3382056e78C,0x76e40D0a69Fd81826B5eb7D18145626d46EAFdef
14523,15627928,226766,10461774208,223174,3592,1162,898,0x68b3465833fb72A70ecDF485E0e4C7bD8665Fc45,0x2d7fCF9cd77FE4C09577166b67C77D49D933C265
14524,15627928,113310,10361774208,113106,204,74,445,0x5D004ddB5D92938dAF8448b9eac1CaA593cd26Ca,0x26DC5D39Bd7A8bc2d792dcAAAC55FE6DCef25593
14525,15627928,129477,10361774208,129273,204,74,46,0x9b9D659D4f2cF68b6616Cc0a65683f1951Eb725C,0x10725d5a7eD9EdA92e5a49D6be78026d5dF01e67
14526,15627928,113310,10361774208,113106,204,74,446,0x5D004ddB5D92938dAF8448b9eac1CaA593cd26Ca,0x26DC5D39Bd7A8bc2d792dcAAAC55FE6DCef25593
14527,15627928,113310,10361774208,113106,204,74,447,0x5D004ddB5D92938dAF8448b9eac1CaA593cd26Ca,0x26DC5D39Bd7A8bc2d792dcAAAC55FE6DCef25593
14528,15627928,181476,10361774208,179912,1564,394,50,0x1Fa8559e873f698292766790AeCf8080A66433F6,0xe167891353Ea02692d4aCfC04660BE1DdA20C68E
14529,15627928,42975,10361774208,42543,432,74,15,0xa4e40785f03103215ffe03e707f7c2f4d78643BA,0xf83ce32008A042aaD53e4A1fBB8330ddE2E0FC53
14530,15627928,279930,10361774208,260502,19428,4682,785,0x00000000006c3852cbEf3e08E8dF289169EdE581,0x8841e5a990f242Fdfd24413969F214b28ccC6161
14531,15627928,113310,10361774208,113106,204,74,448,0x5D004ddB5D92938dAF8448b9eac1CaA593cd26Ca,0x26DC5D39Bd7A8bc2d792dcAAAC55FE6DCef25593
14532,15627928,113310,10361774208,113106,204,74,449,0x5D004ddB5D92938dAF8448b9eac1CaA593cd26Ca,0x26DC5D39Bd7A8bc2d792dcAAAC55FE6DCef25593
14533,15627928,113310,10361774208,113106,204,74,450,0x5D004ddB5D92938dAF8448b9eac1CaA593cd26Ca,0x26DC5D39Bd7A8bc2d792dcAAAC55FE6DCef25593
14534,15627928,178594,10212377411,177894,700,202,246,0xDFCe40fBBfdC957F8e493BF4962b5d50992412b4,0x2AE8496583F6035E5626e5122E686bF4CF12Ce8D
14535,15627928,306431,10212377411,304027,2404,586,229,0xEfF92A263d31888d860bD50809A8D171709b7b1c,0x3EB4BD4e17f51b09Bfa3E842b90d5293404376b6
14536,15627928,322509,10164021691,322317,192,74,202,0x1D4bbaD379c7b5f92fe428262c840E76E0E89169,0x53Cdc87043681c669608ae9444fBB32c11E32e69
14537,15627928,34223,10164021691,33627,596,138,0,0x083D41d6DD21EE938f0c055CA4fb12268DF0EfaC,0xc4f6865d0ce53c780B1Ba4fb7C83DD106ec49cE3
14538,15627928,56150,10164021691,55578,572,138,480,0x60E4d786628Fea6478F785A6d7e704777c86a7c6,0xa0Be587B81F5f829f70c3329B3cA3868871a9024
14539,15627928,27938,10000000000,27874,64,10,23,0xC02aaA39b223FE8D0A0e5C4F27eAD9083C756Cc2,0x307CdEd925E24F85eeEbB01f42Ba607755004369
14540,15627928,217589,10000000000,215469,2120,522,415,0x7a250d5630B4cF539739dF2C5dAcb4c659F2488D,0xA9F4Dbd56B432b81Ef80F8Bc08668709F53ee137
14541,15627928,43376,9976455586,42752,624,266,5,0x456cD8af1E936AD47a31579A5fB462393c6A6851,0x1b65160a686Ac5a26bB82dC7e2dd2B56bb247830
14542,15627928,274055,9910413600,273031,1024,202,14,0x429CA183C5f4B43F09D70580C5365a6D21ccCd47,0xAdf5249Bf641a75b094e0AE986500A9520fD9889
14543,15627928,210501,9910413600,198541,11960,3786,1319,0x00000000006c3852cbEf3e08E8dF289169EdE581,0x5C943aE9807E85B4Fa7298EcFEd84E48E3226FAB
14544,15627928,46547,9910413600,46059,488,138,15,0xaE351b8Ae55B69A5007618E598dDe89d0a092c37,0xFfee27d51710C1449290a8BE509F35D472E24dC2
14545,15627928,8000000,9801485054,7999936,64,10,15109,0xF2A0BD19d179F8283be3E4907fa8a6D53A096745,0xb2AA4a5DF3641D42e72D7F07a40292794dfD07a0
14546,15627928,82271,9736769600,81663,608,138,1,0x467719aD09025FcC6cF6F8311755809d45a5E5f3,0xF169017C6C77859EDD37bf06487Dff879ca00CDC
14547,15627928,105000,9736769600,104392,608,138,0,0xdAC17F958D2ee523a2206206994597C13D831ec7,0xb1010F6AbAb6950FA886323FbEBcA3E81424dc37
14548,15627928,105000,9736769600,104392,608,138,4,0xdAC17F958D2ee523a2206206994597C13D831ec7,0xe1e70e7E08F85Aff9A882bbCE68F026cbbE02416
14549,15627928,21000,9698983199,21000,0,2,3,0xCBD6832Ebc203e49E2B771897067fce3c58575ac,0x93CeeF42e14940Be2B181aE09a89414e9f8Ad771
14550,15627928,21000,9683448073,21000,0,2,10,0xCBD6832Ebc203e49E2B771897067fce3c58575ac,0xbc36a29070806a9401B28Cb7FdF47170577272B9
14551,15627928,21000,9666372777,21000,0,2,39,0xCBD6832Ebc203e49E2B771897067fce3c58575ac,0xf0a71165820f83ebCDcfC4A3f4a8427e09d03e7e
14552,15627928,21000,9660468915,21000,0,2,221,0xCBD6832Ebc203e49E2B771897067fce3c58575ac,0x004F1e106dBA9D82C97C5D4A0d7Aff86BFA30Ac0
14553,15627928,21000,9629901276,21000,0,2,122,0xCBD6832Ebc203e49E2B771897067fce3c58575ac,0xcfaEfe6E1a5A8d97F561fBA29fa6dA9552d1A1cA
14554,15627928,21000,9629901276,21000,0,2,276,0xCBD6832Ebc203e49E2B771897067fce3c58575ac,0xde622a75ed35F70986bD84AB7B140C14923439Af
14555,15627928,21000,9624072237,21000,0,2,765,0xCBD6832Ebc203e49E2B771897067fce3c58575ac,0x6c02C4b61bF2472c386eE5F0a87ccf0D0aEe064E
14556,15627928,21000,9624072237,21000,0,2,20,0xCBD6832Ebc203e49E2B771897067fce3c58575ac,0xbf9c65c108c45d37465be4d67ab729C0CEBbA44C
14557,15627928,21000,9613788393,21000,0,2,27,0xCBD6832Ebc203e49E2B771897067fce3c58575ac,0xad80948147328400033c3319fDC4E15c87824D38
14558,15627928,215870,9597696033,213110,2760,842,5,0x68b3465833fb72A70ecDF485E0e4C7bD8665Fc45,0xB4d60E7EbCaA8B0b8859e75Ad68E6F41f1824D99
14559,15627928,90000,9597696033,89344,656,138,57218,0x923b83c26B3809d960fF80332Ed00aA46D7Ed375,0x533e3c0e6b48010873B947bddC4721b1bDFF9648
14560,15627928,60739,9597696033,53271,7468,2506,3,0x00000000006c3852cbEf3e08E8dF289169EdE581,0x1AD783fE41E08FbB7856bedAd344174941FA3Baf
14561,15627928,54018,9519605249,53386,632,138,9,0xE5a3229CCb22b6484594973A03a3851dCd948756,0x6933004E6404A5Ac95Bc06b54D96e3eC6dbdCEf0
14562,15627928,54018,10001774208,53386,632,138,10,0xE5a3229CCb22b6484594973A03a3851dCd948756,0x6933004E6404A5Ac95Bc06b54D96e3eC6dbdCEf0
14563,15627928,79396,9380000000,78788,608,138,12,0xA0b86991c6218b36c1d19D4a2e9Eb0cE3606eB48,0x87BC26fc1962BE764040ABCc69A75d8505636261
14564,15627928,30000,9361774208,30000,0,2,644,0x388C818CA8B9251b393131C08a736A67ccB19297,0xf573d99385C05c23B24ed33De616ad16a43a0919
14565,15627929,821660,555000000000,819752,1908,458,416,0x7a250d5630B4cF539739dF2C5dAcb4c659F2488D,0x1F2b6cE01434a1885CC1B3cc7ADC3b0aEb31Cf38
14566,15627929,300000,83000000000,299344,656,138,2977,0xBB0E17EF65F82Ab018d8EDd776e8DD940327B28b,0x62012C72B9D525a704e164f541140762087A635c
14567,15627929,300000,83000000000,299344,656,138,2978,0xBB0E17EF65F82Ab018d8EDd776e8DD940327B28b,0x62012C72B9D525a704e164f541140762087A635c
14568,15627929,300000,83000000000,299344,656,138,2979,0xBB0E17EF65F82Ab018d8EDd776e8DD940327B28b,0x62012C72B9D525a704e164f541140762087A635c
14569,15627929,300000,83000000000,299344,656,138,2980,0xBB0E17EF65F82Ab018d8EDd776e8DD940327B28b,0x62012C72B9D525a704e164f541140762087A635c
14570,15627929,300000,83000000000,299344,656,138,2981,0xBB0E17EF65F82Ab018d8EDd776e8DD940327B28b,0x62012C72B9D525a704e164f541140762087A635c
14571,15627929,21000,41568608766,21000,0,2,2,0xA86309988947559b6E72Ef716C5058F479386C0F,0x78418eAdDFbbfa9c60ced65445647848396D6Aae
14572,15627929,21000,41568608766,21000,0,2,2,0xA86309988947559b6E72Ef716C5058F479386C0F,0x48B5D88E43AAa483FA33B1cd70E294ba0A694dF5
14573,15627929,21000,41568608766,21000,0,2,2,0xA86309988947559b6E72Ef716C5058F479386C0F,0xf755285e0940b909e306eA17BeEA1415b1c9A605
14574,15627929,21000,41568608766,21000,0,2,2,0xA86309988947559b6E72Ef716C5058F479386C0F,0x50e9eee45E2bAA80075fcA9cb77279b3fe2aAa06
14575,15627929,21000,41568608766,21000,0,2,2,0xA86309988947559b6E72Ef716C5058F479386C0F,0xa51E7979A6679C14f45E0ddAd75adE4779683863
14576,15627929,21000,41568608766,21000,0,2,2,0xA86309988947559b6E72Ef716C5058F479386C0F,0x1203a61d05B99b0c3D3A93CBF7CA6c4dCC686510
14577,15627929,21000,41568608766,21000,0,2,2,0xA86309988947559b6E72Ef716C5058F479386C0F,0xeA1E5Ad97A124E15F209959a39f7c77BEFB1cD79
14578,15627929,276183,29826919420,269595,6588,1802,2999,0x00000000006c3852cbEf3e08E8dF289169EdE581,0x679F1C7De559cF077aF7BFF879E8E8FED76a0B58
14579,15627929,239824,24826919420,229464,10360,3274,3152,0x00000000006c3852cbEf3e08E8dF289169EdE581,0x2d1cb5ED13C731604A3F1d48dc206D85fe5e52B1
14580,15627929,276183,17000000000,269595,6588,1802,3104,0x00000000006c3852cbEf3e08E8dF289169EdE581,0xD498420B5fFe2093FA078C800b41e6782DF7a83A
14581,15627929,245676,16000000000,239100,6576,1802,2013,0x00000000006c3852cbEf3e08E8dF289169EdE581,0xCeb8f419afEEDa4D18C0a22f6524AfFb4ca5CA9B
14582,15627929,400000,16000000000,393424,6576,1802,2169,0x00000000006c3852cbEf3e08E8dF289169EdE581,0x948AdE8e848aD86291f81c0c6Ea284bec78DE15f
14583,15627929,56667,15970486493,55723,944,138,469,0xf9a7e47f6D00a75bE08BB23a804f4153c01a1636,0x87D3F8b8ee938CaDaD7331B9579950EE4B314D98
14584,15627929,69872,14826919420,68928,944,138,69,0xFDBf91A7F2d757A9815326af5E1e60319571984c,0xf03FCe97291C605bAFF3e2541a8225F71d963A00
14585,15627929,212576,14826919420,206264,6312,1802,1966,0x00000000006c3852cbEf3e08E8dF289169EdE581,0x19317be29D9FB86aF1b72594E6e09ec0208Fbcf4
14586,15627929,69181,14250000000,68561,620,138,8,0xdAC17F958D2ee523a2206206994597C13D831ec7,0x8Fb262a047Ce6014EB0E5AbE81DDD8e4367E5606
14587,15627929,259914,14230919421,257598,2316,650,119386,0xA69babEF1cA67A37Ffaf7a485DfFF3382056e78C,0x0cac3d1a887206e0f6169222C4504301A8b4b993
14588,15627929,400000,14226919420,387252,12748,4042,2961,0x11c91606fC27a55c6f0e8F847D2aC46Ec45b6E21,0x822A2AEF1C4dA3D313096a099BfE21AFdD9997a6
14589,15627929,62274,14220000000,61606,668,138,1,0x95aD61b0a150d79219dCF64E1E6Cc01f0B64C4cE,0x12C6Fa5891E00601dB3b9Ab76F32f68720992459
14590,15627929,50000,13841088293,50000,0,2,476125,0xC03c5c5102de33Ad380Cd7Bb85092cC739b338Cb,0x4d846dA8257BB0Ebd164EFf513DfF0F0c2C3c0ba
14591,15627929,184304,13826919420,182708,1596,230,2296,0x9507c04B10486547584C37bCBd931B2a4FeE9A41,0x10045CF950fd303847010DFBFf57Eb1a6D978Ee1
14592,15627929,253357,13141536290,250585,2772,842,55,0x68b3465833fb72A70ecDF485E0e4C7bD8665Fc45,0x121E1573B7C6c15Aa4C036d54BFd2974Cf38a163
14593,15627929,201639,12836919420,199615,2024,522,357,0x7a250d5630B4cF539739dF2C5dAcb4c659F2488D,0x788296BAb7c874416c34BB5d7Bc0eb2170c97334
14594,15627929,270726,12826919420,268974,1752,458,44,0x7a250d5630B4cF539739dF2C5dAcb4c659F2488D,0xe6880A1053064a1BFDFB31684a608403874BFaEf
14595,15627929,122412,12826919420,121672,740,138,192819,0xDBd324B73f6f85bf9013B75C442021303b635Ff9,0x19f494583c7C933be7B0eE58104DDaFac1E8aDfA
14596,15627929,46109,12826919420,45501,608,138,0,0xdAC17F958D2ee523a2206206994597C13D831ec7,0xc8c62329aE33730B4c8A0208d95072b6A36A1cE3
14597,15627929,46109,12826919420,45501,608,138,0,0xdAC17F958D2ee523a2206206994597C13D831ec7,0x0E90687B87E1Bf60CF14d09a3176DA9B0d15E20D
14598,15627929,46109,12826919420,45501,608,138,0,0xdAC17F958D2ee523a2206206994597C13D831ec7,0xd2bF01ba9c9Fe1b3e70F23596680EA3cb1D0C997
14599,15627929,184142,12826919420,177554,6588,1802,334,0x00000000006c3852cbEf3e08E8dF289169EdE581,0x4dE89519c7AE636270dBEC47D819B6a738a8330B
14600,15627929,44124,12760000000,43468,656,138,18,0xb056c38f6b7Dc4064367403E26424CD2c60655e1,0x9405512De34ef57254514D40077774f6310A499C
14601,15627929,21000,12640968831,21000,0,2,14,0x151b079D1F51ff2ddA6A4BCb7077380b0d76d721,0x81932Fbbb63c11Cfa2Acc33b227BB184578F20EC
14602,15627929,21000,12500000000,21000,0,2,0,0xFD037C57aEc63C5c3EcAe12b5539Ea76eCaCA808,0x2E449298768F76C3981AaBdc94BB9bE75272D131
14603,15627929,50000,12477004842,50000,0,2,464129,0xaAcA5D9FD504a262CD1Ac88D2dAda4634DaA1DC7,0x3B794929566e3Ba0f25e4263e1987828b5c87161
14604,15627929,49234,12326919420,48282,952,202,7,0x1Fa8559e873f698292766790AeCf8080A66433F6,0x652191b52E9e1AD7dfcEC10315eb20df5dfA2b58
14605,15627929,49234,12326919420,48282,952,202,7,0x1Fa8559e873f698292766790AeCf8080A66433F6,0x7E879F99b09342f9aD26c858Fc7f5518EF0D1361
14606,15627929,49234,12326919420,48282,952,202,7,0x1Fa8559e873f698292766790AeCf8080A66433F6,0x30Cf17723d0cb253856aBB5738c86C268fE47FC5
14607,15627929,49234,12326919420,48282,952,202,7,0x1Fa8559e873f698292766790AeCf8080A66433F6,0x8a3718E7eac2552765F1aC747A7fd5cB3C4cA19C
14608,15627929,49234,12326919420,48282,952,202,7,0x1Fa8559e873f698292766790AeCf8080A66433F6,0x55C550CB3EE7F7dfC1DE7603758B3301703d419A
14609,15627929,245694,12326919420,239106,6588,1802,360,0x00000000006c3852cbEf3e08E8dF289169EdE581,0xD4995019404540F0C1bEBeBC2022836959e8456c
14610,15627929,237022,12326919420,236806,216,74,93,0xA35aa193f94A90eca0AE2a3fB5616E53C1F35193,0xefD90153e3c179927F540181047d1b8D472a86c7
14611,15627929,69114,12000000000,68626,488,138,29,0x57f1887a8BF19b14fC0dF6Fd9B2acc9Af147eA85,0xe25233f3502DaE11b9BA0d5e1Dfd2987132faA4b
14612,15627929,21000,11826919420,21000,0,2,1714,0x41e6816f82117b8721BeEeFAf6f76B3b35FFE730,0xe2EA0f0163Ccb5761Ee2A250f6032C46569c718c
14613,15627929,21000,11826919420,21000,0,2,4,0xa702b33Ba34fd6752EcFbBC7aa23B7f57A832c3A,0x32f6D2a63F83c9B02A8530c3F0E34d07F97F7a60
14614,15627929,21000,11826919420,21000,0,2,501,0x57775A231cc9B1Cb3B43647FfbC55D4D07C5224D,0x5C11eaB8926703C9942987C9288E243B58018489
14615,15627929,400000,11826919420,393700,6300,1802,1274,0x00000000006c3852cbEf3e08E8dF289169EdE581,0xb3924EcF19c2ef7fB7cE3ecDDD22ec96C77a3f64
14616,15627929,238702,11826919420,235918,2784,842,1459,0x68b3465833fb72A70ecDF485E0e4C7bD8665Fc45,0x43C1Bf1a33506d2d3f023a1F354e608e7784aC46
14617,15627929,449930,11826919420,443686,6244,1612,662,0x881D40237659C251811CEC9c364ef91dC08D300C,0x37B009b21260e07fe73AD2E5BEe98acb1C6B8B2a
14618,15627929,245369,11826919420,239777,5592,1676,11,0x881D40237659C251811CEC9c364ef91dC08D300C,0x25899a9A47384f0307776aD266a9B1cD024B002B
14619,15627929,1112104,11826919420,1022184,89920,31186,1109,0x00000000006c3852cbEf3e08E8dF289169EdE581,0x9a0Abcd57493935A1fD880B157A0f9784471BA89
14620,15627929,42000,11826919420,42000,0,2,329579,0x793C5534229Ed11573Adc1D4636903A2Aa9271F4,0x9430801EBAf509Ad49202aaBC5F5Bc6fd8A3dAf8
14621,15627929,290111,11826919420,283987,6124,1546,20,0xc9154424B823b10579895cCBE442d41b9Abd96Ed,0x582DE6cfdB6a5cD2cDd0E8432b4001C8BbdF4094
14622,15627929,66836,11826919420,65892,944,138,0,0xA0b86991c6218b36c1d19D4a2e9Eb0cE3606eB48,0x1D874e5216F0A41e5E35E30258Aa9264db5aE4c7
14623,15627929,202606,11826919420,199798,2808,842,565,0x68b3465833fb72A70ecDF485E0e4C7bD8665Fc45,0x4BDD0F329875b52d05D9111A0AD4bFa804a319B0
14624,15627929,207128,11826919420,206520,608,138,3199196,0xdAC17F958D2ee523a2206206994597C13D831ec7,0x9696f59E4d72E237BE84fFD425DCaD154Bf96976
14625,15627929,207128,11826919420,206472,656,138,4232364,0xDDB3422497E61e13543BeA06989C0789117555c5,0xDFd5293D8e347dFe59E90eFd55b2956a1343963d
14626,15627929,207128,11826919420,207128,0,2,1679545,0x57bb015aEf1C4A82CC6BFe7e1BdFcbA87087cc2F,0x4976A4A02f38326660D17bf34b431dC6e2eb2327
14627,15627929,207128,11826919420,207128,0,2,4708729,0xE35e5A5DA97E9A609ee2a2E0230c02Df353185f9,0x28C6c06298d514Db089934071355E5743bf21d60
14628,15627929,207128,11826919420,207128,0,2,4468988,0xbaF8F823CbA9115da9c656505d38460c4c7c8d29,0x21a31Ee1afC51d94C2eFcCAa2092aD1028285549
14629,15627929,207128,11826919420,207128,0,2,3199197,0xB976E201e11A4271ca87eba6595b73F26C579032,0x9696f59E4d72E237BE84fFD425DCaD154Bf96976
14630,15627929,46135,11826919420,45647,488,138,57,0x1Fa8559e873f698292766790AeCf8080A66433F6,0x3B6bf291349e415569D699444608697B032219EF
14631,15627929,216755,11360411282,215403,1352,402,1996,0x1111111254fb6c44bAC0beD2854e76F90643097d,0x30123e49FE5f703b6675943c1520a422D1705DB6
14632,15627929,46135,11326919420,45647,488,138,558,0x1Fa8559e873f698292766790AeCf8080A66433F6,0x1C48aa57CE0aecE12Cb4c07939a44C21b34a9c9B
14633,15627929,81706,11326919420,79930,1776,458,421,0xFbdDaDD80fe7bda00B901FbAf73803F2238Ae655,0xA3407ebF30a39b1d0a4875644C8819c8dA0FA55d
14634,15627929,146705,11326919420,140117,6588,1802,34,0x00000000006c3852cbEf3e08E8dF289169EdE581,0xf5b75474d006495C82dBbf010e230d5D2F86226f
14635,15627929,21000,11326919420,21000,0,2,18,0xFDe0774aDb63eCDDEd39b647BE8ADCD21B7e8FcD,0x66B5010C8BA58FD0f089fa89325E29b530570702
14636,15627929,46135,11326919420,45647,488,138,47,0x1Fa8559e873f698292766790AeCf8080A66433F6,0x0601f794CfD96C939d2F918f8a45a1Be1883ebDE
14637,15627929,49175,11326919420,48687,488,138,81,0x8B576c79767791f83613bEd5095ef22E04245F3E,0x14Edea867c14Eab93080f63375212b415144A585
14638,15627929,132289,11326919420,125921,6368,1674,1054,0x00000000006c3852cbEf3e08E8dF289169EdE581,0x2F741CB460b60ddef6a11E585F1d0F2F101d9277
14639,15627929,45897,11326919420,44953,944,138,1385,0x57f1887a8BF19b14fC0dF6Fd9B2acc9Af147eA85,0x33de5f7c0dcFfBbC399b603FF539250a2c132E3c
14640,15627929,29151,11326919420,28591,560,138,2492,0xA23147f7757f94DF82Bc9C062B9F58ff1e1D69bC,0xA17138c0675173B8Ea506Fb1b96FA754BC316cc2
14641,15627929,220539,11326919420,218135,2404,586,194,0xd9e1cE17f2641f24aE83637ab66a2cca9C378B9F,0x6BfE59e8fEaDDfBdBb97F7Da8c6B4550a8bD4ffd
14642,15627929,99774,11326919420,97906,1868,330,341,0x000000000000509081d6FCD3ee63e791aD1db763,0x947a9158714c1CFc20c92B72e1fA9F181B6c9a21
14643,15627929,21000,11326919420,21000,0,2,202,0xf2E9db3c5D06015833Df31eD3C37172a2B34EE7F,0x68a1F25D55230A9224395Db7f50F57e7b460C93D
14644,15627929,230779,11326919420,230575,204,74,18,0x89078be8004Fb238630C2E156DF7d3bA56e590EF,0xF381c70AFFa00237A25f48663C5E9fFdf56c7Bd9
14645,15627929,62178,11326919420,60386,1792,394,55,0xF87E31492Faf9A91B02Ee0dEAAd50d51d56D5d4d,0x987A5Dc16a6367A03231feCf76741F475b108099
14646,15627929,46135,11326919420,45647,488,138,374,0x1Fa8559e873f698292766790AeCf8080A66433F6,0xd9493D3f51C84Cedead582a2E55Fe4381f17DF0a
14647,15627929,125078,11326919420,124802,276,74,169,0x8Bc3702c35D33E5DF7cb0F06cb72a0c34Ae0C56F,0x7E56b14AA930Abb55E272D6f75f7612Bb6a4DfA2
14648,15627929,150000,11326919420,149344,656,138,56,0x00C2999c8B2AdF4ABC835cc63209533973718eB1,0xbd6Be4cfB2Ca109c50600625a5E24C7F5962bD50
14649,15627929,536913,11326919420,504101,32812,11338,2073,0x00000000006c3852cbEf3e08E8dF289169EdE581,0x2bF8F06adC558fb713fA2CCC221c9BCc72DbF75d
14650,15627929,180954,11326919420,180750,204,74,120,0xa0B329EA79e09Fa19fFDC781Eca58cC8916Ee855,0xB38c18E15Dd16437D27b3fF1d22B200C8dE31697
14651,15627929,227700,11326919420,224964,2736,842,799,0x68b3465833fb72A70ecDF485E0e4C7bD8665Fc45,0x6953Ba87386bD829F800C533D73264BFA5d43D6D
14652,15627929,484742,11326919420,441746,42996,14306,265,0x00000000006c3852cbEf3e08E8dF289169EdE581,0xDB14278a4b6f6a67b087E9E2324f4A807cb80D81
14653,15627929,21000,11326919420,21000,0,2,105,0xBB5AB182B63f1F5023b5B15b2aC419C48B4670Ee,0x3504f9a1b78525388F3274203Fa2be438D34100f
14654,15627929,55950,11326919420,55006,944,138,159,0x6097004C68F7B350d72226003226Ac089597D579,0x297aC2a7eEFB04C44444F22dBE82dC394662Ce86
14655,15627929,250407,11326919420,246755,3652,1162,668,0x68b3465833fb72A70ecDF485E0e4C7bD8665Fc45,0xCaBA18AE3eD72886b64BFc24e79CD7A98137e536
14656,15627929,46135,11326919420,45647,488,138,225,0x1Fa8559e873f698292766790AeCf8080A66433F6,0xA2a8f59d5d7b7AD6eD33E15c9D09220bcE5E1930
14657,15627929,56686,11326919420,55742,944,138,2,0x97b738E9AF2B815132325A02386113bd104C0f08,0x066eDeeA7B363921232231eC0fD9Cb394C50023a
14658,15627929,116720,11326919420,114360,2360,522,259,0x2d1715fb980665ef9d95992FB3467634e848691B,0x8Dc085526EE05F27443C9eD2C312dC28FbDC50E3
14659,15627929,46135,11326919420,45647,488,138,2169,0x1Fa8559e873f698292766790AeCf8080A66433F6,0x1c308bCdFfa3CDaFd2D2Eaa740ae5402C44F2448
14660,15627929,21000,11326919420,21000,0,2,15,0x073b7993d04835Ca17cDe15ab6323876e6aFBb93,0x3fC571771ca7433058deA997beFe59c36B00E638
14661,15627929,46135,11326919420,45647,488,138,552,0x1Fa8559e873f698292766790AeCf8080A66433F6,0xF6160fcfb3D0695728B8806AABb619854Bad833F
14662,15627929,53758,11326919420,52806,952,202,35,0xd5dF338F6C32476ef2A3FB341416ddA981c0F310,0x4b71BE4c8B4682C4d673bc3db401a608f181b58F
14663,15627929,55897,11326919420,54953,944,138,42,0xFDBf91A7F2d757A9815326af5E1e60319571984c,0xA83236C27717D16e78155cAcE656Ada0273Dcd2E
14664,15627929,21000,11326919420,21000,0,2,136,0x73d81b91d5Cfa015578db440BdBB16938A7b635A,0x886b25394642918A8946335a382d8122Cf2d07c4
14665,15627929,152276,11326919420,141648,10628,3402,137,0x00000000006c3852cbEf3e08E8dF289169EdE581,0x5bF2eb73b153ec29b52018b90a2f9074bDdE70CF
14666,15627929,475767,11326919420,448143,27624,8906,68,0x56Dd5bbEDE9BFDB10a2845c4D70d4a2950163044,0x7e3FEbE9bEA70AA3d0B9CE72698a1781162bB8F2
14667,15627929,135210,11326919420,129190,6020,1674,774,0x00000000006c3852cbEf3e08E8dF289169EdE581,0x0Df444b18cfB7e0FBa4d7d00d83e20c74F3de934
14668,15627929,293176,11326919420,290012,3164,906,18,0x68b3465833fb72A70ecDF485E0e4C7bD8665Fc45,0xE71814755D42816716097a6a2EEC5573Aab76768
14669,15627929,238674,11326919420,235914,2760,842,121,0x68b3465833fb72A70ecDF485E0e4C7bD8665Fc45,0x6df64eA776B490Eb15B5E910871A2098a7B22272
14670,15627929,142815,11326919420,134575,8240,1482,36,0xF2aECeE06841F0Cc984aB8d7dE5B1e9106890FDC,0x0b2396e81fd0904752940F3Ca585E2673c06c84d
14671,15627929,46016,11326919420,45528,488,138,498,0x495f947276749Ce646f68AC8c248420045cb7b5e,0xC612b11556a9a3aC1dca1f18df1c7Ad4819Ff4d8
14672,15627929,29501,11326919420,29025,476,138,2493,0x984F7f9953B4a55b4aF55b388D9AC67B81edF56C,0xA17138c0675173B8Ea506Fb1b96FA754BC316cc2
14673,15627929,46678,11326919420,46190,488,138,105,0xA6d0eea3AfaB2696a840731537874e058BC8049f,0x552E211dF0e69f90b561f4bE266A30645664Ca88
14674,15627929,2151552,11326919420,2142652,8900,3210,1788,0x000000000000509081d6FCD3ee63e791aD1db763,0x954021052072c6B6d8E1fEb5FA2C093CBA72a344
14675,15627929,186523,11326919420,179971,6552,1802,121,0x00000000006c3852cbEf3e08E8dF289169EdE581,0xa982bA5645A1b04c256EcE852Cb87ca742612Ca4
14676,15627929,21000,11326919420,21000,0,2,4,0xAF52Ca97EB19E738D3be14D6FCe4104A229F1AcF,0xFac48d5EC2fbF4dDE98341923FD14778F85456F1
14677,15627929,21000,11326919420,21000,0,2,112,0xDA556f7c448806D6D445547f5991C4c161D9a3c6,0xfe2703083694a66b2aEC3db3AcEa74E99d8e1Efc
14678,15627929,46581,11326919420,45637,944,138,1073,0xFDBf91A7F2d757A9815326af5E1e60319571984c,0x463303Eb6d47caC34B671a13867Dfb49E3Aca79F
14679,15627929,21000,11326919420,21000,0,2,9,0x71172E033133b9123320f4B56408bA3Af01e35f7,0xe9292fa198778331496E114Be2B906a2D179DcB2
14680,15627929,60727,11326919420,53271,7456,2506,179,0x00000000006c3852cbEf3e08E8dF289169EdE581,0xD542C581389CE26636A62dFe358cEaE78aEf8A1f
14681,15627929,99244,11326919420,98636,608,138,179,0xA0b86991c6218b36c1d19D4a2e9Eb0cE3606eB48,0x022d4D24D434f91775C9f147d69421ec73025A95
14682,15627929,277232,11326919420,274472,2760,842,0,0x68b3465833fb72A70ecDF485E0e4C7bD8665Fc45,0xF61ECE32C8f000AbbDA8E7F3ECEb20608499c204
14683,15627929,46135,11326919420,45647,488,138,159,0x1Fa8559e873f698292766790AeCf8080A66433F6,0xb851e1782b1c2cC6d26918942f5D2068BFcf9421
14684,15627929,467133,11326919420,377117,90016,31186,5818,0x00000000006c3852cbEf3e08E8dF289169EdE581,0x80A25bB487e89e79599c9ACAe6dbc6b8a5F1BCDc
14685,15627929,46219,11326919420,45647,572,138,608,0x1Fa8559e873f698292766790AeCf8080A66433F6,0xff019340537C2DB8F0717F9E710977d18A46d61f
14686,15627929,33536,11326919420,33040,496,202,324,0x36E5913BF48CCBD361875d09C0A20A4C144da896,0xa4606Bb11264E40A912dD4cde577986013562d23
14687,15627929,46121,11326919420,45633,488,138,433,0x306b1ea3ecdf94aB739F1910bbda052Ed4A9f949,0xAf4144C200CfCB09fc7695d38fF378225ddC5118
14688,15627929,46135,11326919420,45647,488,138,384,0x1Fa8559e873f698292766790AeCf8080A66433F6,0x9b029e725CfB7D5dE4A7628Ea6948d55A5F811F0
14689,15627929,185305,11326919420,181713,3592,1162,1376,0x68b3465833fb72A70ecDF485E0e4C7bD8665Fc45,0xF7161CFe40D4B21D9B6F87C19d9Ff424D8675d3E
14690,15627929,50719,11326919420,50111,608,138,46,0xdAC17F958D2ee523a2206206994597C13D831ec7,0xbB7feCB3f437585fF1F3768ddB423b894401389F
14691,15627929,89998,11326919420,88194,1804,586,44,0x35CA26A7a7F3ca98F3e60BD94C139C892e45B6C3,0x0c36550A5E25Cf3BaF746217439774d48766aa2E
14692,15627929,46135,11326919420,45647,488,138,39,0x1Fa8559e873f698292766790AeCf8080A66433F6,0xA45684D3dA5787db547e2ec0D0467238dFF8052A
14693,15627929,21000,11117919420,21000,0,2,12384,0x42525B10C8472a5446021A2222465180A21aBACa,0xF7aAb787787631d5d180B54B83747e6654E8f6B6
14694,15627929,52656,11117919420,52656,0,2,113059,0x5F128634eAA8D906D02BE4Ce84d9bc1EBB653651,0x6081258689a75d253d87cE902A8de3887239Fe80
14695,15627929,46125,11000000000,45637,488,138,119,0x21374D22F169849cFD680241F3f37cD61AC2eea5,0x46d398dA5073b6B0271340F57A6D9De6177e4E3B
14696,15627929,300000,11000000000,297952,2048,522,5,0x7a250d5630B4cF539739dF2C5dAcb4c659F2488D,0x632f83ad969c3376a879884Fcb73f3E93c99B795
14697,15627929,21000,11000000000,21000,0,2,64,0xcf8FDbc996331E684E3024f8528257D5402453b8,0x387EB5232d64578b5689e21B90B0ABB51a3C24D1
14698,15627929,113310,10826919420,113106,204,74,451,0x5D004ddB5D92938dAF8448b9eac1CaA593cd26Ca,0x26DC5D39Bd7A8bc2d792dcAAAC55FE6DCef25593
14699,15627929,21000,10826919420,21000,0,2,10,0x7681A1fb625f0ae1f7337B9d5922fA834Bfa1F4b,0xDc74130E54f7a9B248F36f0943154ca4Da0dD2a4
14700,15627929,250000,10826919420,250000,0,2,45337172,0x2B92576BA08f9a04294Aa0db888B707374b3A9B4,0xEA674fdDe714fd979de3EdF0F56AA9716B898ec8
14701,15627929,113310,10826919420,113106,204,74,452,0x5D004ddB5D92938dAF8448b9eac1CaA593cd26Ca,0x26DC5D39Bd7A8bc2d792dcAAAC55FE6DCef25593
14702,15627929,113310,10826919420,113106,204,74,453,0x5D004ddB5D92938dAF8448b9eac1CaA593cd26Ca,0x26DC5D39Bd7A8bc2d792dcAAAC55FE6DCef25593
14703,15627929,165375,10826919420,155851,9524,3018,422,0x00000000006c3852cbEf3e08E8dF289169EdE581,0xA8B4756959E1192042fC2a8A103Dfe2BdDF128E8
14704,15627929,175110,10826919420,173546,1564,394,843,0x1Fa8559e873f698292766790AeCf8080A66433F6,0xBe2c6fD365a09c9b552949444685A218751E67Bb
14705,15627929,113310,10826919420,113106,204,74,454,0x5D004ddB5D92938dAF8448b9eac1CaA593cd26Ca,0x26DC5D39Bd7A8bc2d792dcAAAC55FE6DCef25593
14706,15627929,191077,10826919420,190177,900,266,215,0xd588b586D61C826A0e87919b3D1a239206d58bf2,0xde499CC69295e266DcA857ab4DF0Bc6A22a99142
14707,15627929,113310,10826919420,113106,204,74,455,0x5D004ddB5D92938dAF8448b9eac1CaA593cd26Ca,0x26DC5D39Bd7A8bc2d792dcAAAC55FE6DCef25593
14708,15627929,143925,10826919420,137325,6600,1802,144,0x00000000006c3852cbEf3e08E8dF289169EdE581,0x888874E5ab7b4F0955Fc07f3400016Ab2e948888
14709,15627929,113310,10826919420,113106,204,74,456,0x5D004ddB5D92938dAF8448b9eac1CaA593cd26Ca,0x26DC5D39Bd7A8bc2d792dcAAAC55FE6DCef25593
14710,15627929,113310,10826919420,113106,204,74,457,0x5D004ddB5D92938dAF8448b9eac1CaA593cd26Ca,0x26DC5D39Bd7A8bc2d792dcAAAC55FE6DCef25593
14711,15627929,191077,10646990995,190177,900,266,203,0xd588b586D61C826A0e87919b3D1a239206d58bf2,0x2E243DF4892e05E5C8AAcfB550DC172DDdF8b1A3
14712,15627929,162831,10646990995,161043,1788,458,3,0xEfF92A263d31888d860bD50809A8D171709b7b1c,0x77358641aD6B522323d0716DFC20A6B1db20cAd3
14713,15627929,56674,10635528793,55730,944,138,7,0x184b6f31aeAa6a19Eb207dFeA01F4289629e0f0f,0xa08897cefcd80f68bEb82555e08C0378B5ed8DaF
14714,15627929,401002,10541383333,388970,12032,3858,872,0x1111111254fb6c44bAC0beD2854e76F90643097d,0xC96E36494656073AFC25E1b6299C73330898B37a
14715,15627929,45553,10411069170,45489,64,10,1,0x4917dfFf59DDD44f4f6f66E239dA1767E6d75E59,0x9Aee91055D78D5bA1E79631E342071ca7ee485d6
14716,15627929,66163,10212377411,65555,608,138,2,0xA0b86991c6218b36c1d19D4a2e9Eb0cE3606eB48,0xca7C9cA635Ae57DDc2083899b52e01addf79C127
14717,15627929,57737,10062841245,57057,680,138,50,0x4cfF49d0A19ed6Ff845a9122fa912AbcFB1F68A6,0x5076545B5cAbaa5D39E52E6E845413923C09f880
14718,15627929,335280,10062841245,160460,174820,22030,183264,0x5E4e65926BA27467555EB562121fac00D24E9dD2,0x6887246668a3b87F54DeB3b94Ba47a6f63F32985
14719,15627929,21000,10000000000,21000,0,2,178,0xe2091Ef01fb64e43Ba84615B5516A8001fE118c4,0xD9f3f6d8Ba203eDe0011380d03Aea0Dd5B47e671
14720,15627929,46707,10000000000,46219,488,138,514,0xbef7Dcc0335Ec876e2DC530b883F34c8807d61fc,0x67615AaE6c56d2C22212b6a63f30a378162E49d9
14721,15627929,75000,10000000000,74428,572,138,50,0x1Fa8559e873f698292766790AeCf8080A66433F6,0xAAa39785EB1a2C3a6C7c95465aB367B84F78cb90
14722,15627929,231973,10000000000,229165,2808,842,0,0x68b3465833fb72A70ecDF485E0e4C7bD8665Fc45,0xcFAb4Ae9A389429A3a881062D289410bb4167103
14723,15627930,219304,17873742234,208944,10360,3274,251,0x00000000006c3852cbEf3e08E8dF289169EdE581,0x0333656a887aF23107BFF18E4a0d20968ef68910
14724,15627930,21000,11923742234,21000,0,2,196180,0xd3cde04028c1cB75D95008FE804c0A7f5F1b22B6,0xd108FD0E8c8E71552a167E7a44FF1d345D233BA6
14725,15627930,442354,11873742234,437694,4660,1162,22,0xe66B31678d6C16E9ebf358268a790B763C133750,0x01FA80E365BBd3c7c73274df7318dd86506505CB
14726,15627930,339372,11873742234,326588,12784,4042,1114,0x11c91606fC27a55c6f0e8F847D2aC46Ec45b6E21,0x0d8Bb81eaF870D6732b41DCFfa8D4074C35EDFc8
14727,15627930,28564,11373742234,27920,644,138,20,0x7D1AfA7B718fb893dB30A3aBc0Cfc608AaCfeBB0,0x682Cad157D79d73Eb1D93d036B438d6F05084736
14728,15627930,162731,11373742234,152187,10544,3402,655,0x00000000006c3852cbEf3e08E8dF289169EdE581,0x8b2BE334F5516c947B617cc89F81Cc2bBB8DDce2
14729,15627930,21000,11373742234,21000,0,2,138,0x462C9C877E02B92142E4069aD595D9A11b7e7f7E,0xD620Fc46d095eC2C86C730D05ad06E94043dBbAB
14730,15627930,220108,10873742234,218156,1952,522,69,0xeF3739eE528B8D74D0C2a906Aa469C67233c6B44,0x57e168AB23DFed4f67ba52099c7e28Fc1B3588c3
14731,15627930,94463,10873742234,94031,432,74,600,0xA0c68C638235ee32657e8f720a23ceC1bFc77C77,0x55dbAC71d136A8aD02edd815B1E1b9217E4a9e22
14732,15627930,113310,10873742234,113106,204,74,458,0x5D004ddB5D92938dAF8448b9eac1CaA593cd26Ca,0x26DC5D39Bd7A8bc2d792dcAAAC55FE6DCef25593
14733,15627930,21000,10873742234,21000,0,2,65,0x27223d0c09CdBdC731405A9DAfaD341909050aeB,0x35760c130C64422A5D9Bc611Ce9185a67cB2c859
14734,15627930,75000,10000000000,74428,572,138,65,0x1Fa8559e873f698292766790AeCf8080A66433F6,0xE7771A0a73735875Ca09b32B7aaB8BB29ffd800e
